"FIPS","Admin2","Province_State","Country_Region","Last_Update","Lat","Long_","Confirmed","Deaths","Recovered","Active","Combined_Key","POPESTIMATE2019","NPOPCHG_2019","BIRTHS2019","DEATHS2019","NATURALINC2019","INTERNATIONALMIG2019","DOMESTICMIG2019","NETMIG2019","RESIDUAL2019","GQESTIMATES2019","RDEATH2019","RNATURALINC2019","RINTERNATIONALMIG2019","RDOMESTICMIG2019","RNETMIG2019","WorkersInCommutingFlow"
45001,"Abbeville","South Carolina","US","2020-05-24 02:32:43",34.22333378,-82.46170658,35,0,0,35,"Abbeville, South Carolina, US",24527,-60,231,275,-44,-11,-3,-14,-2,904,11.198436291,-1.791749807,-0.447937452,-0.12216476,-0.570102211,5673
22001,"Acadia","Louisiana","US","2020-05-24 02:32:43",30.2950649,-92.41419698,289,15,0,274,"Acadia, Louisiana, US",62045,-169,816,690,126,17,-312,-295,0,1050,11.105835392,2.0280221151,0.2736220314,-5.021769047,-4.748147016,15643
51001,"Accomack","Virginia","US","2020-05-24 02:32:43",37.76707161,-75.63234615,722,11,0,711,"Accomack, Virginia, US",32316,-265,384,489,-105,30,-186,-156,-4,430,15.070034054,-3.235896883,0.9245419665,-5.732160192,-4.807618226,13136
16001,"Ada","Idaho","US","2020-05-24 02:32:43",43.4526575,-116.2415516,794,23,0,771,"Ada, Idaho, US",481587,12823,4980,3055,1925,26,10815,10841,57,11386,6.4292035259,4.0511347913,0.0547166258,22.760011827,22.814728453,215983
19001,"Adair","Iowa","US","2020-05-24 02:32:43",41.33075609,-94.47105874,7,0,0,7,"Adair, Iowa, US",7152,78,84,77,7,2,71,73,-2,150,10.825249543,0.9841135948,0.2811753128,9.9817236047,10.262898917,2968
21001,"Adair","Kentucky","US","2020-05-24 02:32:43",37.10459774,-85.28129668,96,18,0,78,"Adair, Kentucky, US",19202,3,184,216,-32,-1,38,37,-2,1187,11.249707039,-1.666623265,-0.052081977,1.9791151272,1.9270331502,5504
29001,"Adair","Missouri","US","2020-05-24 02:32:43",40.19058551,-92.60078167,38,0,0,38,"Adair, Missouri, US",25343,-133,267,193,74,99,-307,-208,1,2914,7.5955843287,2.912296582,3.8961805624,-12.08209528,-8.185914717,11712
40001,"Adair","Oklahoma","US","2020-05-24 02:32:43",35.88494195,-94.65859267,82,3,0,79,"Adair, Oklahoma, US",22194,-30,309,285,24,3,-58,-55,1,92,12.832635418,1.0806429826,0.1350803728,-2.611553875,-2.476473502,6280
8001,"Adams","Colorado","US","2020-05-24 02:32:43",39.87432092,-104.3362578,2856,112,0,2744,"Adams, Colorado, US",517421,6067,6777,3208,3569,1204,1283,2487,11,4036,6.2365434619,6.9383490073,2.3406478579,2.4942285728,4.8348764307,175518
16003,"Adams","Idaho","US","2020-05-24 02:32:43",44.89333571,-116.4545247,3,0,0,3,"Adams, Idaho, US",4294,60,31,27,4,1,56,57,-1,21,6.3320825516,0.9380863039,0.234521576,13.133208255,13.367729831,1216
17001,"Adams","Illinois","US","2020-05-24 02:32:43",39.98815591,-91.18786813,44,1,0,43,"Adams, Illinois, US",65435,-188,776,850,-74,18,-131,-113,-1,2020,12.971356193,-1.12927101,0.2746875429,-1.999114896,-1.724427353,34891
18001,"Adams","Indiana","US","2020-05-24 02:32:43",40.7457653,-84.93671406,12,1,0,11,"Adams, Indiana, US",35777,182,676,261,415,8,-239,-231,-2,422,7.3137925237,11.629210335,0.2241775486,-6.697304265,-6.473126716,14115
19003,"Adams","Iowa","US","2020-05-24 02:32:43",41.02903567,-94.69932645,4,0,0,4,"Adams, Iowa, US",3602,-42,29,38,-9,0,-35,-35,2,69,10.488545404,-2.484129175,0,-9.660502346,-9.660502346,1587
28001,"Adams","Mississippi","US","2020-05-24 02:32:43",31.47669768,-91.35326037,181,15,0,166,"Adams, Mississippi, US",30693,-351,340,429,-89,151,-414,-263,1,2347,13.897662666,-2.883198082,4.8917180945,-13.4117304,-8.52001231,11415
31001,"Adams","Nebraska","US","2020-05-24 02:32:43",40.5244942,-98.50117804,264,11,0,253,"Adams, Nebraska, US",31363,-151,391,316,75,59,-286,-227,1,1232,10.051370135,2.3856100005,1.876679867,-9.097126135,-7.220446268,15253
39001,"Adams","Ohio","US","2020-05-24 02:32:43",38.84541072,-83.4718964,8,1,0,7,"Adams, Ohio, US",27698,4,346,326,20,5,-21,-16,0,338,11.770652802,0.7221259388,0.1805314847,-0.758232236,-0.577700751,7109
42001,"Adams","Pennsylvania","US","2020-05-24 02:32:43",39.87140411,-77.21610347,222,6,0,216,"Adams, Pennsylvania, US",103009,-53,960,1013,-53,54,-50,4,-4,4037,9.8315629079,-0.514385818,0.5240912113,-0.48526964,0.0388215712,34853
53001,"Adams","Washington","US","2020-05-24 02:32:43",46.98299757,-118.5601734,50,0,0,50,"Adams, Washington, US",19983,247,388,100,288,24,-65,-41,0,162,5.0353734988,14.501875677,1.2084896397,-3.272992774,-2.064503135,7733
55001,"Adams","Wisconsin","US","2020-05-24 02:32:43",43.96974651,-89.76782777,4,1,0,3,"Adams, Wisconsin, US",20220,-121,123,252,-129,8,1,9,-1,1025,12.425729149,-6.360789921,0.394467592,0.049308449,0.443776041,4373
50001,"Addison","Vermont","US","2020-05-24 02:32:43",44.03217337,-73.14130877,62,2,0,60,"Addison, Vermont, US",36777,-96,299,341,-42,20,-72,-52,-2,2965,9.2600135777,-1.140529532,0.5431093007,-1.955193483,-1.412084182,16116
45003,"Aiken","South Carolina","US","2020-05-24 02:32:43",33.54338026,-81.63645384,169,7,0,162,"Aiken, South Carolina, US",170872,1423,1830,1824,6,140,1272,1412,5,2317,10.719291492,0.0352608273,0.8227526365,7.4752953829,8.2980480194,64571
27001,"Aitkin","Minnesota","US","2020-05-24 02:32:43",46.60962049,-93.4116826,6,0,0,6,"Aitkin, Minnesota, US",15886,-1,124,207,-83,-1,84,83,-1,274,13.029931074,-5.224561735,-0.062946527,5.2875082617,5.2245617348,4961
12001,"Alachua","Florida","US","2020-05-24 02:32:43",29.67866525,-82.35928158,355,7,0,348,"Alachua, Florida, US",269043,192,2775,2081,694,798,-1302,-504,2,14648,7.7375839849,2.5804340632,2.9671273522,-4.841102522,-1.87397517,130130
37001,"Alamance","North Carolina","US","2020-05-24 02:32:43",36.0434701,-79.39976137,268,20,0,248,"Alamance, North Carolina, US",169509,2995,1976,1646,330,67,2588,2655,10,6309,9.7969484232,1.9641512635,0.3987822262,15.403707484,15.802489711,61254
6001,"Alameda","California","US","2020-05-24 02:32:43",37.64629437,-121.8929271,2760,92,0,2668,"Alameda, California, US",1671329,4573,18628,10944,7684,8540,-11626,-3086,-25,36951,6.5570529211,4.60383723,5.1167061354,-6.965670437,-1.848964301,699741
8003,"Alamosa","Colorado","US","2020-05-24 02:32:43",37.57250606,-105.7885451,55,2,0,53,"Alamosa, Colorado, US",16233,-15,198,115,83,-4,-93,-97,-1,852,7.0810627752,5.1106800899,-0.246297836,-5.726424679,-5.972722515,8340
36001,"Albany","New York","US","2020-05-24 02:32:43",42.60060306,-73.97723916,1770,76,0,1694,"Albany, New York, US",305506,-1079,3024,2776,248,546,-1872,-1326,-1,17251,9.0705466998,0.8103370251,1.7840484503,-6.116737544,-4.332689094,221934
56001,"Albany","Wyoming","US","2020-05-24 02:32:43",41.65498705,-105.7235415,14,0,0,14,"Albany, Wyoming, US",38880,152,341,198,143,259,-253,6,3,2310,5.1025667457,3.6851870941,6.674569632,-6.519946397,0.1546232347,19737
51003,"Albemarle","Virginia","US","2020-05-24 02:32:43",38.02080697,-78.55481085,143,5,0,138,"Albemarle, Virginia, US",109330,953,1061,894,167,133,656,789,-3,6685,8.2128732654,1.5341720753,1.2218256648,6.0264483916,7.2482740564,55872
26001,"Alcona","Michigan","US","2020-05-24 02:32:43",44.6846864,-83.59507875,10,1,0,9,"Alcona, Michigan, US",10405,45,57,167,-110,3,150,153,2,127,16.084758006,-10.59475078,0.2889477486,14.447387431,14.736335179,2021
28003,"Alcorn","Mississippi","US","2020-05-24 02:32:43",34.88084463,-88.57996173,15,1,0,14,"Alcorn, Mississippi, US",36953,143,411,457,-46,-7,197,190,-1,788,12.391036156,-1.247237775,-0.189797053,5.3414313409,5.1516342882,14949
17003,"Alexander","Illinois","US","2020-05-24 02:32:43",37.18049267,-89.32910838,8,0,0,8,"Alexander, Illinois, US",5761,-280,54,72,-18,0,-263,-263,1,132,12.20132181,-3.050330452,0,-44.56871717,-44.56871717,1780
37003,"Alexander","North Carolina","US","2020-05-24 02:32:43",35.9223796,-81.17751948,27,0,0,27,"Alexander, North Carolina, US",37497,166,363,399,-36,0,203,203,-1,1502,10.664457155,-0.962206661,0,5.4257764473,5.4257764473,10362
51510,"Alexandria","Virginia","US","2020-05-24 02:32:43",38.814003,-77.08183073,1703,38,0,1665,"Alexandria, Virginia, US",159428,359,2566,782,1784,1208,-2615,-1407,-18,1834,4.9105643067,11.202617293,7.58562875,-16.42087681,-8.835248056,99181
40003,"Alfalfa","Oklahoma","US","2020-05-24 02:32:43",36.73090616,-98.32408495,1,0,0,1,"Alfalfa, Oklahoma, US",5702,-63,47,54,-7,6,-62,-56,0,1051,9.4183308625,-1.220894741,1.0464812069,-10.81363914,-9.767157931,2335
19005,"Allamakee","Iowa","US","2020-05-24 02:32:43",43.28383218,-91.37860922,118,4,0,114,"Allamakee, Iowa, US",13687,-165,192,178,14,16,-194,-178,-1,214,12.927121537,1.0167398961,1.1619884527,-14.08910999,-12.92712154,5310
26005,"Allegan","Michigan","US","2020-05-24 02:32:43",42.59147037,-85.89102866,202,7,0,195,"Allegan, Michigan, US",118081,908,1285,925,360,49,504,553,-5,955,7.8638407849,3.060521819,0.4165710254,4.2847305466,4.7013015719,41136
24001,"Allegany","Maryland","US","2020-05-24 02:32:43",39.62357628,-78.69280486,168,14,0,154,"Allegany, Maryland, US",70416,-525,640,874,-234,42,-332,-290,-1,7597,12.365853831,-3.310766358,0.5942401155,-4.697326627,-4.103086511,32388
36003,"Allegany","New York","US","2020-05-24 02:32:43",42.25748406,-78.02750466,44,0,0,44,"Allegany, New York, US",46091,-241,445,460,-15,28,-254,-226,0,4223,9.9542321716,-0.324594527,0.6059097844,-5.49646733,-4.890557545,16746
37005,"Alleghany","North Carolina","US","2020-05-24 02:32:43",36.49360862,-81.12857041,13,0,0,13,"Alleghany, North Carolina, US",11137,-1,99,133,-34,5,29,34,-1,109,11.941638608,-3.052749719,0.4489337823,2.6038159371,3.0527497194,4016
51005,"Alleghany","Virginia","US","2020-05-24 02:32:43",37.78636074,-80.00222498,13,2,0,11,"Alleghany, Virginia, US",14860,-126,121,238,-117,-5,-3,-8,-1,281,15.948535817,-7.840246599,-0.335053273,-0.201031964,-0.536085238,6499
42003,"Allegheny","Pennsylvania","US","2020-05-24 02:32:43",40.46809875,-79.98167747,1753,158,0,1595,"Allegheny, Pennsylvania, US",1216045,-1236,12668,13695,-1027,2392,-2543,-151,-58,34966,11.256198306,-0.844112133,1.9660333223,-2.090143285,-0.124109963,688112
18003,"Allen","Indiana","US","2020-05-24 02:32:43",41.09194313,-85.06800636,1213,65,0,1148,"Allen, Indiana, US",379299,4220,5155,3162,1993,747,1492,2239,-12,6121,8.3830652538,5.2838232292,1.9804395144,3.9555766473,5.9360161617,180250
20001,"Allen","Kansas","US","2020-05-24 02:32:43",37.88582951,-95.30030847,1,0,0,1,"Allen, Kansas, US",12369,-132,138,161,-23,8,-115,-107,-2,382,12.947326096,-1.849618014,0.6433453961,-9.248090068,-8.604744672,6518
21003,"Allen","Kentucky","US","2020-05-24 02:32:43",36.75197631,-86.19457544,47,2,0,45,"Allen, Kentucky, US",21315,193,239,242,-3,1,195,196,0,197,11.40514174,-0.141386055,0.0471286849,9.1900935504,9.2372222353,5652
22003,"Allen","Louisiana","US","2020-05-24 02:32:43",30.65385745,-92.82442028,182,10,0,172,"Allen, Louisiana, US",25627,60,315,242,73,-3,-9,-12,-1,4181,9.4542329179,2.8518967066,-0.117201235,-0.351603704,-0.468804938,8103
39003,"Allen","Ohio","US","2020-05-24 02:32:43",40.77285242,-84.10802343,184,31,0,153,"Allen, Ohio, US",102351,-374,1214,1079,135,-8,-501,-509,0,5814,10.522928085,1.3165850709,-0.078019856,-4.885993485,-4.964013341,52798
45005,"Allendale","South Carolina","US","2020-05-24 02:32:43",32.98837386,-81.35321066,34,3,0,31,"Allendale, South Carolina, US",8688,-236,81,102,-21,9,-226,-217,2,1056,11.583011583,-2.384737679,1.0220304338,-25.66431978,-24.64228935,3003
26007,"Alpena","Michigan","US","2020-05-24 02:32:43",45.03477666,-83.62212411,94,9,0,85,"Alpena, Michigan, US",28405,21,280,342,-62,8,76,84,-1,513,12.044586099,-2.183521457,0.2817447041,2.6765746888,2.9583193928,12933
6003,"Alpine","California","US","2020-05-24 02:32:43",38.59678594,-119.8223594,2,0,0,2,"Alpine, California, US",1129,40,10,5,5,1,35,36,-1,24,4.5085662759,4.5085662759,0.9017132552,31.559963931,32.461677187,689
6005,"Amador","California","US","2020-05-24 02:32:43",38.44583082,-120.65696,10,0,0,10,"Amador, California, US",39752,347,307,427,-120,17,451,468,-1,4368,10.788685776,-3.031949164,0.4295261316,11.395075609,11.824601741,11906
51007,"Amelia","Virginia","US","2020-05-24 02:32:43",37.34081025,-77.98584649,22,1,0,21,"Amelia, Virginia, US",13145,88,150,150,0,1,88,89,-1,128,11.449507671,0,0.0763300511,6.7170445004,6.7933745516,2800
51009,"Amherst","Virginia","US","2020-05-24 02:32:43",37.60308293,-79.14548696,25,0,0,25,"Amherst, Virginia, US",31605,-79,306,382,-76,1,0,1,-4,1400,12.07160802,-2.401681177,0.0316010681,0,0.0316010681,9477
28005,"Amite","Mississippi","US","2020-05-24 02:32:43",31.17467303,-90.80501621,50,1,0,49,"Amite, Mississippi, US",12297,-30,125,145,-20,-2,-7,-9,-1,113,11.777128005,-1.624431449,-0.162443145,-0.568551007,-0.730994152,2248
2020,"Anchorage","Alaska","US","2020-05-24 02:32:43",61.14998174,-149.1426986,206,4,0,202,"Anchorage, Alaska, US",288000,-2521,3923,1847,2076,364,-4972,-4608,11,7595,6.3852478994,7.1769218403,1.2583812861,-17.18865867,-15.93027738,166563
20003,"Anderson","Kansas","US","2020-05-24 02:32:43",38.21413251,-95.29272815,1,0,0,1,"Anderson, Kansas, US",7858,10,102,96,6,-4,8,4,0,103,12.224627531,0.7640392207,-0.50935948,1.0187189609,0.5093594805,2312
21005,"Anderson","Kentucky","US","2020-05-24 02:32:43",38.00671029,-84.99171713,15,1,0,14,"Anderson, Kentucky, US",22747,106,252,211,41,6,59,65,0,108,9.2976117035,1.8066449282,0.2643870627,2.5998061162,2.8641931788,4961
45007,"Anderson","South Carolina","US","2020-05-24 02:32:43",34.51828081,-82.63959517,218,8,0,210,"Anderson, South Carolina, US",202558,2266,2266,2200,66,67,2133,2200,0,2988,10.922179471,0.3276653841,0.3326300112,10.58954946,10.922179471,67805
47001,"Anderson","Tennessee","US","2020-05-24 02:32:43",36.12684348,-84.19965764,39,1,0,38,"Anderson, Tennessee, US",76978,691,792,932,-140,51,783,834,-3,1261,12.161941735,-1.826901119,0.6655139791,10.217596973,10.883110952,46938
48001,"Anderson","Texas","US","2020-05-24 02:32:43",31.81534745,-95.65354823,63,0,0,63,"Anderson, Texas, US",57735,-239,588,754,-166,32,-104,-72,-1,14445,13.032694086,-2.869266868,0.5531116853,-1.797612977,-1.244501292,19817
29003,"Andrew","Missouri","US","2020-05-24 02:32:43",39.98492163,-94.80163024,20,0,0,20,"Andrew, Missouri, US",17712,50,190,161,29,-2,24,22,-1,192,9.1027308192,1.6396223215,-0.113077401,1.3569288178,1.2438514163,2717
48003,"Andrews","Texas","US","2020-05-24 02:32:43",32.30468633,-102.6376548,22,0,0,22,"Andrews, Texas, US",18705,694,286,189,97,14,583,597,0,78,10.295239133,5.2837999782,0.7626103061,31.757272034,32.51988234,7791
23001,"Androscoggin","Maine","US","2020-05-24 02:32:43",44.1664747,-70.20380627,227,2,0,225,"Androscoggin, Maine, US",108277,363,1208,1084,124,92,150,242,-3,3276,10.028169535,1.1471337845,0.8510992595,1.3876618361,2.2387610955,49061
48005,"Angelina","Texas","US","2020-05-24 02:32:43",31.25457347,-94.60901487,168,2,0,166,"Angelina, Texas, US",86715,-95,1071,997,74,6,-173,-167,-2,2733,11.491139605,0.8529030399,0.0691543005,-1.993948999,-1.924794698,36651
24003,"Anne Arundel","Maryland","US","2020-05-24 02:32:43",39.00670238,-76.60329337,3282,150,0,3132,"Anne Arundel, Maryland, US",579234,3711,6782,4661,2121,436,1162,1598,-8,14455,8.072694082,3.673500139,0.755137228,2.0125446306,2.7676818586,284090
27003,"Anoka","Minnesota","US","2020-05-24 02:32:43",45.27476015,-93.24604565,1092,55,0,1037,"Anoka, Minnesota, US",356921,3480,4218,2166,2052,234,1216,1450,-22,2944,6.098299177,5.7773360625,0.6588190247,3.4236065555,4.0824255802,119433
37007,"Anson","North Carolina","US","2020-05-24 02:32:43",34.97403241,-80.09953279,58,0,0,58,"Anson, North Carolina, US",24446,-24,253,272,-19,29,-33,-4,-1,1698,11.121105569,-0.776841933,1.1857061084,-1.349251779,-0.16354567,8046
31003,"Antelope","Nebraska","US","2020-05-24 02:32:43",42.17695516,-98.0666283,7,0,0,7,"Antelope, Nebraska, US",6298,-10,80,59,21,4,-35,-31,0,54,9.3606219261,3.3317467872,0.6346184357,-5.552911312,-4.918292876,2794
26009,"Antrim","Michigan","US","2020-05-24 02:32:43",44.99690221,-85.15503082,11,0,0,11,"Antrim, Michigan, US",23324,1,156,276,-120,7,115,122,-1,226,11.833558428,-5.145025404,0.3001264819,4.9306493451,5.230775827,6394
4001,"Apache","Arizona","US","2020-05-24 02:32:43",35.39465006,-109.4892383,1144,25,0,1119,"Apache, Arizona, US",71887,156,934,702,232,37,-112,-75,-1,956,9.7759333788,3.2307927976,0.5152557479,-1.559693075,-1.044437327,16695
19007,"Appanoose","Iowa","US","2020-05-24 02:32:43",40.74324454,-92.86865906,9,3,0,6,"Appanoose, Iowa, US",12426,25,127,170,-43,0,69,69,-1,122,13.694767793,-3.463970677,0,5.5584645749,5.5584645749,5301
13001,"Appling","Georgia","US","2020-05-24 02:32:43",31.74847232,-82.28909114,124,13,0,111,"Appling, Georgia, US",18386,-140,225,213,12,2,-154,-152,0,416,11.540962289,0.6501950585,0.1083658431,-8.344169918,-8.235804075,7462
51011,"Appomattox","Virginia","US","2020-05-24 02:32:43",37.37569884,-78.81340003,26,0,0,26,"Appomattox, Virginia, US",15911,30,184,186,-2,9,24,33,-1,56,11.70105687,-0.125817816,0.5661801711,1.5098137896,2.0759939607,3520
48007,"Aransas","Texas","US","2020-05-24 02:32:43",28.10556197,-96.9995047,5,0,0,5,"Aransas, Texas, US",23510,64,193,365,-172,-11,247,236,0,439,15.546469035,-7.326007326,-0.468523724,10.520487265,10.05196354,7052
8005,"Arapahoe","Colorado","US","2020-05-24 02:32:43",39.64977461,-104.3353617,4027,278,0,3749,"Arapahoe, Colorado, US",656590,4793,7605,4149,3456,2507,-1165,1342,-5,5014,6.3421602324,5.2828406274,3.8321994945,-1.780818672,2.0513808223,298038
48009,"Archer","Texas","US","2020-05-24 02:32:43",33.61569967,-98.68754589,1,0,0,1,"Archer, Texas, US",8553,-147,70,144,-74,0,-72,-72,-1,54,16.692749087,-8.578218281,0,-8.346374544,-8.346374544,2089
8007,"Archuleta","Colorado","US","2020-05-24 02:32:43",37.19474156,-107.0476867,8,0,0,8,"Archuleta, Colorado, US",14029,299,127,93,34,9,255,264,1,129,6.700529558,2.4496559674,0.6484383443,18.372419756,19.0208581,4950
26011,"Arenac","Michigan","US","2020-05-24 02:32:43",44.0636262,-83.89277559,32,1,0,31,"Arenac, Michigan, US",14883,-125,110,206,-96,0,-28,-28,-1,207,13.783413067,-6.423338129,0,-1.873473621,-1.873473621,4821
5001,"Arkansas","Arkansas","US","2020-05-24 02:32:43",34.29145151,-91.37277296,2,0,0,2,"Arkansas, Arkansas, US",17486,-240,206,216,-10,-3,-229,-232,2,247,12.268544814,-0.567988186,-0.170396456,-13.00692946,-13.17732591,9409
51013,"Arlington","Virginia","US","2020-05-24 02:32:43",38.8767675,-77.10139853,1804,95,0,1709,"Arlington, Virginia, US",236842,817,2887,1020,1867,1057,-2110,-1053,3,2924,4.3141094642,7.8965121271,4.4706016702,-8.924285264,-4.453683594,190029
42005,"Armstrong","Pennsylvania","US","2020-05-24 02:32:43",40.81665618,-79.46290811,58,3,0,55,"Armstrong, Pennsylvania, US",64735,-617,643,881,-238,0,-378,-378,-1,650,13.544781569,-3.659089686,0,-5.811495384,-5.811495384,19549
48011,"Armstrong","Texas","US","2020-05-24 02:32:43",34.96507426,-101.3574874,2,0,0,2,"Armstrong, Texas, US",1887,8,19,20,-1,0,10,10,-1,53,10.621348911,-0.531067446,0,5.3106744557,5.3106744557,499
23003,"Aroostook","Maine","US","2020-05-24 02:32:43",46.65926321,-68.59841248,8,1,0,7,"Aroostook, Maine, US",67055,-263,613,865,-252,39,-45,-6,-5,2184,12.874610227,-3.7507535,0.5804737559,-0.669777411,-0.089303655,29421
31005,"Arthur","Nebraska","US","2020-05-24 02:32:43",41.56896142,-101.6959559,0,0,0,0,"Arthur, Nebraska, US",463,1,3,3,0,0,3,3,-2,0,6.4864864865,0,0,6.4864864865,6.4864864865,155
22005,"Ascension","Louisiana","US","2020-05-24 02:32:43",30.20406249,-90.9132841,785,52,0,733,"Ascension, Louisiana, US",126604,1746,1683,927,756,38,955,993,-3,788,7.372883378,6.0128369296,0.3022325441,7.5955810421,7.8978135861,40645
37009,"Ashe","North Carolina","US","2020-05-24 02:32:43",36.43296207,-81.49862729,33,0,0,33,"Ashe, North Carolina, US",27203,104,216,350,-134,-13,251,238,0,318,12.890869581,-4.935361497,-0.478803727,9.2445950425,8.7657913152,9157
39005,"Ashland","Ohio","US","2020-05-24 02:32:43",40.84772277,-82.27280781,17,0,0,17,"Ashland, Ohio, US",53484,-222,586,580,6,56,-285,-229,1,2349,10.821905028,0.1119507417,1.044873589,-5.317660229,-4.272786641,19703
55003,"Ashland","Wisconsin","US","2020-05-24 02:32:43",46.31956891,-90.67837132,2,0,0,2,"Ashland, Wisconsin, US",15562,-25,179,167,12,3,-40,-37,0,573,10.722655623,0.7704902244,0.1926225561,-2.568300748,-2.375678192,8452
5003,"Ashley","Arkansas","US","2020-05-24 02:32:43",33.19153461,-91.7698471,19,0,0,19,"Ashley, Arkansas, US",19657,-355,213,251,-38,-4,-313,-317,0,191,12.65471779,-1.915853689,-0.201668809,-15.78058434,-15.98225314,7581
39007,"Ashtabula","Ohio","US","2020-05-24 02:32:43",41.70860332,-80.74830218,274,31,0,243,"Ashtabula, Ohio, US",97241,-346,1111,1143,-32,-6,-307,-313,-1,3446,11.733426407,-0.328494878,-0.06159279,-3.151497731,-3.213090521,32599
53003,"Asotin","Washington","US","2020-05-24 02:32:43",46.18894415,-117.2022851,18,2,0,16,"Asotin, Washington, US",22582,-34,223,266,-43,-27,38,11,-2,174,11.77043232,-1.902739059,-1.19474313,1.6814903314,0.4867472012,6231
22007,"Assumption","Louisiana","US","2020-05-24 02:32:43",29.89946234,-91.06461642,238,11,0,227,"Assumption, Louisiana, US",21891,-388,238,233,5,-2,-393,-395,2,199,10.550147159,0.2263980077,-0.090559203,-17.79488341,-17.88544261,3732
48013,"Atascosa","Texas","US","2020-05-24 02:32:43",28.89333001,-98.52730485,35,1,0,34,"Atascosa, Texas, US",51153,831,710,435,275,8,551,559,-3,358,8.5735402809,5.4200542005,0.157674304,10.859817689,11.017491993,16182
20005,"Atchison","Kansas","US","2020-05-24 02:32:43",39.53185661,-95.30870026,19,0,0,19,"Atchison, Kansas, US",16073,-100,162,170,-8,-2,-90,-92,0,1385,10.543943435,-0.496185573,-0.124046393,-5.582087701,-5.706134094,7050
29005,"Atchison","Missouri","US","2020-05-24 02:32:43",40.43238737,-95.42970639,3,0,0,3,"Atchison, Missouri, US",5143,-40,41,72,-31,2,-11,-9,0,98,13.945380593,-6.004261089,0.3873716831,-2.130544257,-1.743172574,2145
39009,"Athens","Ohio","US","2020-05-24 02:32:43",39.33425634,-82.04278644,13,1,0,12,"Athens, Ohio, US",65327,-192,477,494,-17,128,-305,-177,2,9542,7.5508613179,-0.259847454,1.9564984791,-4.661969032,-2.705470553,26880
13003,"Atkinson","Georgia","US","2020-05-24 02:32:43",31.29633502,-82.87545866,26,2,0,24,"Atkinson, Georgia, US",8165,-97,122,61,61,-1,-156,-157,-1,21,7.4267973458,7.4267973458,-0.121750776,-18.99312108,-19.11487186,2232
34001,"Atlantic","New Jersey","US","2020-05-24 02:32:43",39.47538693,-74.65848483,1936,143,0,1793,"Atlantic, New Jersey, US",263670,-319,2718,2793,-75,271,-507,-236,-8,5986,10.586382493,-0.284274503,1.0271785377,-1.921695641,-0.894517103,129557
40005,"Atoka","Oklahoma","US","2020-05-24 02:32:43",34.37366573,-96.03802487,1,0,0,1,"Atoka, Oklahoma, US",13758,-37,153,130,23,3,-61,-58,-2,748,9.4363590172,1.6695096723,0.2177621312,-4.42783,-4.210067869,3675
28007,"Attala","Mississippi","US","2020-05-24 02:32:43",33.08658803,-89.57838564,270,12,0,258,"Attala, Mississippi, US",18174,-154,221,233,-12,0,-141,-141,-1,345,12.766423758,-0.657498219,0,-7.725604076,-7.725604076,4928
29007,"Audrain","Missouri","US","2020-05-24 02:32:43",39.215877,-91.84242683,34,0,0,34,"Audrain, Missouri, US",25388,-35,309,272,37,4,-76,-72,0,2318,10.706343115,1.456377556,0.1574462223,-2.991478223,-2.834032001,10340
19009,"Audubon","Iowa","US","2020-05-24 02:32:43",41.6844628,-94.90581859,11,1,0,10,"Audubon, Iowa, US",5496,25,60,63,-3,1,29,30,-2,112,11.489012492,-0.547095833,0.1823652777,5.2885930519,5.4709583295,2283
39011,"Auglaize","Ohio","US","2020-05-24 02:32:43",40.55998859,-84.2242143,58,3,0,55,"Auglaize, Ohio, US",45656,-80,559,493,66,18,-165,-147,1,526,10.788690476,1.4443277311,0.393907563,-3.610819328,-3.216911765,20340
51015,"Augusta","Virginia","US","2020-05-24 02:32:43",38.16404586,-79.12461614,89,1,0,88,"Augusta, Virginia, US",75558,23,534,759,-225,24,228,252,-4,2913,10.046792373,-2.978298134,0.3176851343,3.0180087761,3.3356939104,28326
46003,"Aurora","South Dakota","US","2020-05-24 02:32:43",43.71757685,-98.56050467,22,0,0,22,"Aurora, South Dakota, US",2751,-34,39,24,15,2,-52,-50,1,95,8.6705202312,5.4190751445,0.7225433526,-18.78612717,-18.06358382,1247
48015,"Austin","Texas","US","2020-05-24 02:32:43",29.88548725,-96.27736949,21,0,0,21,"Austin, Texas, US",30032,67,328,274,54,2,13,15,-2,209,9.1337900228,1.8000900045,0.0666700002,0.4333550011,0.5000250013,10362
1001,"Autauga","Alabama","US","2020-05-24 02:32:43",32.53952745,-86.64408227,155,3,0,152,"Autauga, Alabama, US",55869,336,624,541,83,-16,270,254,-1,455,9.7125724852,1.490098921,-0.287247985,4.8473097431,4.5600617583,13221
37011,"Avery","North Carolina","US","2020-05-24 02:32:43",36.07569796,-81.92308483,2,0,0,2,"Avery, North Carolina, US",17557,29,130,215,-85,10,106,116,-2,2505,12.255949836,-4.845375517,0.5700441784,6.0424682913,6.6125124697,7608
22009,"Avoyelles","Louisiana","US","2020-05-24 02:32:43",31.07796211,-92.00079449,101,9,0,92,"Avoyelles, Louisiana, US",40144,-258,510,452,58,5,-320,-315,-1,3348,11.223400293,1.4401708341,0.1241526581,-7.945770119,-7.821617461,11218
8009,"Baca","Colorado","US","2020-05-24 02:32:43",37.31940883,-102.5603223,12,0,0,12,"Baca, Colorado, US",3581,-3,37,46,-9,3,3,6,0,82,12.840195394,-2.512212142,0.8374040475,0.8374040475,1.6748080949,1650
13005,"Bacon","Georgia","US","2020-05-24 02:32:43",31.55456473,-82.45936528,76,2,0,74,"Bacon, Georgia, US",11164,32,158,108,50,-5,-14,-19,1,296,9.6878363832,4.4851094367,-0.448510944,-1.255830642,-1.704341586,4430
48017,"Bailey","Texas","US","2020-05-24 02:32:43",34.06854817,-102.8299707,10,0,0,10,"Bailey, Texas, US",7000,-15,124,39,85,23,-123,-100,0,104,5.5654655726,12.129860863,3.2821976454,-17.55262219,-14.27042455,2642
12003,"Baker","Florida","US","2020-05-24 02:32:43",30.33060121,-82.28467476,27,3,0,24,"Baker, Florida, US",29210,857,322,273,49,5,802,807,1,2839,9.4852596286,1.7024824974,0.1737227038,27.865121693,28.038844397,6373
13007,"Baker","Georgia","US","2020-05-24 02:32:43",31.32669878,-84.44218806,33,2,0,31,"Baker, Georgia, US",3038,-48,30,22,8,-1,-55,-56,0,0,7.1848465056,2.6126714566,-0.326583932,-17.96211626,-18.2887002,669
41001,"Baker","Oregon","US","2020-05-24 02:32:43",44.70915557,-117.6749883,1,0,0,1,"Baker, Oregon, US",16124,90,153,211,-58,10,139,149,-1,428,13.122706636,-3.607189502,0.6219292245,8.6448162199,9.2667454444,5965
1003,"Baldwin","Alabama","US","2020-05-24 02:32:43",30.72774991,-87.72207058,273,9,0,264,"Baldwin, Alabama, US",223234,5379,2304,2326,-22,80,5297,5377,24,2170,10.546624377,-0.099753111,0.3627385856,24.017828601,24.380567187,68396
13009,"Baldwin","Georgia","US","2020-05-24 02:32:43",33.06882326,-83.24701748,329,24,0,305,"Baldwin, Georgia, US",44890,-3,411,480,-69,27,42,69,-3,5828,10.692447345,-1.537039306,0.6014501632,0.9355891427,1.5370393059,16454
21007,"Ballard","Kentucky","US","2020-05-24 02:32:43",37.05842757,-88.99427697,9,0,0,9,"Ballard, Kentucky, US",7888,-104,76,98,-22,0,-82,-82,0,127,12.34256927,-2.770780856,0,-10.32745592,-10.32745592,2732
24005,"Baltimore","Maryland","US","2020-05-24 02:32:43",39.45784712,-76.62911955,5290,299,0,4991,"Baltimore, Maryland, US",827370,-489,9598,8601,997,1727,-3211,-1484,-2,21405,10.392519706,1.2046671488,2.0867203269,-3.879825692,-1.793105365,351234
24510,"Baltimore City","Maryland","US","2020-05-24 02:32:43",39.30211911,-76.61151012,4673,229,0,4444,"Baltimore City, Maryland, US",593490,-8953,7555,6873,682,1290,-10919,-9629,-6,26613,11.493954929,1.1405321201,2.1573114882,-18.26022026,-16.10290877,371992
45009,"Bamberg","South Carolina","US","2020-05-24 02:32:43",33.21927586,-81.05659969,20,0,0,20,"Bamberg, South Carolina, US",14066,-206,124,196,-72,0,-133,-133,-1,998,13.833015739,-5.081515986,0,-9.386689251,-9.386689251,4717
48019,"Bandera","Texas","US","2020-05-24 02:32:43",29.74619598,-99.24598147,6,0,0,6,"Bandera, Texas, US",23112,320,185,239,-54,3,370,373,1,304,10.413035901,-2.352736145,0.1307075636,16.120599512,16.251307076,4873
13011,"Banks","Georgia","US","2020-05-24 02:32:43",34.35607081,-83.49644388,73,0,0,73,"Banks, Georgia, US",19234,262,219,158,61,11,191,202,-1,0,8.2709522065,3.1932157253,0.5758257865,9.998429566,10.574255353,4485
16005,"Bannock","Idaho","US","2020-05-24 02:32:43",42.67002716,-112.2233311,17,0,0,17,"Bannock, Idaho, US",87808,1134,1170,709,461,66,606,672,1,2016,8.1269128048,5.2842126982,0.7565250284,6.9462752605,7.7028002889,34280
26013,"Baraga","Michigan","US","2020-05-24 02:32:43",46.6720582,-88.36363591,1,0,0,1,"Baraga, Michigan, US",8209,-115,62,117,-55,4,-63,-59,-1,1010,14.153511159,-6.653359947,0.4838807234,-7.621121394,-7.13724067,2789
20007,"Barber","Kansas","US","2020-05-24 02:32:43",37.2288586,-98.68460053,1,0,0,1,"Barber, Kansas, US",4427,-38,50,48,2,1,-41,-40,0,40,10.796221323,0.4498425551,0.2249212776,-9.22177238,-8.996851102,2254
1005,"Barbour","Alabama","US","2020-05-24 02:32:43",31.868263,-85.3871286,105,1,0,104,"Barbour, Alabama, US",24686,-186,256,312,-56,13,-141,-128,-2,2812,12.591307155,-2.259978207,0.5246377981,-5.690302272,-5.165664474,8437
54001,"Barbour","West Virginia","US","2020-05-24 02:32:43",39.1307219,-80.00350858,7,1,0,6,"Barbour, West Virginia, US",16441,-46,169,207,-38,-4,-3,-7,-1,853,12.572886297,-2.308066084,-0.242954325,-0.182215743,-0.425170068,3511
38003,"Barnes","North Dakota","US","2020-05-24 02:32:43",46.93579637,-98.06605978,4,0,0,4,"Barnes, North Dakota, US",10415,-112,90,126,-36,-6,-69,-75,-1,535,12.033234648,-3.438067042,-0.573011174,-6.589628498,-7.162639671,5449
25001,"Barnstable","Massachusetts","US","2020-05-24 02:32:43",41.72980578,-70.28854339,1264,107,0,1157,"Barnstable, Massachusetts, US",212990,-481,1524,2917,-1393,317,616,933,-21,4129,13.680031703,-6.532836531,1.4866541137,2.8888925365,4.3755466502,97409
45011,"Barnwell","South Carolina","US","2020-05-24 02:32:43",33.26679302,-81.43584352,43,1,0,42,"Barnwell, South Carolina, US",20866,-255,234,286,-52,1,-204,-203,0,285,13.623264344,-2.476957153,0.0476337914,-9.717293448,-9.669659657,6884
21009,"Barren","Kentucky","US","2020-05-24 02:32:43",36.96469836,-85.93338945,42,1,0,41,"Barren, Kentucky, US",44249,134,557,519,38,0,98,98,-2,702,11.746865239,0.8600787651,0,2.2180978679,2.2180978679,18434
55005,"Barron","Wisconsin","US","2020-05-24 02:32:43",45.42372701,-91.84833627,12,0,0,12,"Barron, Wisconsin, US",45244,94,486,470,16,11,69,80,-2,658,10.398920282,0.3540057968,0.2433789853,1.5266499989,1.7700289842,21887
13013,"Barrow","Georgia","US","2020-05-24 02:32:43",33.99148694,-83.71436292,283,11,0,272,"Barrow, Georgia, US",83240,2406,1062,659,403,44,1949,1993,10,360,8.0329607372,4.9124175677,0.5363433573,23.757572803,24.29391616,17663
26015,"Barry","Michigan","US","2020-05-24 02:32:43",42.59513984,-85.30834519,59,2,0,57,"Barry, Michigan, US",61550,319,625,581,44,20,258,278,-3,604,9.4640050171,0.7167232715,0.3257833052,4.2026046375,4.5283879428,13716
29009,"Barry","Missouri","US","2020-05-24 02:32:43",36.70978521,-93.82919888,8,0,0,8,"Barry, Missouri, US",35789,77,410,403,7,7,65,72,-2,296,11.272569614,0.1958014573,0.1958014573,1.8181563894,2.0139578467,15733
18005,"Bartholomew","Indiana","US","2020-05-24 02:32:43",39.20744865,-85.89558181,467,33,0,434,"Bartholomew, Indiana, US",83779,1057,1015,734,281,629,151,780,-4,1148,8.8167638633,3.375355103,7.5555101771,1.8138029201,9.3693130972,48100
20009,"Barton","Kansas","US","2020-05-24 02:32:43",38.47889676,-98.75636726,36,1,0,35,"Barton, Kansas, US",25779,-278,271,304,-33,5,-250,-245,0,672,11.7293001,-1.273246392,0.1929161201,-9.645806004,-9.452889883,12907
13015,"Bartow","Georgia","US","2020-05-24 02:32:43",34.23732119,-84.83887523,444,36,0,408,"Bartow, Georgia, US",107738,1360,1268,982,286,20,1050,1070,4,1034,9.172598031,2.671449121,0.1868146238,9.8077677521,9.9945823759,37146
48021,"Bastrop","Texas","US","2020-05-24 02:32:43",30.10370699,-97.31206354,161,2,0,159,"Bastrop, Texas, US",88723,2128,1093,727,366,-48,1809,1761,1,2173,8.2935009526,4.1752700807,-0.547576404,20.636785727,20.089209322,18184
29013,"Bates","Missouri","US","2020-05-24 02:32:43",38.25271289,-94.34113157,7,1,0,6,"Bates, Missouri, US",16172,-132,181,171,10,-1,-140,-141,-1,311,10.530853553,0.6158393891,-0.061583939,-8.621751447,-8.683335386,4545
21011,"Bath","Kentucky","US","2020-05-24 02:32:43",38.14735938,-83.74588932,8,1,0,7,"Bath, Kentucky, US",12500,56,194,161,33,-2,26,24,-1,103,12.908915972,2.6459268762,-0.160359205,2.08466966,1.9243104554,2265
51017,"Bath","Virginia","US","2020-05-24 02:32:43",38.05852573,-79.73912095,0,0,0,0,"Bath, Virginia, US",4147,-106,30,62,-32,-1,-73,-74,0,53,14.761904762,-7.619047619,-0.238095238,-17.38095238,-17.61904762,2064
5005,"Baxter","Arkansas","US","2020-05-24 02:32:43",36.28784385,-92.33782872,6,0,0,6,"Baxter, Arkansas, US",41932,308,349,695,-346,-1,656,655,-1,595,16.635549811,-8.281870841,-0.023936043,15.702044138,15.678108095,15469
12005,"Bay","Florida","US","2020-05-24 02:32:43",30.26548745,-85.62122584,94,3,0,91,"Bay, Florida, US",174705,-11535,2222,1989,233,277,-12080,-11803,35,3940,11.021069692,1.291055424,1.5348598817,-66.93540567,-65.40054579,80424
26017,"Bay","Michigan","US","2020-05-24 02:32:43",43.70639106,-83.98731479,276,19,0,257,"Bay, Michigan, US",103126,-576,981,1163,-182,-5,-384,-389,-5,1438,11.246059528,-1.759916452,-0.048349353,-3.713230317,-3.76157967,35976
55007,"Bayfield","Wisconsin","US","2020-05-24 02:32:43",46.52868768,-91.19716729,3,1,0,2,"Bayfield, Wisconsin, US",15036,10,128,211,-83,2,91,93,0,124,14.037655512,-5.521921363,0.1330583461,6.0541547469,6.1872130929,4675
46005,"Beadle","South Dakota","US","2020-05-24 02:32:43",44.41464384,-98.27858469,118,2,0,116,"Beadle, South Dakota, US",18453,30,285,182,103,52,-124,-72,-1,620,9.8709187547,5.5862891854,2.8202625014,-6.725241349,-3.904978848,9144
37013,"Beaufort","North Carolina","US","2020-05-24 02:32:43",35.48531943,-76.84325809,35,0,0,35,"Beaufort, North Carolina, US",46994,-62,439,628,-189,3,128,131,-4,510,13.354598618,-4.019138756,0.0637958533,2.7219564062,2.7857522594,18050
45013,"Beaufort","South Carolina","US","2020-05-24 02:32:43",32.39226291,-80.72619758,332,12,0,320,"Beaufort, South Carolina, US",192122,3246,1923,1741,182,187,2862,3049,15,5738,9.1391555861,0.9553855926,0.9816324495,15.023700912,16.005333361,78166
22011,"Beauregard","Louisiana","US","2020-05-24 02:32:43",30.64836518,-93.34173616,56,4,0,52,"Beauregard, Louisiana, US",37497,128,531,412,119,11,1,12,-3,1292,11.006331312,3.1790131702,0.2938583603,0.0267143964,0.3205727567,9972
40007,"Beaver","Oklahoma","US","2020-05-24 02:32:43",36.7496847,-100.4758872,24,0,0,24,"Beaver, Oklahoma, US",5311,-7,52,46,6,12,-25,-13,0,43,8.6555649638,1.1289867344,2.2579734688,-4.704111393,-2.446137925,2161
42007,"Beaver","Pennsylvania","US","2020-05-24 02:32:43",40.6825484,-80.34921611,552,72,0,480,"Beaver, Pennsylvania, US",163929,-653,1506,2071,-565,9,-86,-77,-11,3195,12.608405807,-3.439763052,0.0547926858,-0.523574553,-0.468781867,59225
30001,"Beaverhead","Montana","US","2020-05-24 02:32:43",45.13434354,-112.8984694,1,0,0,1,"Beaverhead, Montana, US",9453,41,77,99,-22,13,49,62,1,442,10.495626822,-2.332361516,1.3782136231,5.1948051948,6.5730188179,4298
27005,"Becker","Minnesota","US","2020-05-24 02:32:43",46.93479392,-95.67158144,32,0,0,32,"Becker, Minnesota, US",34423,34,413,373,40,26,-31,-5,-1,458,10.841132361,1.1625879207,0.7556821485,-0.901005639,-0.14532349,14063
40009,"Beckham","Oklahoma","US","2020-05-24 02:32:43",35.26862449,-99.68128023,6,0,0,6,"Beckham, Oklahoma, US",21859,139,294,238,56,3,80,83,0,1929,10.922692122,2.5700452053,0.1376809931,3.6714931504,3.8091741435,12096
42009,"Bedford","Pennsylvania","US","2020-05-24 02:32:43",40.00522157,-78.48998442,37,2,0,35,"Bedford, Pennsylvania, US",47888,-206,447,553,-106,4,-103,-99,-1,551,11.522993895,-2.208747473,0.0833489613,-2.146235753,-2.062886791,17488
47003,"Bedford","Tennessee","US","2020-05-24 02:32:43",35.51123746,-86.45549096,264,4,0,260,"Bedford, Tennessee, US",49713,567,678,482,196,88,283,371,0,544,9.7512618983,3.9652434275,1.7803133756,5.7253259693,7.5056393449,16957
51019,"Bedford","Virginia","US","2020-05-24 02:32:43",37.3080028,-79.5281964,41,2,0,39,"Bedford, Virginia, US",78997,115,679,867,-188,19,289,308,-5,547,10.983094648,-2.381570697,0.2406906555,3.6610315495,3.901722205,19427
48025,"Bee","Texas","US","2020-05-24 02:32:43",28.41761668,-97.74215593,8,0,0,8,"Bee, Texas, US",32565,98,318,234,84,-5,18,13,1,7749,7.1964571288,2.5833435847,-0.153770451,0.5535736253,0.3998031738,9959
33001,"Belknap","New Hampshire","US","2020-05-24 02:32:43",43.51637314,-71.41684235,55,0,0,55,"Belknap, New Hampshire, US",61303,158,478,775,-297,28,432,460,-5,1060,12.658434601,-4.851038808,0.457336992,7.0560564485,7.5133934405,25236
21013,"Bell","Kentucky","US","2020-05-24 02:32:43",36.73355174,-83.67766671,1,0,0,1,"Bell, Kentucky, US",26032,-455,316,379,-63,5,-398,-393,1,947,14.432871913,-2.399131743,0.1904072812,-15.15641958,-14.9660123,9250
48027,"Bell","Texas","US","2020-05-24 02:32:43",31.03736027,-97.4785025,282,3,0,279,"Bell, Texas, US",362924,7527,5940,2304,3636,115,3745,3860,31,9982,6.4149593288,10.123607691,0.3201911123,10.42709318,10.747284292,157780
39013,"Belmont","Ohio","US","2020-05-24 02:32:43",40.01625942,-80.9924051,381,12,0,369,"Belmont, Ohio, US",67006,-527,608,856,-248,-12,-264,-276,-3,3802,12.724934777,-3.686663347,-0.178386936,-3.924512595,-4.102899531,23623
27007,"Beltrami","Minnesota","US","2020-05-24 02:32:43",47.97373527,-94.93732139,12,0,0,12,"Beltrami, Minnesota, US",47188,453,638,433,205,29,219,248,0,2002,9.2203187718,4.3652779404,0.6175271233,4.6633944827,5.280921606,20570
13017,"Ben Hill","Georgia","US","2020-05-24 02:32:43",31.76095874,-83.22145359,56,1,0,55,"Ben Hill, Georgia, US",16700,-122,197,225,-28,6,-100,-94,0,297,13.424020047,-1.670544717,0.3579738679,-5.966231132,-5.608257264,6106
50003,"Bennington","Vermont","US","2020-05-24 02:32:43",43.03519828,-73.09048868,60,1,0,59,"Bennington, Vermont, US",35470,-50,323,447,-124,15,60,75,-1,1473,12.593323003,-3.493449782,0.4225947317,1.6903789266,2.1129736583,19391
38005,"Benson","North Dakota","US","2020-05-24 02:32:43",48.0683985,-99.35916363,1,0,0,1,"Benson, North Dakota, US",6832,-126,139,69,70,1,-197,-196,0,16,10.007251632,10.152284264,0.1450326323,-28.57142857,-28.42639594,2488
8011,"Bent","Colorado","US","2020-05-24 02:32:43",37.95474293,-103.0720195,2,0,0,2,"Bent, Colorado, US",5577,-231,36,57,-21,2,-215,-213,3,1693,10.013175231,-3.689064559,0.3513394818,-37.76899429,-37.41765481,1329
5007,"Benton","Arkansas","US","2020-05-24 02:32:43",36.33644656,-94.25680817,237,0,0,237,"Benton, Arkansas, US",279141,6875,3744,1820,1924,107,4823,4930,21,2081,6.6012945066,6.9785113355,0.3880980836,17.493430442,17.881528526,116389
18007,"Benton","Indiana","US","2020-05-24 02:32:43",40.60626947,-87.31093999,24,0,0,24,"Benton, Indiana, US",8748,95,103,81,22,1,73,74,-1,92,9.309809781,2.5285903109,0.1149359232,8.3903223953,8.5052583185,2532
19011,"Benton","Iowa","US","2020-05-24 02:32:43",42.08011739,-92.06463573,37,1,0,36,"Benton, Iowa, US",25645,20,280,263,17,6,-1,5,-2,315,10.259410962,0.6631558416,0.2340550029,-0.039009167,0.1950458358,6443
27009,"Benton","Minnesota","US","2020-05-24 02:32:43",45.69804958,-93.99514135,161,2,0,159,"Benton, Minnesota, US",40889,379,538,330,208,50,123,173,-2,1049,8.1082077175,5.1106278947,1.2285163208,3.0221501493,4.2506664701,15884
28009,"Benton","Mississippi","US","2020-05-24 02:32:43",34.81681228,-89.18945516,14,0,0,14,"Benton, Mississippi, US",8259,16,88,92,-4,-3,23,20,0,78,11.150163617,-0.484789722,-0.363592292,2.7875409041,2.4239486123,1098
29015,"Benton","Missouri","US","2020-05-24 02:32:43",38.29503305,-93.28756116,10,0,0,10,"Benton, Missouri, US",19443,146,174,305,-131,-3,279,276,1,244,15.745998967,-6.763035622,-0.154878678,14.403717088,14.24883841,4398
41003,"Benton","Oregon","US","2020-05-24 02:32:43",44.49167306,-123.4316987,55,5,0,50,"Benton, Oregon, US",93053,611,701,584,117,331,168,499,-5,5638,6.2966656783,1.261489528,3.5688293485,1.8113695787,5.3801989272,40304
47005,"Benton","Tennessee","US","2020-05-24 02:32:43",36.07110411,-88.06849355,7,1,0,6,"Benton, Tennessee, US",16160,-86,166,259,-93,1,6,7,0,248,15.984694192,-5.739677837,0.061716966,0.370301796,0.432018762,4684
53005,"Benton","Washington","US","2020-05-24 02:32:43",46.23946995,-119.5120834,674,59,0,615,"Benton, Washington, US",204390,3104,2578,1467,1111,256,1740,1996,-3,1422,7.2323726323,5.4772774332,1.2620909297,8.5782742879,9.8403652176,83688
26019,"Benzie","Michigan","US","2020-05-24 02:32:43",44.63899297,-86.01608482,4,0,0,4,"Benzie, Michigan, US",17766,5,154,213,-59,-4,70,66,-2,252,11.990880176,-3.321417513,-0.225180848,3.9406648465,3.7154839981,4880
34003,"Bergen","New Jersey","US","2020-05-24 02:32:43",40.96010917,-74.07164325,17668,1521,0,16147,"Bergen, New Jersey, US",932202,-614,9153,7248,1905,1909,-4439,-2530,11,10435,7.7725791386,2.0428757256,2.0471652284,-4.760275772,-2.713110544,428068
45015,"Berkeley","South Carolina","US","2020-05-24 02:32:43",33.20222596,-79.94654523,214,15,0,199,"Berkeley, South Carolina, US",227907,6725,2774,1647,1127,285,5291,5576,22,3841,7.3348489943,5.0190496761,1.2692361648,23.563258062,24.832494227,59012
54003,"Berkeley","West Virginia","US","2020-05-24 02:32:43",39.46704621,-78.02414609,256,6,0,250,"Berkeley, West Virginia, US",119171,1935,1372,1057,315,-94,1709,1615,5,941,8.942205603,2.6648957095,-0.79523872,14.458116722,13.662878003,32288
42011,"Berks","Pennsylvania","US","2020-05-24 02:32:43",40.41570541,-75.92457766,3845,292,0,3553,"Berks, Pennsylvania, US",421164,635,4708,3885,823,694,-871,-177,-11,11771,9.2313943445,1.9555823798,1.6490573166,-2.069638217,-0.420580901,175026
25003,"Berkshire","Massachusetts","US","2020-05-24 02:32:43",42.37428441,-73.20524838,515,38,0,477,"Berkshire, Massachusetts, US",124944,-957,993,1460,-467,175,-662,-487,-3,5813,11.640654587,-3.723414858,1.3952839403,-5.27815982,-3.88287588,63219
35001,"Bernalillo","New Mexico","US","2020-05-24 02:32:43",35.05163625,-106.6703554,1313,66,0,1247,"Bernalillo, New Mexico, US",679121,1087,7130,5949,1181,773,-824,-51,-43,11898,8.766868928,1.7404054806,1.1391477024,-1.214304925,-0.075157222,334503
13019,"Berrien","Georgia","US","2020-05-24 02:32:43",31.27590016,-83.2252992,34,0,0,34,"Berrien, Georgia, US",19397,131,236,237,-1,12,120,132,0,202,12.259783255,-0.051729043,0.6207485193,6.2074851926,6.8282337118,3900
26021,"Berrien","Michigan","US","2020-05-24 02:32:43",41.95447397,-86.4131308,584,42,0,542,"Berrien, Michigan, US",153401,-389,1696,1688,8,216,-608,-392,-5,3511,10.989905303,0.0520848593,1.4062911999,-3.958449304,-2.552158104,67318
37015,"Bertie","North Carolina","US","2020-05-24 02:32:43",36.0688473,-76.96545943,109,3,0,106,"Bertie, North Carolina, US",18947,-159,167,268,-101,31,-89,-58,0,1385,14.085617428,-5.308385673,1.6293064936,-4.677686385,-3.048379891,6057
2050,"Bethel","Alaska","US","2020-05-24 02:32:43",60.90980451,-159.8561831,2,0,0,2,"Bethel, Alaska, US",18386,167,403,150,253,2,-88,-86,0,327,8.1956016938,13.82324819,0.1092746893,-4.808086327,-4.698811638,6167
48029,"Bexar","Texas","US","2020-05-24 02:32:43",29.44928723,-98.52019748,2392,66,0,2326,"Bexar, Texas, US",2003554,22367,26736,14216,12520,2339,7493,9832,15,43052,7.135219077,6.2839717814,1.1739784342,3.7608466899,4.9348251241,872913
1007,"Bibb","Alabama","US","2020-05-24 02:32:43",32.99642064,-87.1251146,58,1,0,57,"Bibb, Alabama, US",22394,27,240,252,-12,10,31,41,-2,2148,11.25980206,-0.53618105,0.4468175421,1.3851343804,1.8319519224,4746
13021,"Bibb","Georgia","US","2020-05-24 02:32:43",32.80904227,-83.70489165,432,24,0,408,"Bibb, Georgia, US",153159,256,2074,1745,329,130,-193,-63,-10,6736,11.402918363,2.1498911985,0.8495010815,-1.261182375,-0.411681293,81338
22013,"Bienville","Louisiana","US","2020-05-24 02:32:43",32.34569994,-93.05398492,136,21,0,115,"Bienville, Louisiana, US",13241,-102,142,207,-65,3,-39,-36,-1,319,15.573277159,-4.890159494,0.225699669,-2.934095697,-2.708396028,4625
30003,"Big Horn","Montana","US","2020-05-24 02:32:43",45.42335905,-107.492347,8,0,0,8,"Big Horn, Montana, US",13319,-46,244,132,112,12,-170,-158,0,137,9.89356918,8.3945435467,0.89941538,-12.74171788,-11.8423025,5081
56003,"Big Horn","Wyoming","US","2020-05-24 02:32:43",44.52405055,-107.9960365,3,0,0,3,"Big Horn, Wyoming, US",11790,-87,131,120,11,2,-100,-98,0,183,10.140702244,0.9295643723,0.1690117041,-8.450585203,-8.281573499,5019
27011,"Big Stone","Minnesota","US","2020-05-24 02:32:43",45.42712824,-96.41403739,3,0,0,3,"Big Stone, Minnesota, US",4991,1,70,70,0,1,1,2,-1,137,14.026650636,0,0.2003807234,0.2003807234,0.4007614467,2171
16011,"Bingham","Idaho","US","2020-05-24 02:32:43",43.2167288,-112.3978437,6,0,0,6,"Bingham, Idaho, US",46811,682,593,377,216,8,461,469,-3,322,8.112760921,4.6481601033,0.1721540779,9.920378739,10.092532817,15453
19013,"Black Hawk","Iowa","US","2020-05-24 02:32:43",42.4704581,-92.30524729,1669,38,0,1631,"Black Hawk, Iowa, US",131228,-495,1660,1212,448,188,-1129,-941,-2,4595,9.2184475435,3.40747896,1.4299242064,-8.587151218,-7.157227012,75339
18009,"Blackford","Indiana","US","2020-05-24 02:32:43",40.47388153,-85.32499702,19,1,0,18,"Blackford, Indiana, US",11758,-166,115,163,-48,10,-128,-118,0,163,13.765729246,-4.05371168,0.8445232666,-10.80989781,-9.965374546,3814
37017,"Bladen","North Carolina","US","2020-05-24 02:32:43",34.61296243,-78.56180059,92,2,0,90,"Bladen, North Carolina, US",32722,-429,337,468,-131,21,-316,-295,-3,289,14.20916005,-3.977350356,0.6375905151,-9.594219179,-8.956628664,13909
16013,"Blaine","Idaho","US","2020-05-24 02:32:43",43.4085812,-113.9752658,510,5,0,505,"Blaine, Idaho, US",23021,250,192,106,86,119,45,164,0,274,4.6296296296,3.7561146052,5.1974143955,1.965408805,7.1628232006,12614
40011,"Blaine","Oklahoma","US","2020-05-24 02:32:43",35.87518314,-98.43307003,4,0,0,4,"Blaine, Oklahoma, US",9429,-25,116,104,12,16,-52,-36,-1,107,11.015198856,1.2709844834,1.6946459779,-5.507599428,-3.81295345,3586
42013,"Blair","Pennsylvania","US","2020-05-24 02:32:43",40.47961444,-78.34917412,46,1,0,45,"Blair, Pennsylvania, US",121829,-674,1146,1619,-473,30,-225,-195,-6,3711,13.252459768,-3.871781019,0.2455675065,-1.841756299,-1.596188792,61536
48031,"Blanco","Texas","US","2020-05-24 02:32:43",30.26640707,-98.3999852,7,0,0,7,"Blanco, Texas, US",11931,283,75,131,-56,4,333,337,2,52,11.11158234,-4.749989397,0.339284957,28.245472666,28.584757623,3810
51021,"Bland","Virginia","US","2020-05-24 02:32:43",37.13128068,-81.13599391,0,0,0,0,"Bland, Virginia, US",6280,-23,39,79,-40,-2,19,17,0,676,12.556624017,-6.357784312,-0.317889216,3.0199475483,2.7020583327,1929
13023,"Bleckley","Georgia","US","2020-05-24 02:32:43",32.43829035,-83.33035166,38,0,0,38,"Bleckley, Georgia, US",12873,52,129,110,19,5,28,33,0,1410,8.562310267,1.4789445007,0.3891959212,2.1794971589,2.5686930801,2704
47007,"Bledsoe","Tennessee","US","2020-05-24 02:32:43",35.59942968,-85.20611967,607,1,0,606,"Bledsoe, Tennessee, US",15064,181,116,154,-38,22,196,218,1,2709,10.284836545,-2.53781681,1.4692623635,13.089791966,14.559054329,2961
1009,"Blount","Alabama","US","2020-05-24 02:32:43",33.98210918,-86.56790593,49,1,0,48,"Blount, Alabama, US",57826,55,651,657,-6,6,59,65,-4,489,11.367077,-0.103808922,0.1038089224,1.0207877367,1.1245966591,9521
47009,"Blount","Tennessee","US","2020-05-24 02:32:43",35.68938198,-83.92847788,81,3,0,78,"Blount, Tennessee, US",133088,1757,1255,1414,-159,71,1842,1913,3,2095,10.695146718,-1.202636724,0.5370264618,13.932432995,14.469459456,46876
27013,"Blue Earth","Minnesota","US","2020-05-24 02:32:43",44.03554215,-94.06699781,110,1,0,109,"Blue Earth, Minnesota, US",67653,275,715,470,245,103,-72,31,-1,3938,6.9613644274,3.6287963505,1.5255756086,-1.066421785,0.4591538239,40052
28011,"Bolivar","Mississippi","US","2020-05-24 02:32:43",33.79696941,-90.87372121,136,10,0,126,"Bolivar, Mississippi, US",30628,-487,405,398,7,23,-519,-496,2,1395,12.892149717,0.2267463518,0.7450237274,-16.81162237,-16.06659864,11813
29017,"Bollinger","Missouri","US","2020-05-24 02:32:43",37.32449052,-90.02725304,6,0,0,6,"Bollinger, Missouri, US",12133,-56,127,138,-11,0,-46,-46,1,163,11.347751007,-0.904530877,0,-3.782583669,-3.782583669,2132
46009,"Bon Homme","South Dakota","US","2020-05-24 02:32:43",42.98914167,-97.88592746,6,0,0,6,"Bon Homme, South Dakota, US",6901,-9,69,62,7,-2,-13,-15,-1,1530,8.9783505901,1.013684744,-0.289624213,-1.882557382,-2.172181594,2169
17005,"Bond","Illinois","US","2020-05-24 02:32:43",38.88829622,-89.43534887,10,1,0,9,"Bond, Illinois, US",16426,-211,146,157,-11,4,-206,-202,2,1602,9.497020839,-0.665396365,0.2419623144,-12.46105919,-12.21909688,5763
16017,"Bonner","Idaho","US","2020-05-24 02:32:43",48.29996017,-116.6017932,4,0,0,4,"Bonner, Idaho, US",45739,1034,426,438,-12,-13,1057,1044,2,348,9.6855512804,-0.265357569,-0.2874707,23.373579231,23.086108531,14673
16019,"Bonneville","Idaho","US","2020-05-24 02:32:43",43.38713372,-111.6161537,32,0,0,32,"Bonneville, Idaho, US",119062,2618,1876,863,1013,-33,1633,1600,5,1225,7.3289003253,8.6027532207,-0.280247637,13.868011855,13.587764218,51840
5009,"Boone","Arkansas","US","2020-05-24 02:32:43",36.3084504,-93.09374925,6,0,0,6,"Boone, Arkansas, US",37432,47,407,460,-53,-11,114,103,-3,465,12.296670543,-1.416790302,-0.294050817,3.0474357432,2.7533849259,16182
17007,"Boone","Illinois","US","2020-05-24 02:32:43",42.32359279,-88.82345779,389,16,0,373,"Boone, Illinois, US",53544,64,564,417,147,2,-84,-82,-1,310,7.7926446405,2.7470473912,0.0373747944,-1.569741366,-1.532366572,17237
18011,"Boone","Indiana","US","2020-05-24 02:32:43",40.0509304,-86.46841646,279,35,0,244,"Boone, Indiana, US",67843,913,764,469,295,72,546,618,0,574,6.9598510087,4.3777314447,1.0684632679,8.1025131146,9.1709763825,23691
19015,"Boone","Iowa","US","2020-05-24 02:32:43",42.03657094,-93.9313999,53,0,0,53,"Boone, Iowa, US",26234,-78,268,290,-22,-15,-40,-55,-1,725,11.037947703,-0.83736155,-0.570928329,-1.522475545,-2.093403875,10398
21015,"Boone","Kentucky","US","2020-05-24 02:32:43",38.97065142,-84.72615357,387,11,0,376,"Boone, Kentucky, US",133581,1680,1680,939,741,0,943,943,-4,834,7.0739259159,5.5822993649,0,7.1040597856,7.1040597856,81375
29019,"Boone","Missouri","US","2020-05-24 02:32:43",38.99186229,-92.30723575,115,1,0,114,"Boone, Missouri, US",180463,1402,2015,1156,859,522,22,544,-1,9033,6.4307250698,4.7785405147,2.9038395211,0.1223840411,3.0262235623,93378
31011,"Boone","Nebraska","US","2020-05-24 02:32:43",41.70759415,-98.06737183,3,0,0,3,"Boone, Nebraska, US",5192,-49,56,62,-6,2,-46,-44,1,97,11.88536375,-1.150196492,0.3833988306,-8.818173105,-8.434774274,2773
54005,"Boone","West Virginia","US","2020-05-24 02:32:43",38.01974191,-81.69888019,9,0,0,9,"Boone, West Virginia, US",21457,-496,225,297,-72,0,-423,-423,-1,131,13.683483068,-3.317208017,0,-19.4885971,-19.4885971,8352
48035,"Bosque","Texas","US","2020-05-24 02:32:43",31.89978581,-97.63613524,6,0,0,6,"Bosque, Texas, US",18685,56,182,250,-68,3,120,123,1,319,13.399796323,-3.6447446,0.1607975559,6.4319022351,6.592699791,4307
22015,"Bossier","Louisiana","US","2020-05-24 02:32:43",32.67932307,-93.60460152,380,24,0,356,"Bossier, Louisiana, US",127039,17,1570,1119,451,41,-477,-436,2,2551,8.8089080969,3.5503284644,0.3227571331,-3.75500372,-3.432246586,51866
51023,"Botetourt","Virginia","US","2020-05-24 02:32:43",37.55531756,-79.80982182,31,4,0,27,"Botetourt, Virginia, US",33419,67,229,359,-130,4,198,202,-5,287,10.753171287,-3.893906037,0.1198124934,5.9307184257,6.0505309191,9859
38009,"Bottineau","North Dakota","US","2020-05-24 02:32:43",48.79106111,-100.8378166,2,0,0,2,"Bottineau, North Dakota, US",6282,-116,61,90,-29,4,-91,-87,0,223,14.195583596,-4.574132492,0.6309148265,-14.3533123,-13.72239748,3228
8013,"Boulder","Colorado","US","2020-05-24 02:32:43",40.09313619,-105.3546767,923,61,0,862,"Boulder, Colorado, US",326196,1560,2609,1935,674,938,-42,896,-10,10339,5.9462349731,2.0711950242,2.8824642919,-0.129065565,2.7533987266,190656
16021,"Boundary","Idaho","US","2020-05-24 02:32:43",48.76684761,-116.4630179,0,0,0,0,"Boundary, Idaho, US",12245,229,134,132,2,2,225,227,0,77,10.881661927,0.1648736656,0.1648736656,18.548287375,18.71316104,3435
20011,"Bourbon","Kansas","US","2020-05-24 02:32:43",37.85508555,-94.84865997,7,1,0,6,"Bourbon, Kansas, US",14534,-8,175,146,29,9,-46,-37,0,409,10.042646857,1.9947723208,0.619067272,-3.164121612,-2.54505434,6373
21017,"Bourbon","Kentucky","US","2020-05-24 02:32:43",38.2054607,-84.21827874,9,1,0,8,"Bourbon, Kentucky, US",19788,-328,208,235,-27,-3,-299,-302,1,236,11.778267843,-1.353247795,-0.150360866,-14.98596632,-15.13632719,7648
48037,"Bowie","Texas","US","2020-05-24 02:32:43",33.44626922,-94.41834132,176,5,0,171,"Bowie, Texas, US",93245,-443,1117,1046,71,17,-531,-514,0,5910,11.191175448,0.7596304558,0.1818833486,-5.681179888,-5.499296539,41842
38011,"Bowman","North Dakota","US","2020-05-24 02:32:43",46.11285362,-103.5203343,1,0,0,1,"Bowman, North Dakota, US",3024,-43,35,34,1,0,-45,-45,1,61,11.164012477,0.3283533082,0,-14.77589887,-14.77589887,1712
31013,"Box Butte","Nebraska","US","2020-05-24 02:32:43",42.22079243,-103.0878834,1,0,0,1,"Box Butte, Nebraska, US",10783,50,124,97,27,2,23,25,-2,144,9.0165458264,2.5097601785,0.1859081614,2.1379438557,2.3238520171,5877
21019,"Boyd","Kentucky","US","2020-05-24 02:32:43",38.36176608,-82.68652187,39,3,0,36,"Boyd, Kentucky, US",46718,-574,493,597,-104,-11,-460,-471,1,2063,12.700776513,-2.212530582,-0.234017658,-9.786192958,-10.02021062,26568
21021,"Boyle","Kentucky","US","2020-05-24 02:32:43",37.62680923,-84.8633779,20,0,0,20,"Boyle, Kentucky, US",30060,-22,310,317,-7,-2,-14,-16,1,3277,10.541717934,-0.232782415,-0.066509261,-0.46556483,-0.532074091,15357
21023,"Bracken","Kentucky","US","2020-05-24 02:32:43",38.69158994,-84.08532444,11,0,0,11,"Bracken, Kentucky, US",8303,25,97,100,-3,2,28,30,-2,41,12.061998673,-0.36185996,0.2412399735,3.3773596285,3.618599602,1498
12007,"Bradford","Florida","US","2020-05-24 02:32:43",29.95079741,-82.16611613,50,2,0,48,"Bradford, Florida, US",28201,449,285,349,-64,2,507,509,4,4226,12.474755598,-2.287634264,0.0714885708,18.122352689,18.19384126,6319
42015,"Bradford","Pennsylvania","US","2020-05-24 02:32:43",41.78869215,-76.51570822,44,3,0,41,"Bradford, Pennsylvania, US",60323,-471,632,725,-93,16,-393,-377,-1,665,11.971894945,-1.535705145,0.2642073367,-6.489592708,-6.225385371,27755
5011,"Bradley","Arkansas","US","2020-05-24 02:32:43",33.46755808,-92.15980837,16,1,0,15,"Bradley, Arkansas, US",10763,-75,116,130,-14,-5,-56,-61,0,227,12.036479793,-1.296236285,-0.46294153,-5.184945141,-5.647886672,3810
47011,"Bradley","Tennessee","US","2020-05-24 02:32:43",35.15739424,-84.857186,91,1,0,90,"Bradley, Tennessee, US",108110,1060,1240,1113,127,168,769,937,-4,2605,10.34578918,1.1805168247,1.5616285555,7.1481688046,8.7097973601,42002
26023,"Branch","Michigan","US","2020-05-24 02:32:43",41.91600556,-85.05929476,100,2,0,98,"Branch, Michigan, US",43517,-49,515,419,96,29,-172,-143,-2,1972,9.6230033416,2.2047931284,0.6660312575,-3.950254355,-3.284223098,15611
13025,"Brantley","Georgia","US","2020-05-24 02:32:43",31.19576557,-81.97743999,50,2,0,48,"Brantley, Georgia, US",19109,124,221,216,5,1,118,119,0,89,11.340368562,0.2625085315,0.0525017063,6.195201344,6.2477030503,2885
54007,"Braxton","West Virginia","US","2020-05-24 02:32:43",38.70036159,-80.72011184,2,0,0,2,"Braxton, West Virginia, US",13957,-119,127,177,-50,-1,-67,-68,-1,380,12.627974173,-3.567224343,-0.071344487,-4.780080619,-4.851425106,4534
48039,"Brazoria","Texas","US","2020-05-24 02:32:43",29.18757369,-95.44563172,825,11,0,814,"Brazoria, Texas, US",374264,5377,4681,2498,2183,171,3025,3196,-2,10474,6.7227252604,5.8749836843,0.4602025699,8.1410103734,8.6012129433,106291
48041,"Brazos","Texas","US","2020-05-24 02:32:43",30.6636448,-96.30205577,362,18,0,344,"Brazos, Texas, US",229211,3430,2621,1142,1479,1023,931,1954,-3,14535,5.0198684812,6.5012132081,4.496782361,4.0923796462,8.5891620072,100127
21025,"Breathitt","Kentucky","US","2020-05-24 02:32:43",37.52333168,-83.31959161,3,0,0,3,"Breathitt, Kentucky, US",12630,-157,161,205,-44,0,-113,-113,0,320,16.130935988,-3.462249675,0,-8.891686666,-8.891686666,3497
21027,"Breckinridge","Kentucky","US","2020-05-24 02:32:43",37.77377239,-86.42885017,16,2,0,14,"Breckinridge, Kentucky, US",20477,168,230,214,16,9,143,152,0,299,10.493796891,0.7845829451,0.4413279066,7.0122100721,7.4535379787,4614
19017,"Bremer","Iowa","US","2020-05-24 02:32:43",42.77461496,-92.31795937,67,5,0,62,"Bremer, Iowa, US",25062,121,271,218,53,23,48,71,-3,1580,8.7194768314,2.1198728076,0.9199448033,1.9198848069,2.8398296102,11948
12009,"Brevard","Florida","US","2020-05-24 02:32:43",28.29409504,-80.73091022,389,11,0,378,"Brevard, Florida, US",601942,6739,5258,7468,-2210,429,8509,8938,11,6801,12.476349983,-3.692117496,0.716705161,14.215487681,14.932192842,217770
48043,"Brewster","Texas","US","2020-05-24 02:32:43",29.81008251,-103.2520326,1,0,0,1,"Brewster, Texas, US",9203,-69,87,70,17,2,-87,-85,-1,44,7.5778078484,1.8403247632,0.2165087957,-9.418132612,-9.201623816,4336
48045,"Briscoe","Texas","US","2020-05-24 02:32:43",34.53026962,-101.2084947,1,0,0,1,"Briscoe, Texas, US",1546,34,12,9,3,1,29,30,1,0,5.8862001308,1.9620667103,0.6540222368,18.966644866,19.620667103,568
25005,"Bristol","Massachusetts","US","2020-05-24 02:32:43",41.79228404,-71.10872211,6426,362,0,6064,"Bristol, Massachusetts, US",565217,1125,5701,5387,314,810,30,840,-29,15446,9.5403472389,0.5560922653,1.4345055251,0.0531298343,1.4876353593,215879
44001,"Bristol","Rhode Island","US","2020-05-24 02:32:43",41.71018079,-71.28652315,213,0,0,213,"Bristol, Rhode Island, US",48479,-158,337,517,-180,21,6,27,-5,2753,10.647061246,-3.706907204,0.4324725071,0.1235635735,0.5560360806,15028
51520,"Bristol","Virginia","US","2020-05-24 02:32:43",36.6163024,-82.16359122,4,0,0,4,"Bristol, Virginia, US",16762,77,126,235,-109,-8,194,186,0,225,14.052082399,-6.517774389,-0.478368763,11.600442491,11.122073729,11159
30007,"Broadwater","Montana","US","2020-05-24 02:32:43",46.33277565,-111.4955813,4,0,0,4,"Broadwater, Montana, US",6237,165,60,51,9,-1,155,154,2,52,8.2866195467,1.4623446259,-0.162482736,25.184824112,25.022341376,1872
54009,"Brooke","West Virginia","US","2020-05-24 02:32:43",40.27367263,-80.57915332,3,0,0,3,"Brooke, West Virginia, US",21939,-190,198,302,-104,-11,-73,-84,-2,672,13.706090587,-4.719978215,-0.499228465,-3.313061632,-3.812290097,8131
46011,"Brookings","South Dakota","US","2020-05-24 02:32:43",44.36974375,-96.79079945,15,0,0,15,"Brookings, South Dakota, US",35077,0,443,204,239,69,-310,-241,2,3614,5.8157767198,6.8135815492,1.9671009493,-8.837699917,-6.870598968,19371
13027,"Brooks","Georgia","US","2020-05-24 02:32:43",30.83922642,-83.58303423,66,9,0,57,"Brooks, Georgia, US",15457,-22,149,199,-50,12,17,29,-1,49,12.865270235,-3.232479959,0.7757951901,1.0990431859,1.874838376,3033
48047,"Brooks","Texas","US","2020-05-24 02:32:43",27.03103197,-98.21808402,1,0,0,1,"Brooks, Texas, US",7093,-6,102,78,24,41,-72,-31,1,57,10.99210823,3.3821871477,5.777903044,-10.14656144,-4.368658399,2714
36007,"Broome","New York","US","2020-05-24 02:32:43",42.15903158,-75.81326086,485,32,0,453,"Broome, New York, US",190488,-1437,1920,2113,-193,248,-1498,-1250,6,11131,11.050879546,-1.009379911,1.2970270362,-7.834461695,-6.537434658,93287
8014,"Broomfield","Colorado","US","2020-05-24 02:32:43",39.95998787,-105.0566324,220,25,0,195,"Broomfield, Colorado, US",70465,1141,651,413,238,105,791,896,7,282,5.9089055648,3.4051320204,1.5022641266,11.317056421,12.819320547,36980
12011,"Broward","Florida","US","2020-05-24 02:32:43",26.15184651,-80.48725556,6649,292,0,6357,"Broward, Florida, US",1952778,6671,21829,16032,5797,13055,-12153,902,-28,16292,8.2238896505,2.9736706776,6.6967863889,-6.234090003,0.4626963863,798239
17009,"Brown","Illinois","US","2020-05-24 02:32:43",39.96209138,-90.75068024,10,0,0,10,"Brown, Illinois, US",6578,15,56,56,0,5,10,15,0,1985,8.5229434594,0,0.7609770946,1.5219541892,2.2829312838,4260
18013,"Brown","Indiana","US","2020-05-24 02:32:43",39.19605589,-86.22868909,33,1,0,32,"Brown, Indiana, US",15092,-138,117,153,-36,-3,-98,-101,-1,163,10.091682607,-2.374513555,-0.19787613,-6.463953565,-6.661829695,3333
20013,"Brown","Kansas","US","2020-05-24 02:32:43",39.82652589,-95.56421698,6,0,0,6,"Brown, Kansas, US",9564,-46,125,121,4,-1,-49,-50,0,116,12.621257953,0.4172316679,-0.104307917,-5.111087932,-5.215395849,4949
27015,"Brown","Minnesota","US","2020-05-24 02:32:43",44.24205652,-94.72562874,11,2,0,9,"Brown, Minnesota, US",25008,-117,276,275,1,8,-125,-117,-1,1134,10.970817625,0.0398938823,0.3191510582,-4.986735284,-4.667584226,15254
39015,"Brown","Ohio","US","2020-05-24 02:32:43",38.93416837,-83.86788395,24,1,0,23,"Brown, Ohio, US",43432,-138,490,518,-28,-8,-102,-110,0,575,11.907772235,-0.643663364,-0.183903818,-2.344773683,-2.528677502,9547
46013,"Brown","South Dakota","US","2020-05-24 02:32:43",45.58994323,-98.35165355,244,0,0,244,"Brown, South Dakota, US",38839,-306,501,353,148,19,-473,-454,0,1370,9.0531391055,3.7956503898,0.4872794419,-12.13069348,-11.64341403,21681
48049,"Brown","Texas","US","2020-05-24 02:32:43",31.77430356,-98.99907113,55,7,0,48,"Brown, Texas, US",37864,44,382,440,-58,13,91,104,-2,1664,11.627292426,-1.532688547,0.3435336399,2.4047354791,2.748269119,15275
55009,"Brown","Wisconsin","US","2020-05-24 02:32:43",44.4526553,-88.00411844,2238,32,0,2206,"Brown, Wisconsin, US",264542,1377,3194,1817,1377,138,-132,6,-6,6569,6.8863971863,5.2188051324,0.5230175078,-0.500277616,0.0227398916,147929
46015,"Brule","South Dakota","US","2020-05-24 02:32:43",43.71756379,-99.08118954,0,0,0,0,"Brule, South Dakota, US",5297,67,69,41,28,-1,41,40,-1,132,7.7894936829,5.3196542225,-0.189987651,7.7894936829,7.5995060321,2632
37019,"Brunswick","North Carolina","US","2020-05-24 02:32:43",34.070565,-78.22814204,74,2,0,72,"Brunswick, North Carolina, US",142820,5940,1027,1738,-711,-36,6629,6593,58,847,12.427601001,-5.084018591,-0.257418663,47.400786557,47.143367894,34868
51025,"Brunswick","Virginia","US","2020-05-24 02:32:43",36.76366949,-77.8593436,21,1,0,20,"Brunswick, Virginia, US",16231,-105,139,222,-83,5,-26,-21,-1,2188,13.633432616,-5.097184266,0.3070592931,-1.596708324,-1.289649031,4199
13029,"Bryan","Georgia","US","2020-05-24 02:32:43",32.00979311,-81.44002948,69,5,0,64,"Bryan, Georgia, US",39627,1568,541,258,283,-3,1289,1286,-1,98,6.6421234199,7.2857400304,-0.077233993,33.184872435,33.107638442,6932
40013,"Bryan","Oklahoma","US","2020-05-24 02:32:43",33.96472458,-96.25903472,21,1,0,20,"Bryan, Oklahoma, US",47995,804,589,542,47,14,739,753,4,1137,11.388229361,0.9875401845,0.294160906,15.527493539,15.821654445,17018
19019,"Buchanan","Iowa","US","2020-05-24 02:32:43",42.4709188,-91.83510825,30,0,0,30,"Buchanan, Iowa, US",21175,-3,267,199,68,4,-74,-70,-1,305,9.3972091705,3.2111066512,0.1888886265,-3.494439591,-3.305550965,7474
29021,"Buchanan","Missouri","US","2020-05-24 02:32:43",39.65816401,-94.80138942,609,2,0,607,"Buchanan, Missouri, US",87364,-799,1068,893,175,163,-1137,-974,0,4344,10.175072781,1.9939952258,1.8572641246,-12.95527184,-11.09800771,50795
51027,"Buchanan","Virginia","US","2020-05-24 02:32:43",37.26818323,-82.03749726,18,0,0,18,"Buchanan, Virginia, US",21004,-365,184,309,-125,12,-253,-241,1,1026,14.584759163,-5.89998348,0.5663984141,-11.94156656,-11.37516815,7553
51029,"Buckingham","Virginia","US","2020-05-24 02:32:43",37.57242268,-78.52518834,443,2,0,441,"Buckingham, Virginia, US",17148,105,126,157,-31,1,135,136,0,2220,9.1837033137,-1.813342693,0.0584949256,7.8968149513,7.9553098769,4034
42017,"Bucks","Pennsylvania","US","2020-05-24 02:32:43",40.33682119,-75.10836643,4839,460,0,4379,"Bucks, Pennsylvania, US",628270,458,5694,6111,-417,536,383,919,-44,8044,9.7302564641,-0.663969391,0.853447466,0.6098327975,1.4632802635,261596
19021,"Buena Vista","Iowa","US","2020-05-24 02:32:43",42.73545875,-95.15100162,227,0,0,227,"Buena Vista, Iowa, US",19620,-206,286,148,138,40,-385,-345,1,789,7.5039294225,6.9969071642,2.0280890331,-19.52035694,-17.49226791,11599
51530,"Buena Vista","Virginia","US","2020-05-24 02:32:43",37.73484642,-79.35296097,12,0,0,12,"Buena Vista, Virginia, US",6478,-16,91,74,17,-5,-27,-32,-1,490,11.409189023,2.6210299106,-0.77089115,-4.162812211,-4.933703361,1983
31019,"Buffalo","Nebraska","US","2020-05-24 02:32:43",40.85486962,-99.07500296,140,1,0,139,"Buffalo, Nebraska, US",49659,307,632,369,263,38,8,46,-2,2056,7.4537172637,5.3125410308,0.7675914797,0.1615982063,0.929189686,27885
46017,"Buffalo","South Dakota","US","2020-05-24 02:32:43",44.07657829,-99.20814467,9,0,0,9,"Buffalo, South Dakota, US",1962,-65,35,37,-2,0,-64,-64,1,3,18.551015292,-1.002757583,0,-32.08824267,-32.08824267,646
55011,"Buffalo","Wisconsin","US","2020-05-24 02:32:43",44.37835084,-91.75332578,5,1,0,4,"Buffalo, Wisconsin, US",13031,-83,129,126,3,9,-95,-86,0,80,9.6385542169,0.2294893861,0.6884681583,-7.267163894,-6.578695735,4342
21029,"Bullitt","Kentucky","US","2020-05-24 02:32:43",37.97162523,-85.68955617,104,4,0,100,"Bullitt, Kentucky, US",81676,667,777,653,124,-8,553,545,-2,340,8.0277837539,1.5244183545,-0.098349571,6.7984141132,6.7000645419,21997
13031,"Bulloch","Georgia","US","2020-05-24 02:32:43",32.39577406,-81.74811421,52,2,0,50,"Bulloch, Georgia, US",79608,2366,890,561,329,84,1935,2019,18,6529,7.1533312082,4.1950908511,1.0710870258,24.673254702,25.744341728,28684
1011,"Bullock","Alabama","US","2020-05-24 02:32:43",32.10030533,-85.71265535,105,1,0,104,"Bullock, Alabama, US",10101,-73,109,109,0,-1,-72,-73,0,1663,10.75215783,0,-0.09864365,-7.102342787,-7.200986436,3287
37021,"Buncombe","North Carolina","US","2020-05-24 02:32:43",35.61113393,-82.53305,251,8,0,243,"Buncombe, North Carolina, US",261191,1932,2413,2700,-287,108,2102,2210,9,8013,10.375636468,-1.102891728,0.4150254587,8.0776251321,8.4926505908,130104
17011,"Bureau","Illinois","US","2020-05-24 02:32:43",41.40385234,-89.5283051,15,1,0,14,"Bureau, Illinois, US",32628,-331,314,383,-69,18,-281,-263,1,457,11.679143733,-2.104075503,0.5488892616,-8.56877125,-8.019881989,13149
13033,"Burke","Georgia","US","2020-05-24 02:32:43",33.05917989,-81.99928721,120,4,0,116,"Burke, Georgia, US",22383,-56,290,247,43,-2,-96,-98,-1,295,11.021373433,1.9187006381,-0.08924189,-4.283610727,-4.372852617,9355
37023,"Burke","North Carolina","US","2020-05-24 02:32:43",35.74989637,-81.70755735,266,14,0,252,"Burke, North Carolina, US",90485,80,883,1034,-151,66,171,237,-6,3369,11.432362209,-1.669522914,0.7297252474,1.8906517773,2.6203770247,31130
38013,"Burke","North Dakota","US","2020-05-24 02:32:43",48.79094471,-102.5182117,5,0,0,5,"Burke, North Dakota, US",2115,21,26,17,9,0,12,12,0,2,8.077928249,4.2765502495,0,5.7020669993,5.7020669993,924
38015,"Burleigh","North Dakota","US","2020-05-24 02:32:43",46.97847375,-100.4645214,129,0,0,129,"Burleigh, North Dakota, US",95626,350,1180,759,421,131,-201,-70,-1,3869,7.9517239212,4.4106400142,1.3724319284,-2.105792501,-0.733360572,51277
48051,"Burleson","Texas","US","2020-05-24 02:32:43",30.49273808,-96.62158484,20,0,0,20,"Burleson, Texas, US",18443,108,209,218,-9,28,87,115,2,167,11.854913263,-0.489423025,1.52264941,4.7310892381,6.2537386481,4647
34005,"Burlington","New Jersey","US","2020-05-24 02:32:43",39.87681124,-74.66927768,4252,266,0,3986,"Burlington, New Jersey, US",445349,604,4333,4022,311,120,199,319,-26,11491,9.0372477514,0.6988025984,0.2696344431,0.4471437848,0.7167782279,203587
48053,"Burnet","Texas","US","2020-05-24 02:32:43",30.78801353,-98.181887,29,0,0,29,"Burnet, Texas, US",48155,811,468,490,-22,-22,854,832,1,1118,10.261887559,-0.460737809,-0.460737809,17.885004031,17.424266223,15582
55013,"Burnett","Wisconsin","US","2020-05-24 02:32:43",45.86303537,-92.36711412,1,1,0,0,"Burnett, Wisconsin, US",15414,40,123,167,-44,1,83,84,0,138,10.848382487,-2.858256464,0.0649603742,5.3917110563,5.4566714304,5193
31021,"Burt","Nebraska","US","2020-05-24 02:32:43",41.85056773,-96.32605633,8,0,0,8,"Burt, Nebraska, US",6459,-27,64,98,-34,1,7,8,-1,124,15.140981074,-5.252993434,0.1544998069,1.0814986481,1.235998455,2317
1013,"Butler","Alabama","US","2020-05-24 02:32:43",31.75300095,-86.68057478,335,11,0,324,"Butler, Alabama, US",19448,-183,213,272,-59,18,-141,-123,-1,333,13.920519972,-3.019524553,0.9212108805,-7.216151897,-6.294941017,6900
19023,"Butler","Iowa","US","2020-05-24 02:32:43",42.73172833,-92.79015971,15,0,0,15,"Butler, Iowa, US",14439,-86,134,172,-38,6,-53,-47,-1,205,11.876812595,-2.623946969,0.4143074161,-3.659715509,-3.245408093,4372
20015,"Butler","Kansas","US","2020-05-24 02:32:43",37.78134351,-96.83878537,25,0,0,25,"Butler, Kansas, US",66911,78,731,637,94,20,-34,-14,-2,2298,9.5256609642,1.4056705348,0.2990788372,-0.508434023,-0.209355186,20396
21031,"Butler","Kentucky","US","2020-05-24 02:32:43",37.20946153,-86.68748787,218,6,0,212,"Butler, Kentucky, US",12879,136,154,143,11,0,126,126,-1,203,11.162282414,0.8586371087,0,9.835297791,9.835297791,3398
29023,"Butler","Missouri","US","2020-05-24 02:32:43",36.71462476,-90.40421163,28,0,0,28,"Butler, Missouri, US",42478,-109,498,566,-68,3,-42,-39,-2,857,13.307470758,-1.598777406,0.0705342973,-0.987480162,-0.916945865,20467
31023,"Butler","Nebraska","US","2020-05-24 02:32:43",41.22703692,-97.13106306,45,0,0,45,"Butler, Nebraska, US",8016,-27,87,85,2,0,-28,-28,-1,168,10.585964257,0.2490815119,0,-3.487141167,-3.487141167,3026
39017,"Butler","Ohio","US","2020-05-24 02:32:43",39.44012838,-84.57388716,750,25,0,725,"Butler, Ohio, US",383134,1134,4455,3467,988,313,-156,157,-11,11831,9.0624648754,2.582554167,0.8181573424,-0.407771711,0.4103856318,151228
42019,"Butler","Pennsylvania","US","2020-05-24 02:32:43",40.91152759,-79.91351055,216,12,0,204,"Butler, Pennsylvania, US",187853,215,1714,1976,-262,58,431,489,-12,5466,10.524886082,-1.395506151,0.3089288425,2.2956608814,2.6045897239,90383
6007,"Butte","California","US","2020-05-24 02:32:43",39.66727762,-121.6005252,34,0,0,34,"Butte, California, US",219186,-11153,2422,2527,-105,103,-11249,-11146,98,5337,11.2429787,-0.46715978,0.4582614982,-50.04838441,-49.59012291,87044
46019,"Butte","South Dakota","US","2020-05-24 02:32:43",44.90608745,-103.5079318,0,0,0,0,"Butte, South Dakota, US",10429,176,135,98,37,0,142,142,-3,111,9.476839764,3.5779905232,0,13.731747413,13.731747413,3530
13035,"Butts","Georgia","US","2020-05-24 02:32:43",33.2830945,-83.9543504,208,20,0,188,"Butts, Georgia, US",24936,744,291,278,13,-3,727,724,7,3015,11.31737502,0.5292297671,-0.122129946,29.596156978,29.474027031,6743
37025,"Cabarrus","North Carolina","US","2020-05-24 02:32:43",35.3877799,-80.55267168,428,22,0,406,"Cabarrus, North Carolina, US",216453,4856,2600,1688,912,185,3756,3941,3,1562,7.8869290971,4.2611844411,0.8643850018,17.549351711,18.413736713,71145
54011,"Cabell","West Virginia","US","2020-05-24 02:32:43",38.42424062,-82.23855912,57,0,0,57,"Cabell, West Virginia, US",91945,-1090,1009,1086,-77,-23,-990,-1013,0,3810,11.741809925,-0.832522435,-0.248675532,-10.70385988,-10.95253541,51935
22017,"Caddo","Louisiana","US","2020-05-24 02:32:43",32.57991587,-93.88375652,2293,156,0,2137,"Caddo, Louisiana, US",240204,-2629,3032,2739,293,19,-2938,-2919,-3,6243,11.340746154,1.2131575842,0.0786689218,-12.1646996,-12.08603068,123352
40015,"Caddo","Oklahoma","US","2020-05-24 02:32:43",35.17364557,-98.37534464,136,10,0,126,"Caddo, Oklahoma, US",28762,-266,374,390,-16,46,-297,-251,1,1928,13.497144835,-0.553729019,1.5919709292,-10.27859491,-8.686623983,8676
6009,"Calaveras","California","US","2020-05-24 02:32:43",38.20537103,-120.552913,13,0,0,13,"Calaveras, California, US",45905,207,397,528,-131,15,323,338,0,493,11.528006725,-2.860168335,0.327500191,7.0521707804,7.3796709715,10876
22019,"Calcasieu","Louisiana","US","2020-05-24 02:32:43",30.22931235,-93.35400434,567,42,0,525,"Calcasieu, Louisiana, US",203436,259,2897,2050,847,58,-644,-586,-2,3790,10.083297878,4.1661235622,0.2852835497,-3.167631138,-2.882347588,90083
21033,"Caldwell","Kentucky","US","2020-05-24 02:32:43",37.14749129,-87.86948214,12,0,0,12,"Caldwell, Kentucky, US",12747,31,139,164,-25,-1,58,57,-1,148,12.881435809,-1.963633507,-0.07854534,4.5556297373,4.477084397,4781
22021,"Caldwell","Louisiana","US","2020-05-24 02:32:43",32.0902519,-92.11752148,51,0,0,51,"Caldwell, Louisiana, US",9918,-46,123,120,3,-2,-45,-47,-2,584,12.071220199,0.301780505,-0.201187003,-4.526707575,-4.727894578,2873
29025,"Caldwell","Missouri","US","2020-05-24 02:32:43",39.65620858,-93.98308093,5,0,0,5,"Caldwell, Missouri, US",9020,-51,91,100,-9,2,-43,-41,-1,214,11.055220828,-0.994969875,0.2211044166,-4.753744956,-4.532640539,1977
37027,"Caldwell","North Carolina","US","2020-05-24 02:32:43",35.95204977,-81.54799522,105,2,0,103,"Caldwell, North Carolina, US",82178,152,774,969,-195,57,294,351,-4,941,11.802392146,-2.375094395,0.6942583616,3.580911549,4.2751699106,26048
48055,"Caldwell","Texas","US","2020-05-24 02:32:43",29.83668859,-97.61814775,41,0,0,41,"Caldwell, Texas, US",43664,503,552,366,186,21,297,318,-1,3359,8.4307515117,4.2844802764,0.4837316441,6.8413475382,7.3250791823,9680
50005,"Caledonia","Vermont","US","2020-05-24 02:32:43",44.46548598,-72.10314651,14,0,0,14,"Caledonia, Vermont, US",29993,-243,272,278,-6,-6,-232,-238,1,1185,9.2314333627,-0.199239569,-0.199239569,-7.70393,-7.903169569,12648
1015,"Calhoun","Alabama","US","2020-05-24 02:32:43",33.77483727,-85.82630386,138,3,0,135,"Calhoun, Alabama, US",113605,-726,1269,1532,-263,14,-475,-461,-2,2833,13.442369788,-2.30766531,0.1228414994,-4.167836586,-4.044995086,47539
12013,"Calhoun","Florida","US","2020-05-24 02:32:43",30.40666734,-85.19394153,52,3,0,49,"Calhoun, Florida, US",14105,-438,133,165,-32,0,-409,-409,3,1686,11.519128735,-2.234012846,0,-28.55347668,-28.55347668,3208
13037,"Calhoun","Georgia","US","2020-05-24 02:32:43",31.53169785,-84.62725131,126,5,0,121,"Calhoun, Georgia, US",6189,-164,53,49,4,2,-171,-169,1,1701,7.8137458141,0.6378568011,0.3189284006,-27.26837825,-26.94944985,2011
17013,"Calhoun","Illinois","US","2020-05-24 02:32:43",39.16840183,-90.66330078,1,0,0,1,"Calhoun, Illinois, US",4739,-90,39,56,-17,1,-74,-73,0,90,11.705685619,-3.553511706,0.2090301003,-15.46822742,-15.25919732,1075
19025,"Calhoun","Iowa","US","2020-05-24 02:32:43",42.38521079,-94.64046046,2,0,0,2,"Calhoun, Iowa, US",9668,-43,102,124,-22,4,-25,-21,0,725,12.797357965,-2.270498994,0.4128179989,-2.580112493,-2.167294494,3188
26025,"Calhoun","Michigan","US","2020-05-24 02:32:43",42.24633834,-85.00493569,339,21,0,318,"Calhoun, Michigan, US",134159,110,1497,1395,102,198,-184,14,-6,4292,10.402374277,0.7606037106,1.4764660264,-1.372069439,0.1043965877,61859
28013,"Calhoun","Mississippi","US","2020-05-24 02:32:43",33.93683395,-89.33686647,60,4,0,56,"Calhoun, Mississippi, US",14361,-71,165,167,-2,7,-75,-68,-1,212,11.600041677,-0.138922655,0.4862292918,-5.209599555,-4.723370264,3979
45017,"Calhoun","South Carolina","US","2020-05-24 02:32:43",33.66926881,-80.77722168,9,1,0,8,"Calhoun, South Carolina, US",14553,-10,134,187,-53,2,43,45,-2,158,12.84517104,-3.640609974,0.1373815084,2.9537024317,3.0910839401,3013
48057,"Calhoun","Texas","US","2020-05-24 02:32:43",28.47048236,-96.61633945,37,3,0,34,"Calhoun, Texas, US",21290,-214,262,218,44,8,-267,-259,1,251,10.18834416,2.0563630415,0.3738841894,-12.47838482,-12.10450063,12279
54013,"Calhoun","West Virginia","US","2020-05-24 02:32:43",38.84315422,-81.11934872,2,0,0,2,"Calhoun, West Virginia, US",7109,-108,49,85,-36,-2,-69,-71,-1,22,11.866536367,-5.025827167,-0.27921262,-9.632835404,-9.912048025,1774
48059,"Callahan","Texas","US","2020-05-24 02:32:43",32.29760619,-99.37326312,8,1,0,7,"Callahan, Texas, US",13943,-47,143,173,-30,5,-21,-16,-1,72,12.386782659,-2.147996993,0.3579994988,-1.503597895,-1.145598396,2606
29027,"Callaway","Missouri","US","2020-05-24 02:32:43",38.83674754,-91.92186505,24,1,0,23,"Callaway, Missouri, US",44743,-211,470,436,34,14,-260,-246,1,3683,9.7216183373,0.758107852,0.3121620567,-5.797295339,-5.485133282,14972
21035,"Calloway","Kentucky","US","2020-05-24 02:32:43",36.62093411,-88.2731593,49,1,0,48,"Calloway, Kentucky, US",39001,37,359,407,-48,14,71,85,0,3237,10.440582313,-1.231321747,0.3591355095,1.821330084,2.1804655935,17677
55015,"Calumet","Wisconsin","US","2020-05-24 02:32:43",44.0816316,-88.21780273,69,1,0,68,"Calumet, Wisconsin, US",50089,-43,477,356,121,13,-175,-162,-2,155,7.1042994981,2.4146635935,0.2594266671,-3.492282057,-3.23285539,15006
24009,"Calvert","Maryland","US","2020-05-24 02:32:43",38.53961642,-76.56820632,298,15,0,283,"Calvert, Maryland, US",92525,460,892,722,170,26,272,298,-8,642,7.8227422937,1.8419199307,0.2817054012,2.9470718891,3.2287772902,23790
16025,"Camas","Idaho","US","2020-05-24 02:32:43",43.46665742,-114.8065892,1,0,0,1,"Camas, Idaho, US",1106,-15,10,6,4,0,-18,-18,-1,0,5.3884149079,3.5922766053,0,-16.16524472,-16.16524472,403
42021,"Cambria","Pennsylvania","US","2020-05-24 02:32:43",40.49527404,-78.71377428,56,2,0,54,"Cambria, Pennsylvania, US",130192,-1257,1218,1727,-509,29,-774,-745,-3,5905,13.201294904,-3.890827508,0.2216777951,-5.916503912,-5.694826117,53759
13039,"Camden","Georgia","US","2020-05-24 02:32:43",30.92951916,-81.66601818,53,1,0,52,"Camden, Georgia, US",54666,1015,768,372,396,-29,645,616,3,2018,6.8687279005,7.311871636,-0.535465347,11.909487892,11.374022545,20526
29029,"Camden","Missouri","US","2020-05-24 02:32:43",38.02199522,-92.76083747,36,1,0,35,"Camden, Missouri, US",46305,392,381,535,-154,-12,558,546,0,774,11.602940858,-3.339911948,-0.260252879,12.101758876,11.841505997,18193
34007,"Camden","New Jersey","US","2020-05-24 02:32:43",39.80343818,-74.96388753,5953,303,0,5650,"Camden, New Jersey, US",506471,118,5923,4741,1182,556,-1610,-1054,-10,7521,9.36194245,2.3340679131,1.0979202705,-3.17922956,-2.08130929,196841
37029,"Camden","North Carolina","US","2020-05-24 02:32:43",36.33804939,-76.15568396,3,0,0,3,"Camden, North Carolina, US",10867,191,96,63,33,11,148,159,-1,17,5.8487675811,3.0636401615,1.0212133872,13.739961937,14.761175324,1320
22023,"Cameron","Louisiana","US","2020-05-24 02:32:43",29.87592238,-93.19310676,3,0,0,3,"Cameron, Louisiana, US",6973,-40,86,66,20,-4,-57,-61,1,20,9.438009438,2.86000286,-0.572000572,-8.151008151,-8.723008723,4466
42023,"Cameron","Pennsylvania","US","2020-05-24 02:32:43",41.43625568,-78.20376845,2,0,0,2,"Cameron, Pennsylvania, US",4447,-54,37,70,-33,8,-28,-20,-1,92,15.645954403,-7.375949933,1.7881090747,-6.258381761,-4.470272687,2245
48061,"Cameron","Texas","US","2020-05-24 02:32:43",26.14524221,-97.48140372,698,32,0,666,"Cameron, Texas, US",423163,1024,6202,2788,3414,11,-2407,-2396,6,3319,6.596459017,8.0775864721,0.0260262013,-5.695006045,-5.668979844,142401
48063,"Camp","Texas","US","2020-05-24 02:32:43",32.97195142,-94.97790104,32,0,0,32,"Camp, Texas, US",13094,111,178,131,47,20,45,65,-1,67,10.047168002,3.6047091307,1.533918779,3.4513172528,4.9852360318,3679
21037,"Campbell","Kentucky","US","2020-05-24 02:32:43",38.94384345,-84.37875208,146,11,0,135,"Campbell, Kentucky, US",93584,120,1141,887,254,-1,-130,-131,-3,3222,9.4841965699,2.7158804157,-0.010692443,-1.390017536,-1.400709978,30151
47013,"Campbell","Tennessee","US","2020-05-24 02:32:43",36.40355516,-84.1510856,17,1,0,16,"Campbell, Tennessee, US",39842,47,438,581,-143,23,169,192,-2,653,14.591207605,-3.591295503,0.5776209551,4.2442583221,4.8218792772,9984
51031,"Campbell","Virginia","US","2020-05-24 02:32:43",37.20553386,-79.09678609,13,1,0,12,"Campbell, Virginia, US",54885,-252,478,577,-99,33,-185,-152,-1,456,10.488811329,-1.799640072,0.599880024,-3.362963771,-2.763083747,20000
56005,"Campbell","Wyoming","US","2020-05-24 02:32:43",44.24886082,-105.5474404,30,0,0,30,"Campbell, Wyoming, US",46341,42,597,323,274,33,-268,-235,3,507,6.9732297064,5.9153713299,0.7124352332,-5.785837651,-5.073402418,29594
40017,"Canadian","Oklahoma","US","2020-05-24 02:32:43",35.5426055,-97.98465569,124,3,0,121,"Canadian, Oklahoma, US",148306,3880,1829,1092,737,57,3078,3135,8,2482,7.4607490811,5.0353224109,0.3894347048,21.029474058,21.418908763,34791
13043,"Candler","Georgia","US","2020-05-24 02:32:43",32.40209349,-82.07702563,13,0,0,13,"Candler, Georgia, US",10803,-24,130,125,5,2,-30,-28,-1,267,11.558021267,0.4623208507,0.1849283403,-2.773925104,-2.588996764,3108
47015,"Cannon","Tennessee","US","2020-05-24 02:32:43",35.80990797,-86.05738983,16,0,0,16,"Cannon, Tennessee, US",14678,238,180,155,25,7,206,213,0,152,10.6463356,1.7171509032,0.4808022529,14.149323443,14.630125695,2380
16027,"Canyon","Idaho","US","2020-05-24 02:32:43",43.61970148,-116.7095499,284,6,0,278,"Canyon, Idaho, US",229849,6613,3099,1547,1552,-96,5132,5036,25,3304,6.828740744,6.8508116579,-0.423761546,22.653585972,22.229824426,61763
29031,"Cape Girardeau","Missouri","US","2020-05-24 02:32:43",37.38489388,-89.6843587,58,2,0,56,"Cape Girardeau, Missouri, US",78871,233,899,738,161,128,-53,75,-3,3842,9.3708930918,2.0443276257,1.6253039509,-0.672977417,0.9523265337,42702
34009,"Cape May","New Jersey","US","2020-05-24 02:32:43",39.15008829,-74.80170244,558,48,0,510,"Cape May, New Jersey, US",92039,-407,734,1299,-565,-15,181,166,-8,2592,14.082445727,-6.125159227,-0.162614847,1.9622191506,1.7996043039,41980
30009,"Carbon","Montana","US","2020-05-24 02:32:43",45.22850116,-109.0274047,6,0,0,6,"Carbon, Montana, US",10725,34,73,86,-13,2,46,48,-1,53,8.0313784087,-1.214045573,0.1867762421,4.2958535674,4.4826298095,3386
42025,"Carbon","Pennsylvania","US","2020-05-24 02:32:43",40.91545395,-75.7068525,227,22,0,205,"Carbon, Pennsylvania, US",64182,7,589,801,-212,6,219,225,-6,702,12.480815226,-3.303286926,0.0934892526,3.412357721,3.5058469737,17088
56007,"Carbon","Wyoming","US","2020-05-24 02:32:43",41.69357844,-106.9326084,16,0,0,16,"Carbon, Wyoming, US",14800,-79,176,119,57,8,-144,-136,0,676,8.0191381111,3.8410997675,0.5391017218,-9.703830992,-9.16472927,7431
16029,"Caribou","Idaho","US","2020-05-24 02:32:43",42.77149116,-111.5597683,1,0,0,1,"Caribou, Idaho, US",7155,118,98,60,38,7,73,80,0,32,8.4554678692,5.3551296505,0.9864712514,10.287485908,11.273957159,3655
21039,"Carlisle","Kentucky","US","2020-05-24 02:32:43",36.85372876,-88.9669222,5,1,0,4,"Carlisle, Kentucky, US",4760,21,53,48,5,0,17,17,-1,60,10.106326982,1.0527423939,0,3.5793241394,3.5793241394,1130
27017,"Carlton","Minnesota","US","2020-05-24 02:32:43",46.59180601,-92.67601019,71,0,0,71,"Carlton, Minnesota, US",35871,49,368,368,0,2,50,52,-3,1999,10.265995285,0,0.0557934526,1.394836316,1.4506297686,14266
24011,"Caroline","Maryland","US","2020-05-24 02:32:43",38.87172293,-75.82904158,231,0,0,231,"Caroline, Maryland, US",33406,100,397,349,48,43,9,52,0,442,10.462885238,1.4390214654,1.2891233961,0.2698165248,1.5589399209,8719
51033,"Caroline","Virginia","US","2020-05-24 02:32:43",38.02679129,-77.34901405,46,2,0,44,"Caroline, Virginia, US",30725,-26,343,289,54,5,-84,-79,-1,513,9.4020430737,1.7567831349,0.1626651051,-2.732773765,-2.57010866,6509
5015,"Carroll","Arkansas","US","2020-05-24 02:32:43",36.3403856,-93.54270261,10,0,0,10,"Carroll, Arkansas, US",28380,283,301,305,-4,25,265,290,-3,230,10.800856986,-0.141650583,0.8853161464,9.3843511518,10.269667298,10858
13045,"Carroll","Georgia","US","2020-05-24 02:32:43",33.58138199,-85.07976677,440,24,0,416,"Carroll, Georgia, US",119992,1995,1535,1093,442,55,1494,1549,4,4111,9.1852984802,3.7144573909,0.4622062364,12.555202131,13.017408368,41898
17015,"Carroll","Illinois","US","2020-05-24 02:32:43",42.06823429,-89.93395545,13,2,0,11,"Carroll, Illinois, US",14305,-9,131,192,-61,2,51,53,-1,223,13.417659597,-4.262902268,0.1397672875,3.5640658304,3.7038331179,5124
18015,"Carroll","Indiana","US","2020-05-24 02:32:43",40.5807832,-86.56198812,88,2,0,86,"Carroll, Indiana, US",20257,69,232,191,41,16,13,29,-1,106,9.4449252071,2.027444678,0.7911979231,0.6428483125,1.4340462356,5497
19027,"Carroll","Iowa","US","2020-05-24 02:32:43",42.03617207,-94.86032705,8,0,0,8,"Carroll, Iowa, US",20165,12,237,224,13,7,-8,-1,0,387,11.111662285,0.6448732576,0.3472394464,-0.396845082,-0.049605635,11502
21041,"Carroll","Kentucky","US","2020-05-24 02:32:43",38.66599534,-85.12601074,7,0,0,7,"Carroll, Kentucky, US",10631,-81,141,125,16,0,-98,-98,1,325,11.713442346,1.4993206203,0,-9.1833388,-9.1833388,7149
24013,"Carroll","Maryland","US","2020-05-24 02:32:43",39.56453592,-77.02373735,765,76,0,689,"Carroll, Maryland, US",168447,180,1663,1615,48,21,120,141,-9,3366,9.5927107278,0.2851084303,0.1247349383,0.7127710757,0.837506014,56874
28015,"Carroll","Mississippi","US","2020-05-24 02:32:43",33.44834567,-89.91994479,113,9,0,104,"Carroll, Mississippi, US",9947,27,84,101,-17,-2,46,44,0,376,10.167614637,-1.711380682,-0.201338904,4.6307947853,4.4294558816,1075
29033,"Carroll","Missouri","US","2020-05-24 02:32:43",39.42762566,-93.50626255,7,0,0,7,"Carroll, Missouri, US",8679,-47,84,114,-30,-2,-14,-16,-1,88,13.099683999,-3.447285263,-0.229819018,-1.608733123,-1.83855214,2948
33003,"Carroll","New Hampshire","US","2020-05-24 02:32:43",43.87498583,-71.20430216,46,0,0,46,"Carroll, New Hampshire, US",48910,156,325,582,-257,10,402,412,1,426,11.918414155,-5.262942333,0.2047837484,8.2323066841,8.4370904325,21589
39019,"Carroll","Ohio","US","2020-05-24 02:32:43",40.5789686,-81.09178213,28,2,0,26,"Carroll, Ohio, US",26914,-168,269,303,-34,-2,-132,-134,0,405,11.22305356,-1.259352545,-0.074079561,-4.889251056,-4.963330617,7723
47017,"Carroll","Tennessee","US","2020-05-24 02:32:43",35.97366108,-88.45189331,27,1,0,26,"Carroll, Tennessee, US",27767,-208,296,394,-98,0,-112,-112,2,1202,14.136557712,-3.516199634,0,-4.018513867,-4.018513867,7927
51035,"Carroll","Virginia","US","2020-05-24 02:32:43",36.73066666,-80.73455942,66,1,0,65,"Carroll, Virginia, US",29791,50,199,383,-184,16,220,236,-2,337,12.867029497,-6.181549419,0.5375260364,7.3909830007,7.9285090372,8888
48065,"Carson","Texas","US","2020-05-24 02:32:43",35.40365929,-101.3542669,6,0,0,6,"Carson, Texas, US",5926,-81,43,55,-12,0,-68,-68,-1,25,9.2181345848,-2.011229364,0,-11.3969664,-11.3969664,2162
32510,"Carson City","Nevada","US","2020-05-24 02:32:43",39.15509045,-119.7480219,83,4,0,79,"Carson City, Nevada, US",55916,714,598,637,-39,-43,795,752,1,2824,11.465289152,-0.701956479,-0.773952015,14.309112835,13.53516082,29879
21043,"Carter","Kentucky","US","2020-05-24 02:32:43",38.31690743,-83.05092385,9,0,0,9,"Carter, Kentucky, US",26797,-243,310,336,-26,3,-221,-218,1,595,12.482121961,-0.965878485,0.1114475175,-8.209967123,-8.098519605,6827
29035,"Carter","Missouri","US","2020-05-24 02:32:43",36.94160441,-90.96051322,4,1,0,3,"Carter, Missouri, US",5982,-101,72,89,-17,-1,-84,-85,1,40,14.753418981,-2.818068794,-0.165768753,-13.92457522,-14.09034397,2040
40019,"Carter","Oklahoma","US","2020-05-24 02:32:43",34.25103751,-97.28552485,22,1,0,21,"Carter, Oklahoma, US",48111,-102,630,614,16,4,-120,-116,-2,913,12.748640007,0.3322121174,0.0830530294,-2.491590881,-2.408537851,23887
47019,"Carter","Tennessee","US","2020-05-24 02:32:43",36.28969086,-82.12588974,19,1,0,18,"Carter, Tennessee, US",56391,-26,473,760,-287,6,256,262,-1,1011,13.474221686,-5.088291611,0.1063754344,4.5386851996,4.645060634,12595
37031,"Carteret","North Carolina","US","2020-05-24 02:32:43",34.8932941,-76.54120135,36,9,0,27,"Carteret, North Carolina, US",69473,35,531,894,-363,22,378,400,-2,985,12.871550849,-5.226367962,0.3167495735,5.4423335805,5.759083154,27062
27019,"Carver","Minnesota","US","2020-05-24 02:32:43",44.82017001,-93.8009918,154,2,0,152,"Carver, Minnesota, US",105089,1556,1157,549,608,47,905,952,-4,877,5.2631074383,5.8287237204,0.4505756823,8.6759785641,9.1265542464,40156
30013,"Cascade","Montana","US","2020-05-24 02:32:43",47.30797024,-111.3467922,17,2,0,15,"Cascade, Montana, US",81366,-322,1054,785,269,6,-595,-589,-2,2484,9.6287119605,3.2995204043,0.0735952507,-7.29819569,-7.224600439,39296
21045,"Casey","Kentucky","US","2020-05-24 02:32:43",37.32533118,-84.92726209,2,0,0,2,"Casey, Kentucky, US",16159,233,185,202,-17,-2,254,252,-2,475,12.591553686,-1.059685211,-0.124668848,15.832943743,15.708274895,3910
17017,"Cass","Illinois","US","2020-05-24 02:32:43",39.96991073,-90.24734436,67,0,0,67,"Cass, Illinois, US",12147,-165,167,130,37,44,-247,-203,1,184,10.630033934,3.0254711967,3.5978576393,-20.19706448,-16.59920684,5728
18017,"Cass","Indiana","US","2020-05-24 02:32:43",40.76135835,-86.34830753,1579,6,0,1573,"Cass, Indiana, US",37689,-206,452,415,37,112,-354,-242,-1,1051,10.981160034,0.9790431837,2.9635901778,-9.367061812,-6.403471634,15610
19029,"Cass","Iowa","US","2020-05-24 02:32:43",41.33149454,-94.92792482,10,0,0,10,"Cass, Iowa, US",12836,-112,141,182,-41,7,-77,-70,-1,296,14.117282035,-3.180266832,0.542972386,-5.972696246,-5.42972386,6539
26027,"Cass","Michigan","US","2020-05-24 02:32:43",41.91522292,-85.99405727,76,2,0,74,"Cass, Michigan, US",51787,62,496,529,-33,-5,104,99,-4,558,10.221037174,-0.637607234,-0.096607157,2.0094288585,1.9128217018,12352
27021,"Cass","Minnesota","US","2020-05-24 02:32:43",46.95043611,-94.32603968,11,3,0,8,"Cass, Minnesota, US",29779,268,284,329,-45,7,304,311,2,224,11.097992916,-1.517962557,0.2361275089,10.254680385,10.490807893,10659
29037,"Cass","Missouri","US","2020-05-24 02:32:43",38.64789422,-94.353399,77,8,0,69,"Cass, Missouri, US",105780,1011,1128,993,135,4,876,880,-4,1045,9.4324836499,1.2823618255,0.0379959059,8.3211034011,8.359099307,26392
31025,"Cass","Nebraska","US","2020-05-24 02:32:43",40.90899107,-96.13971217,34,0,0,34,"Cass, Nebraska, US",26248,59,267,232,35,7,17,24,0,253,8.8487136945,1.3349352556,0.2669870511,0.6483971242,0.9153841753,6490
38017,"Cass","North Dakota","US","2020-05-24 02:32:43",46.93201724,-97.2444719,1487,35,0,1452,"Cass, North Dakota, US",181923,1629,2511,1116,1395,416,-174,242,-8,5389,6.1620520296,7.702565037,2.2969656311,-0.960750048,1.3362155835,108110
48067,"Cass","Texas","US","2020-05-24 02:32:43",33.07499881,-94.34646905,21,0,0,21,"Cass, Texas, US",30026,-80,302,405,-103,6,18,24,-1,355,13.470365197,-3.425796581,0.1995609659,0.5986828976,0.7982438635,9074
16031,"Cassia","Idaho","US","2020-05-24 02:32:43",42.28347888,-113.6012409,22,1,0,21,"Cassia, Idaho, US",24030,239,391,185,206,3,31,34,-1,278,7.7371865917,8.6154618264,0.1254678907,1.296501537,1.4219694277,10582
48069,"Castro","Texas","US","2020-05-24 02:32:43",34.53016752,-102.2617243,29,1,0,28,"Castro, Texas, US",7530,-58,104,57,47,24,-129,-105,0,64,7.5406799841,6.2177536711,3.1750231512,-17.06574944,-13.89072629,2771
37033,"Caswell","North Carolina","US","2020-05-24 02:32:43",36.39312665,-79.33353281,52,1,0,51,"Caswell, North Carolina, US",22604,-30,210,245,-35,13,-5,8,-3,1340,10.831601751,-1.547371679,0.5747380521,-0.221053097,0.3536849551,3190
22025,"Catahoula","Louisiana","US","2020-05-24 02:32:43",31.66778967,-91.84526385,112,3,0,109,"Catahoula, Louisiana, US",9494,-112,106,115,-9,11,-114,-103,0,866,12.041884817,-0.942408377,1.1518324607,-11.93717277,-10.78534031,2482
37035,"Catawba","North Carolina","US","2020-05-24 02:32:43",35.66211129,-81.2132617,143,3,0,140,"Catawba, North Carolina, US",159551,864,1671,1713,-42,233,679,912,-6,2587,10.765527687,-0.263953393,1.4643128728,4.2672465262,5.7315593989,82101
13047,"Catoosa","Georgia","US","2020-05-24 02:32:43",34.89872298,-85.13757014,97,0,0,97,"Catoosa, Georgia, US",67580,200,674,676,-2,2,204,206,-4,468,10.017783047,-0.029638411,0.0296384114,3.0231179609,3.0527563723,16241
35003,"Catron","New Mexico","US","2020-05-24 02:32:43",33.91514144,-108.4046587,2,1,0,1,"Catron, New Mexico, US",3527,-27,10,28,-18,0,-9,-9,0,106,7.9084875018,-5.08402768,0,-2.54201384,-2.54201384,955
36009,"Cattaraugus","New York","US","2020-05-24 02:32:43",42.24778241,-78.67923096,78,0,0,78,"Cattaraugus, New York, US",76117,-609,801,848,-47,5,-565,-560,-2,2554,11.096353775,-0.615010174,0.0654266142,-7.393207409,-7.327780795,30632
36011,"Cayuga","New York","US","2020-05-24 02:32:43",42.91261714,-76.55731592,76,1,0,75,"Cayuga, New York, US",76576,-545,741,711,30,26,-602,-576,1,3780,9.2519697847,0.3903784719,0.338328009,-7.83359467,-7.495266661,28353
24015,"Cecil","Maryland","US","2020-05-24 02:32:43",39.56647682,-75.94627411,342,20,0,322,"Cecil, Maryland, US",102855,211,1130,1004,126,-12,102,90,-5,1350,9.7713370868,1.2262833396,-0.116788889,0.9927055606,0.8759166711,33776
19031,"Cedar","Iowa","US","2020-05-24 02:32:43",41.77233777,-91.13246684,44,1,0,43,"Cedar, Iowa, US",18627,63,194,171,23,0,42,42,-2,320,9.1957731709,1.2368583797,0,2.2586109543,2.2586109543,5809
29039,"Cedar","Missouri","US","2020-05-24 02:32:43",37.72391475,-93.85445441,9,0,0,9,"Cedar, Missouri, US",14349,213,186,207,-21,-3,239,236,-2,156,14.533965245,-1.474460242,-0.210637177,16.780761804,16.570124627,3881
31027,"Cedar","Nebraska","US","2020-05-24 02:32:43",42.5988851,-97.25311951,7,0,0,7,"Cedar, Nebraska, US",8402,-51,103,93,10,1,-62,-61,0,137,11.035301098,1.1865915159,0.1186591516,-7.356867398,-7.238208247,3650
42027,"Centre","Pennsylvania","US","2020-05-24 02:32:43",40.92058903,-77.82200624,143,6,0,137,"Centre, Pennsylvania, US",162385,-216,1147,1105,42,835,-1101,-266,8,19594,6.8002929357,0.2584726727,5.1386828971,-6.775676491,-1.636993594,81057
19033,"Cerro Gordo","Iowa","US","2020-05-24 02:32:43",43.08177563,-93.2612239,21,1,0,20,"Cerro Gordo, Iowa, US",42450,-192,442,495,-53,15,-153,-138,-1,1155,11.634466225,-1.245710525,0.3525595826,-3.596107742,-3.24354816,24692
8015,"Chaffee","Colorado","US","2020-05-24 02:32:43",38.74745778,-106.1926573,70,18,0,52,"Chaffee, Colorado, US",20356,315,131,175,-44,9,351,360,-1,1460,8.6640097037,-2.178379583,0.4455776419,17.377528034,17.823105676,8182
1017,"Chambers","Alabama","US","2020-05-24 02:32:43",32.91360079,-85.39072749,330,23,0,307,"Chambers, Alabama, US",33254,-346,354,441,-87,6,-265,-259,0,458,13.192927873,-2.602686451,0.1794956173,-7.927723098,-7.748227481,8353
48071,"Chambers","Texas","US","2020-05-24 02:32:43",29.70972016,-94.67154501,58,0,0,58,"Chambers, Texas, US",43837,1610,561,275,286,35,1290,1325,-1,222,6.390593047,6.6462167689,0.813348206,29.977691021,30.791039227,13662
17019,"Champaign","Illinois","US","2020-05-24 02:32:43",40.13919438,-88.20046615,537,7,0,530,"Champaign, Illinois, US",209689,-229,2232,1389,843,1608,-2697,-1089,17,16386,6.6204805926,4.0180454568,7.6643144657,-12.85488564,-5.190571177,109471
39021,"Champaign","Ohio","US","2020-05-24 02:32:43",40.13923427,-83.76875242,26,1,0,25,"Champaign, Ohio, US",38885,100,412,398,14,3,87,90,-4,673,10.248487189,0.3604995494,0.0772499034,2.2402471997,2.3174971031,11996
29041,"Chariton","Missouri","US","2020-05-24 02:32:43",39.51499357,-92.9629191,6,0,0,6,"Chariton, Missouri, US",7426,-31,82,98,-16,0,-14,-14,-1,213,13.169387892,-2.150104146,0,-1.881341127,-1.881341127,2201
24017,"Charles","Maryland","US","2020-05-24 02:32:43",38.51092331,-76.98580666,969,69,0,900,"Charles, Maryland, US",163257,1781,1847,1164,683,65,1043,1108,-10,1407,7.1689665048,4.2065327515,0.4003288856,6.423738887,6.8240677726,42905
51036,"Charles City","Virginia","US","2020-05-24 02:32:43",37.35358063,-77.05634116,27,1,0,26,"Charles City, Virginia, US",6963,-37,52,92,-40,1,3,4,-1,0,13.177683879,-5.729427773,0.1432356943,0.429707083,0.5729427773,1724
46023,"Charles Mix","South Dakota","US","2020-05-24 02:32:43",43.20660134,-98.58856175,12,0,0,12,"Charles Mix, South Dakota, US",9292,-39,157,106,51,-1,-90,-91,1,589,11.383772754,5.4770982119,-0.107394083,-9.665467433,-9.772861515,4105
45019,"Charleston","South Carolina","US","2020-05-24 02:32:43",32.82487866,-79.96512315,550,11,0,539,"Charleston, South Carolina, US",411406,5184,4763,3629,1134,423,3601,4024,26,10869,8.8768975622,2.7738776069,1.0347003772,8.8084067571,9.8431071343,241776
26029,"Charlevoix","Michigan","US","2020-05-24 02:32:43",45.37790017,-85.19614053,14,1,0,13,"Charlevoix, Michigan, US",26143,-44,218,292,-74,20,12,32,-2,279,11.159946493,-2.828205618,0.7643798968,0.4586279381,1.2230078349,10745
12015,"Charlotte","Florida","US","2020-05-24 02:32:43",26.90131002,-81.92949121,417,56,0,361,"Charlotte, Florida, US",188910,4061,1047,2841,-1794,160,5674,5834,21,2883,15.20230951,-9.599768835,0.8561666742,30.361810685,31.21797736,49005
51037,"Charlotte","Virginia","US","2020-05-24 02:32:43",37.01909701,-78.66314092,19,0,0,19,"Charlotte, Virginia, US",11880,-64,115,158,-43,4,-25,-21,0,175,13.263935527,-3.609805238,0.3357958361,-2.098723976,-1.76292814,3004
51540,"Charlottesville","Virginia","US","2020-05-24 02:32:43",38.03527919,-78.48569588,74,3,0,71,"Charlottesville, Virginia, US",47266,-240,568,312,256,184,-681,-497,1,2423,6.5842231883,5.4024395391,3.8830034187,-14.37133331,-10.48832989,37578
13049,"Charlton","Georgia","US","2020-05-24 02:32:43",30.78371028,-82.13951596,29,1,0,28,"Charlton, Georgia, US",13392,473,109,107,2,85,383,468,3,2576,8.1334802934,0.152027669,6.461175934,29.11329862,35.574474554,2723
20017,"Chase","Kansas","US","2020-05-24 02:32:43",38.30292938,-96.59563862,4,0,0,4,"Chase, Kansas, US",2648,48,18,14,4,0,44,44,0,145,5.3353658537,1.5243902439,0,16.768292683,16.768292683,812
13051,"Chatham","Georgia","US","2020-05-24 02:32:43",32.00043026,-81.12489526,435,21,0,414,"Chatham, Georgia, US",289430,264,3549,2570,979,304,-994,-690,-25,14754,8.8835733396,3.384053813,1.0508195701,-3.435903463,-2.385083893,152259
37037,"Chatham","North Carolina","US","2020-05-24 02:32:43",35.70394416,-79.25541492,573,26,0,547,"Chatham, North Carolina, US",74470,1343,667,770,-103,-8,1448,1440,6,762,10.433816405,-1.395692324,-0.108403287,19.620995007,19.512591719,17373
13053,"Chattahoochee","Georgia","US","2020-05-24 02:32:43",32.34341231,-84.78809239,22,0,0,22,"Chattahoochee, Georgia, US",10907,307,239,24,215,38,53,91,1,2513,2.2318314967,19.993490491,3.5337332031,4.9286278886,8.4623610917,14985
13055,"Chattooga","Georgia","US","2020-05-24 02:32:43",34.47197698,-85.34535662,24,2,0,22,"Chattooga, Georgia, US",24789,7,299,310,-11,5,13,18,0,1280,12.507312743,-0.443807872,0.2017308507,0.5245002118,0.7262310625,7018
20019,"Chautauqua","Kansas","US","2020-05-24 02:32:43",37.14994405,-96.2454192,4,0,0,4,"Chautauqua, Kansas, US",3250,-54,28,40,-12,0,-42,-42,0,79,12.206286237,-3.661885871,0,-12.81660055,-12.81660055,1076
36013,"Chautauqua","New York","US","2020-05-24 02:32:43",42.2276921,-79.36691763,72,4,0,68,"Chautauqua, New York, US",126903,-569,1282,1398,-116,21,-471,-450,-3,5924,10.991646192,-0.912039312,0.1651105651,-3.703194103,-3.538083538,55959
35005,"Chaves","New Mexico","US","2020-05-24 02:32:43",33.36406072,-104.4665365,35,2,0,33,"Chaves, New Mexico, US",64615,61,819,635,184,26,-148,-122,-1,1776,9.8320804527,2.8489807926,0.4025733729,-2.291571507,-1.888998134,23320
47021,"Cheatham","Tennessee","US","2020-05-24 02:32:43",36.26136216,-87.08903581,103,0,0,103,"Cheatham, Tennessee, US",40667,165,451,403,48,-1,119,118,-1,317,9.9298993458,1.1827175399,-0.024639949,2.9321539011,2.9075139524,8963
26031,"Cheboygan","Michigan","US","2020-05-24 02:32:43",45.44787015,-84.50122149,21,1,0,20,"Cheboygan, Michigan, US",25276,-228,219,370,-151,-1,-74,-75,-2,391,14.572666404,-5.947223316,-0.039385585,-2.914533281,-2.953918866,7568
53007,"Chelan","Washington","US","2020-05-24 02:32:43",47.87046092,-120.6173956,204,6,0,198,"Chelan, Washington, US",77200,448,851,687,164,7,279,286,-2,931,8.9248596965,2.1305341925,0.090937435,3.6245063396,3.7154437747,37202
36015,"Chemung","New York","US","2020-05-24 02:32:43",42.13891056,-76.7638805,136,1,0,135,"Chemung, New York, US",83456,-479,859,943,-84,17,-411,-394,-1,3634,11.267033473,-1.003638188,0.2031172524,-4.910658279,-4.707541027,38709
36017,"Chenango","New York","US","2020-05-24 02:32:43",42.49430041,-75.60887553,118,0,0,118,"Chenango, New York, US",47207,-238,470,535,-65,-2,-169,-171,-2,718,11.304568313,-1.373452225,-0.042260068,-3.570975785,-3.613235853,18747
1019,"Cherokee","Alabama","US","2020-05-24 02:32:43",34.17805983,-85.60638968,33,2,0,31,"Cherokee, Alabama, US",26196,182,222,343,-121,-3,306,303,0,290,13.139245355,-4.63512737,-0.114920513,11.721892358,11.606971844,6037
13057,"Cherokee","Georgia","US","2020-05-24 02:32:43",34.24393976,-84.47431861,807,29,0,778,"Cherokee, Georgia, US",258773,4859,2721,1656,1065,217,3561,3778,16,1624,6.4600818823,4.1545816453,0.8465203916,13.891516656,14.738037048,63572
19035,"Cherokee","Iowa","US","2020-05-24 02:32:43",42.73538914,-95.62389402,14,0,0,14,"Cherokee, Iowa, US",11235,-60,112,163,-51,3,-11,-8,-1,366,14.469596094,-4.527296937,0.2663115846,-0.97647581,-0.710164225,5409
20021,"Cherokee","Kansas","US","2020-05-24 02:32:43",37.16928494,-94.8462897,9,0,0,9,"Cherokee, Kansas, US",19939,-96,212,264,-52,10,-54,-44,0,202,13.208585581,-2.601691099,0.5003252114,-2.701756141,-2.20143093,6654
37039,"Cherokee","North Carolina","US","2020-05-24 02:32:43",35.1349263,-84.05970864,30,1,0,29,"Cherokee, North Carolina, US",28612,243,250,380,-130,-14,386,372,1,440,13.33777926,-4.562924484,-0.491391867,13.548375774,13.056983907,9513
40021,"Cherokee","Oklahoma","US","2020-05-24 02:32:43",35.90692775,-94.99980896,28,1,0,27,"Cherokee, Oklahoma, US",48657,50,556,534,22,42,-11,31,-3,2011,10.980424412,0.4523770357,0.8636288863,-0.226188518,0.6374403685,16784
45021,"Cherokee","South Carolina","US","2020-05-24 02:32:43",35.05122251,-81.61828622,27,2,0,25,"Cherokee, South Carolina, US",57300,231,652,624,28,-9,214,205,-2,1135,10.912047845,0.4896431725,-0.157385305,3.7422728187,3.5848875132,18651
48073,"Cherokee","Texas","US","2020-05-24 02:32:43",31.837258,-95.16559897,44,2,0,42,"Cherokee, Texas, US",52646,265,722,553,169,3,94,97,-1,2772,10.530625458,3.2182200767,0.057128167,1.7900159007,1.8471440677,16116
31031,"Cherry","Nebraska","US","2020-05-24 02:32:43",42.54502621,-101.1244332,1,0,0,1,"Cherry, Nebraska, US",5689,-74,77,57,20,-2,-92,-94,0,40,9.9545930842,3.4928396787,-0.349283968,-16.06706252,-16.41634649,3493
51550,"Chesapeake","Virginia","US","2020-05-24 02:32:43",36.67670048,-76.30545744,426,13,0,413,"Chesapeake, Virginia, US",244835,2476,2865,1920,945,94,1458,1552,-21,4313,7.8818704664,3.8793581202,0.3858832416,5.9852953854,6.371178627,95905
33005,"Cheshire","New Hampshire","US","2020-05-24 02:32:43",42.92015988,-72.25311043,51,2,0,49,"Cheshire, New Hampshire, US",76085,184,636,718,-82,52,217,269,-3,4078,9.4482386536,-1.079046754,0.6842735515,2.8555261669,3.5397997184,36235
42029,"Chester","Pennsylvania","US","2020-05-24 02:32:43",39.97291773,-75.74768357,2364,245,0,2119,"Chester, Pennsylvania, US",524989,2903,5292,4194,1098,895,948,1843,-38,13510,8.0108874722,2.0972709691,1.7095241506,1.8107585417,3.5202826923,248658
45023,"Chester","South Carolina","US","2020-05-24 02:32:43",34.69249168,-81.1583216,46,0,0,46,"Chester, South Carolina, US",32244,-60,358,424,-66,4,5,9,-3,218,13.13751007,-2.044989775,0.1239387742,0.1549234678,0.2788622421,8510
47023,"Chester","Tennessee","US","2020-05-24 02:32:43",35.42527478,-88.6095842,12,0,0,12,"Chester, Tennessee, US",17297,52,181,159,22,7,25,32,-2,1139,9.2061837763,1.2738115917,0.4053036883,1.4475131724,1.8528168606,4847
45025,"Chesterfield","South Carolina","US","2020-05-24 02:32:43",34.64137396,-80.1564014,129,2,0,127,"Chesterfield, South Carolina, US",45650,-231,496,571,-75,13,-168,-155,-1,874,12.476647256,-1.638789044,0.2840567677,-3.670887459,-3.386830691,16611
51041,"Chesterfield","Virginia","US","2020-05-24 02:32:43",37.37373208,-77.5868014,1193,29,0,1164,"Chesterfield, Virginia, US",352802,4521,3868,2622,1246,257,3032,3289,-14,4573,7.4798561654,3.5545006797,0.7331514243,8.6494751691,9.3826265934,119988
8017,"Cheyenne","Colorado","US","2020-05-24 02:32:43",38.82777431,-102.6032558,5,0,0,5,"Cheyenne, Colorado, US",1831,-28,17,13,4,6,-38,-32,0,42,7.0460704607,2.1680216802,3.2520325203,-20.59620596,-17.34417344,1170
20023,"Cheyenne","Kansas","US","2020-05-24 02:32:43",39.78580976,-101.7318201,2,0,0,2,"Cheyenne, Kansas, US",2657,12,28,43,-15,2,24,26,1,49,16.220294229,-5.658242173,0.7544322897,9.0531874764,9.8076197661,1177
31033,"Cheyenne","Nebraska","US","2020-05-24 02:32:43",41.21999357,-102.9941693,9,0,0,9,"Cheyenne, Nebraska, US",8910,-372,86,84,2,-3,-371,-374,0,101,9.234828496,0.219876869,-0.329815303,-40.78715919,-41.11697449,6398
19037,"Chickasaw","Iowa","US","2020-05-24 02:32:43",43.06001295,-92.31773347,8,0,0,8,"Chickasaw, Iowa, US",11933,-19,145,111,34,6,-59,-53,0,101,9.2945363199,2.846975089,0.5024073686,-4.940339125,-4.437931756,5050
28017,"Chickasaw","Mississippi","US","2020-05-24 02:32:43",33.91983202,-88.9481545,125,12,0,113,"Chickasaw, Mississippi, US",17103,3,231,200,31,19,-45,-26,-2,505,11.694880566,1.8127064877,1.1110136538,-2.631348127,-1.520334474,6149
5017,"Chicot","Arkansas","US","2020-05-24 02:32:43",33.26458973,-91.29539209,12,0,0,12,"Chicot, Arkansas, US",10118,-324,111,150,-39,-2,-283,-285,0,769,14.591439689,-3.793774319,-0.194552529,-27.52918288,-27.72373541,3668
48075,"Childress","Texas","US","2020-05-24 02:32:43",34.5293041,-100.2077916,2,0,0,2,"Childress, Texas, US",7306,-9,66,49,17,4,-30,-26,0,1730,6.7026879146,2.3254223377,0.5471581971,-4.103686478,-3.556528281,2759
1021,"Chilton","Alabama","US","2020-05-24 02:32:43",32.85044126,-86.7173256,86,1,0,85,"Chilton, Alabama, US",44428,265,551,503,48,35,184,219,-2,393,11.355555305,1.0836315201,0.7901479834,4.1539208272,4.9440688106,10819
26033,"Chippewa","Michigan","US","2020-05-24 02:32:43",46.29552653,-84.54353449,2,0,0,2,"Chippewa, Michigan, US",37349,-112,318,374,-56,3,-57,-54,-2,4821,9.9986632803,-1.497126053,0.0802031814,-1.523860446,-1.443657265,14594
27023,"Chippewa","Minnesota","US","2020-05-24 02:32:43",45.02343421,-95.56403693,39,0,0,39,"Chippewa, Minnesota, US",11800,-101,164,138,26,21,-148,-127,0,237,11.645078267,2.1940002532,1.7720771275,-12.48892452,-10.71684739,6029
55017,"Chippewa","Wisconsin","US","2020-05-24 02:32:43",45.06939744,-91.28068855,48,0,0,48,"Chippewa, Wisconsin, US",64658,549,654,576,78,-1,474,473,-2,2701,8.9463915444,1.2114905216,-0.01553193,7.3621347084,7.3466027787,25969
27025,"Chisago","Minnesota","US","2020-05-24 02:32:43",45.5021011,-92.90861945,44,1,0,43,"Chisago, Minnesota, US",56579,607,600,401,199,20,391,411,-3,1682,7.1256585903,3.5361747119,0.3553944434,6.9479613686,7.303355812,16695
50007,"Chittenden","Vermont","US","2020-05-24 02:32:43",44.46322849,-73.08359212,440,38,0,402,"Chittenden, Vermont, US",163774,203,1450,1151,299,317,-410,-93,-3,10040,7.0323359147,1.8268187997,1.9367945134,-2.505002368,-0.568207854,101282
1023,"Choctaw","Alabama","US","2020-05-24 02:32:43",32.02227341,-88.2656443,139,4,0,135,"Choctaw, Alabama, US",12589,-244,133,176,-43,-2,-199,-201,0,129,13.84627488,-3.382896704,-0.157344033,-15.65573126,-15.81307529,3477
28019,"Choctaw","Mississippi","US","2020-05-24 02:32:43",33.34598242,-89.24809382,29,2,0,27,"Choctaw, Mississippi, US",8210,-55,80,106,-26,1,-28,-27,-2,122,12.867981791,-3.15629742,0.1213960546,-3.39908953,-3.277693475,1954
40023,"Choctaw","Oklahoma","US","2020-05-24 02:32:43",34.02807439,-95.54771129,14,0,0,14,"Choctaw, Oklahoma, US",14672,-26,193,204,-11,0,-14,-14,-1,172,13.891726251,-0.74906367,0,-0.953353762,-0.953353762,5031
37041,"Chowan","North Carolina","US","2020-05-24 02:32:43",36.12908077,-76.60118385,15,0,0,15,"Chowan, North Carolina, US",13943,-122,136,191,-55,0,-66,-66,-1,249,13.638960297,-3.9274493,0,-4.71293916,-4.71293916,4594
17021,"Christian","Illinois","US","2020-05-24 02:32:43",39.54581621,-89.27780482,33,4,0,29,"Christian, Illinois, US",32304,-349,324,396,-72,-1,-275,-276,-1,1594,12.192681312,-2.216851148,-0.030789599,-8.4671398,-8.497929399,11332
21047,"Christian","Kentucky","US","2020-05-24 02:32:43",36.89267803,-87.49055367,103,3,0,100,"Christian, Kentucky, US",70461,-251,1466,627,839,-62,-1026,-1088,-2,5502,8.8827183668,11.886125534,-0.878354926,-14.53535733,-15.41371225,53635
29043,"Christian","Missouri","US","2020-05-24 02:32:43",36.9711783,-93.18537118,21,0,0,21,"Christian, Missouri, US",88595,1551,1025,664,361,10,1178,1188,2,583,7.5609631118,4.1107043424,0.1138699264,13.413877328,13.527747254,18237
32001,"Churchill","Nevada","US","2020-05-24 02:32:43",39.58105744,-118.3394607,6,0,0,6,"Churchill, Nevada, US",24909,403,327,260,67,-5,341,336,0,314,10.52312051,2.7117272083,-0.202367702,13.801477284,13.599109582,9743
35006,"Cibola","New Mexico","US","2020-05-24 02:32:43",34.91131525,-107.998876,122,4,0,118,"Cibola, New Mexico, US",26675,-91,306,263,43,9,-143,-134,0,2576,9.8426301903,1.6092513239,0.3368200445,-5.351696263,-5.014876219,9317
40025,"Cimarron","Oklahoma","US","2020-05-24 02:32:43",36.74817177,-102.5173885,1,0,0,1,"Cimarron, Oklahoma, US",2137,-28,22,9,13,2,-42,-40,-1,7,4.1841004184,6.0437006044,0.929800093,-19.52580195,-18.59600186,1001
12017,"Citrus","Florida","US","2020-05-24 02:32:43",28.84804315,-82.47614748,119,12,0,107,"Citrus, Florida, US",149657,1975,1066,2706,-1640,-18,3619,3601,14,2251,18.201446833,-11.0311799,-0.121073926,24.342585399,24.221511473,36145
41005,"Clackamas","Oregon","US","2020-05-24 02:32:43",45.18787398,-122.2179634,290,9,0,281,"Clackamas, Oregon, US",418187,2771,3987,3559,428,23,2340,2363,-20,2925,8.5388368324,1.0268677056,0.0551821431,5.6141832503,5.6693653934,149407
22027,"Claiborne","Louisiana","US","2020-05-24 02:32:43",32.82308512,-92.99526883,58,10,0,48,"Claiborne, Louisiana, US",15670,-225,134,200,-66,0,-160,-160,1,2922,12.672263583,-4.181846982,0,-10.13781087,-10.13781087,4387
28021,"Claiborne","Mississippi","US","2020-05-24 02:32:43",31.97061673,-90.90702196,57,1,0,56,"Claiborne, Mississippi, US",8988,-84,113,101,12,1,-98,-97,1,1293,11.184939092,1.3289036545,0.1107419712,-10.85271318,-10.74197121,2728
47025,"Claiborne","Tennessee","US","2020-05-24 02:32:43",36.48319149,-83.65947309,8,0,0,8,"Claiborne, Tennessee, US",31959,109,333,427,-94,22,183,205,-2,1293,13.383691956,-2.946292843,0.6895578994,5.735867981,6.4254258804,9156
53009,"Clallam","Washington","US","2020-05-24 02:32:43",48.04754642,-123.9226319,25,0,0,25,"Clallam, Washington, US",77331,780,632,1061,-429,44,1162,1206,3,1818,13.78978698,-5.575700862,0.571866755,15.102481122,15.674347877,26436
26035,"Clare","Michigan","US","2020-05-24 02:32:43",43.98794227,-84.8481986,17,2,0,15,"Clare, Michigan, US",30950,215,324,400,-76,6,286,292,-1,391,12.969117289,-2.464132285,0.1945367593,9.272918862,9.4674556213,8113
45027,"Clarendon","South Carolina","US","2020-05-24 02:32:43",33.66610974,-80.21647898,289,37,0,252,"Clarendon, South Carolina, US",33745,3,302,408,-106,-1,113,112,-3,1561,12.091217568,-3.141345741,-0.029635337,3.3487931009,3.3191577637,8088
42031,"Clarion","Pennsylvania","US","2020-05-24 02:32:43",41.19265812,-79.42413524,28,2,0,26,"Clarion, Pennsylvania, US",38438,-234,370,440,-70,11,-175,-164,0,1774,11.412268188,-1.815588121,0.2853067047,-4.538970302,-4.253663597,14697
5019,"Clark","Arkansas","US","2020-05-24 02:32:43",34.04613432,-93.17484713,36,0,0,36,"Clark, Arkansas, US",22320,7,233,241,-8,2,14,16,-1,2986,10.79918446,-0.358479152,0.089619788,0.6273385163,0.7169583044,9167
17023,"Clark","Illinois","US","2020-05-24 02:32:43",39.33425789,-87.78705622,10,0,0,10,"Clark, Illinois, US",15441,-159,168,199,-31,-3,-125,-128,0,221,12.821751877,-1.997358333,-0.193292742,-8.053864244,-8.247156986,5196
18019,"Clark","Indiana","US","2020-05-24 02:32:43",38.48015445,-85.70510334,450,38,0,412,"Clark, Indiana, US",118302,1022,1436,1197,239,64,719,783,0,1328,10.162066711,2.0290174971,0.5433352293,6.1040317172,6.6473669465,46769
20025,"Clark","Kansas","US","2020-05-24 02:32:43",37.23577007,-99.81883015,31,1,0,30,"Clark, Kansas, US",1994,0,23,22,1,0,-1,-1,0,57,11.033099298,0.5015045135,0,-0.501504514,-0.501504514,824
21049,"Clark","Kentucky","US","2020-05-24 02:32:43",37.9689263,-84.14615986,37,0,0,37,"Clark, Kentucky, US",36263,83,426,414,12,-10,82,72,-1,458,11.429675745,0.3312949491,-0.276079124,2.2638488191,1.9877696948,13667
29045,"Clark","Missouri","US","2020-05-24 02:32:43",40.41040752,-91.73661677,1,0,0,1,"Clark, Missouri, US",6797,-36,72,67,5,4,-45,-41,0,90,9.8312545855,0.7336757153,0.5869405723,-6.603081438,-6.016140866,1845
32003,"Clark","Nevada","US","2020-05-24 02:32:43",36.21458855,-115.0130241,5815,322,0,5493,"Clark, Nevada, US",2266715,40600,27048,17919,9129,-360,31643,31283,188,23015,7.9767095572,4.0638083346,-0.16025534,14.085999248,13.925743908,918012
39023,"Clark","Ohio","US","2020-05-24 02:32:43",39.91592258,-83.78498252,195,6,0,189,"Clark, Ohio, US",134083,-445,1554,1661,-107,23,-355,-332,-6,3519,12.367326729,-0.796691126,0.1712513635,-2.643227567,-2.471976204,48388
46025,"Clark","South Dakota","US","2020-05-24 02:32:43",44.85834507,-97.72925109,4,0,0,4,"Clark, South Dakota, US",3736,10,64,30,34,1,-26,-25,1,489,8.0407397481,9.1128383811,0.2680246583,-6.968641115,-6.700616457,1650
53011,"Clark","Washington","US","2020-05-24 02:32:43",45.77568046,-122.4829204,399,22,0,377,"Clark, Washington, US",488241,6814,5574,3766,1808,139,4847,4986,20,3419,7.7676070573,3.7291114072,0.286696065,9.9972361674,10.283932232,151638
55019,"Clark","Wisconsin","US","2020-05-24 02:32:43",44.73483377,-90.61207486,28,4,0,24,"Clark, Wisconsin, US",34774,69,568,313,255,14,-200,-186,0,477,9.0099166655,7.3403474431,0.4029994675,-5.757135249,-5.354135782,12998
1025,"Clarke","Alabama","US","2020-05-24 02:32:43",31.68099859,-87.83548597,97,2,0,95,"Clarke, Alabama, US",23622,-296,266,324,-58,-5,-232,-237,-1,280,13.630626841,-2.440050484,-0.21034918,-9.760201935,-9.970551115,8313
13059,"Clarke","Georgia","US","2020-05-24 02:32:43",33.95436462,-83.37124007,222,13,0,209,"Clarke, Georgia, US",128331,1063,1339,806,533,326,205,531,-1,10413,6.3067539388,4.1705953466,2.5508706998,1.6040751333,4.1549458331,70897
19039,"Clarke","Iowa","US","2020-05-24 02:32:43",41.02868181,-93.78499767,30,0,0,30,"Clarke, Iowa, US",9395,-107,124,106,18,19,-142,-123,-2,156,11.218711965,1.9050642959,2.0109012012,-15.02884056,-13.01793936,4384
28023,"Clarke","Mississippi","US","2020-05-24 02:32:43",32.04158545,-88.6889622,124,16,0,108,"Clarke, Mississippi, US",15541,-44,199,202,-3,0,-40,-40,-1,52,12.979502667,-0.192764891,0,-2.570198548,-2.570198548,3864
51043,"Clarke","Virginia","US","2020-05-24 02:32:43",39.11271747,-77.99199425,21,0,0,21,"Clarke, Virginia, US",14619,108,122,142,-20,-1,130,129,-1,180,9.7493992448,-1.373154823,-0.068657741,8.9255063508,8.8568486097,4119
41007,"Clatsop","Oregon","US","2020-05-24 02:32:43",45.99712889,-123.660711,45,0,0,45,"Clatsop, Oregon, US",40224,513,377,398,-21,-12,542,530,4,844,9.9580909489,-0.525426909,-0.300243948,13.561018327,13.260774379,18133
1027,"Clay","Alabama","US","2020-05-24 02:32:43",33.26984193,-85.85836077,27,2,0,25,"Clay, Alabama, US",13235,-59,143,187,-44,-2,-12,-14,-1,255,14.097779788,-3.317124656,-0.150778393,-0.904670361,-1.055448754,4083
5021,"Clay","Arkansas","US","2020-05-24 02:32:43",36.36826212,-90.4148172,4,0,0,4,"Clay, Arkansas, US",14551,-212,155,197,-42,0,-170,-170,0,125,13.44067681,-2.865525005,0,-11.59855359,-11.59855359,4905
12019,"Clay","Florida","US","2020-05-24 02:32:43",29.98319144,-81.85609986,354,27,0,327,"Clay, Florida, US",219252,3344,2183,1877,306,170,2875,3045,-7,1250,8.626712014,1.4063792628,0.7813218127,13.213530655,13.994852468,49196
13061,"Clay","Georgia","US","2020-05-24 02:32:43",31.62221166,-84.97713865,35,2,0,33,"Clay, Georgia, US",2834,-50,22,35,-13,-2,-34,-36,-1,57,12.242042672,-4.547044421,-0.699545296,-11.89227002,-12.59181532,545
17025,"Clay","Illinois","US","2020-05-24 02:32:43",38.75388572,-88.48914513,2,0,0,2,"Clay, Illinois, US",13184,-82,144,173,-29,1,-53,-52,-1,305,13.081285444,-2.192816635,0.0756143667,-4.007561437,-3.93194707,5699
18021,"Clay","Indiana","US","2020-05-24 02:32:43",39.39561833,-87.11723506,38,1,0,37,"Clay, Indiana, US",26225,50,307,288,19,1,32,33,-2,341,10.992366412,0.7251908397,0.0381679389,1.2213740458,1.2595419847,7470
19041,"Clay","Iowa","US","2020-05-24 02:32:43",43.08247182,-95.15096481,10,0,0,10,"Clay, Iowa, US",16016,-90,201,163,38,4,-133,-129,1,214,10.148807671,2.3659797024,0.249050495,-8.280928958,-8.031878463,9013
20027,"Clay","Kansas","US","2020-05-24 02:32:43",39.34948772,-97.16518128,5,1,0,4,"Clay, Kansas, US",8002,-1,92,106,-14,1,13,14,-1,140,13.245860669,-1.749453296,0.1249609497,1.6244923461,1.7494532958,3880
21051,"Clay","Kentucky","US","2020-05-24 02:32:43",37.16451126,-83.712575,4,0,0,4,"Clay, Kentucky, US",19901,-187,239,245,-6,-3,-178,-181,0,1754,12.253369677,-0.300082523,-0.150041261,-8.902448173,-9.052489435,3947
27027,"Clay","Minnesota","US","2020-05-24 02:32:43",46.89289518,-96.48761922,361,23,0,338,"Clay, Minnesota, US",64222,205,851,453,398,100,-294,-194,1,2923,7.0649334446,6.2071600683,1.5595879569,-4.585188593,-3.025600636,22205
28025,"Clay","Mississippi","US","2020-05-24 02:32:43",33.65358105,-88.77784255,96,3,0,93,"Clay, Mississippi, US",19316,-88,209,230,-21,4,-70,-66,-1,303,11.880165289,-1.084710744,0.2066115702,-3.615702479,-3.409090909,6086
29047,"Clay","Missouri","US","2020-05-24 02:32:43",39.31132056,-94.41850862,141,2,0,139,"Clay, Missouri, US",249948,3588,3051,1803,1248,109,2231,2340,0,2653,7.2656495563,5.0291351338,0.4392433731,8.9903850029,9.4296283759,94337
31035,"Clay","Nebraska","US","2020-05-24 02:32:43",40.52439441,-98.05126296,22,0,0,22,"Clay, Nebraska, US",6203,1,80,69,11,-1,-8,-9,-1,69,11.124546554,1.7734784361,-0.161225312,-1.289802499,-1.451027811,2499
37043,"Clay","North Carolina","US","2020-05-24 02:32:43",35.05704275,-83.74353633,8,0,0,8,"Clay, North Carolina, US",11231,107,87,163,-76,-8,189,181,2,112,14.582867367,-6.799373742,-0.715723552,16.908968911,16.193245359,2459
46027,"Clay","South Dakota","US","2020-05-24 02:32:43",42.91296147,-96.97656917,15,0,0,15,"Clay, South Dakota, US",14070,87,131,80,51,-1,38,37,-1,2254,5.7034898228,3.6359747621,-0.071293623,2.7091576658,2.6378640431,6695
47027,"Clay","Tennessee","US","2020-05-24 02:32:43",36.55151008,-85.53930419,6,0,0,6,"Clay, Tennessee, US",7615,-62,64,101,-37,2,-29,-27,2,76,13.209521318,-4.839131572,0.2615746796,-3.792832854,-3.531258174,2077
48077,"Clay","Texas","US","2020-05-24 02:32:43",33.78686685,-98.20771198,3,0,0,3,"Clay, Texas, US",10471,23,75,122,-47,7,63,70,0,70,11.664037478,-4.493522635,0.669248052,6.0232324681,6.6924805201,1899
54015,"Clay","West Virginia","US","2020-05-24 02:32:43",38.46231092,-81.07652217,2,0,0,2,"Clay, West Virginia, US",8508,-131,88,109,-21,0,-110,-110,0,74,12.713594215,-2.44940806,0,-12.83023269,-12.83023269,1729
13063,"Clayton","Georgia","US","2020-05-24 02:32:43",33.54187245,-84.35594188,1089,43,0,1046,"Clayton, Georgia, US",292256,3059,4074,1852,2222,423,408,831,6,4773,6.3702483262,7.6429221278,1.4549757246,1.4033808408,2.8583565654,95093
19043,"Clayton","Iowa","US","2020-05-24 02:32:43",42.84443388,-91.34133693,30,3,0,27,"Clayton, Iowa, US",17549,9,178,188,-10,9,11,20,-1,257,10.71560888,-0.569979196,0.5129812762,0.6269771153,1.1399583915,7600
8019,"Clear Creek","Colorado","US","2020-05-24 02:32:43",39.68864463,-105.6463118,16,1,0,15,"Clear Creek, Colorado, US",9700,96,73,57,16,23,56,79,1,84,5.905511811,1.6576875259,2.3829258185,5.8019063407,8.1848321591,3409
42033,"Clearfield","Pennsylvania","US","2020-05-24 02:32:43",41.00110782,-78.47592663,34,0,0,34,"Clearfield, Pennsylvania, US",79255,-317,732,943,-211,59,-161,-102,-4,5659,11.874555334,-2.656978977,0.7429467282,-2.027363106,-1.284416378,32438
27029,"Clearwater","Minnesota","US","2020-05-24 02:32:43",47.57992111,-95.37790562,2,0,0,2,"Clearwater, Minnesota, US",8818,3,110,74,36,5,-38,-33,0,115,8.3933533715,4.0832529915,0.567118471,-4.31010038,-3.742981909,2982
1029,"Cleburne","Alabama","US","2020-05-24 02:32:43",33.67679204,-85.52005899,13,1,0,12,"Cleburne, Alabama, US",14910,-100,187,189,-2,-11,-86,-97,-1,178,12.63368984,-0.13368984,-0.735294118,-5.748663102,-6.483957219,2763
5023,"Cleburne","Arkansas","US","2020-05-24 02:32:43",35.53864922,-92.02640019,73,4,0,69,"Cleburne, Arkansas, US",24919,-75,227,385,-158,-6,90,84,-1,339,15.426842706,-6.331015968,-0.240418328,3.6062749184,3.3658565905,8723
39025,"Clermont","Ohio","US","2020-05-24 02:32:43",39.04847534,-84.15375786,177,5,0,172,"Clermont, Ohio, US",206428,902,2283,1833,450,38,422,460,-8,1716,8.8990518359,2.1847099433,0.1844866174,2.0487724358,2.2332590532,60171
5025,"Cleveland","Arkansas","US","2020-05-24 02:32:43",33.89723187,-92.18537045,18,0,0,18,"Cleveland, Arkansas, US",7956,-39,75,88,-13,-1,-25,-26,0,52,11.033790985,-1.62999185,-0.125383988,-3.134599712,-3.2599837,1233
37045,"Cleveland","North Carolina","US","2020-05-24 02:32:43",35.33553364,-81.55204486,67,2,0,65,"Cleveland, North Carolina, US",97947,428,1102,1219,-117,44,504,548,-3,1894,12.47275741,-1.197139144,0.450206174,5.1569070836,5.6071132575,35332
40027,"Cleveland","Oklahoma","US","2020-05-24 02:32:43",35.20413532,-97.32519562,487,37,0,450,"Cleveland, Oklahoma, US",284014,2848,2735,2105,630,369,1852,2221,-3,10542,7.4489543154,2.2293782512,1.30577869,6.5536643193,7.8594430093,89075
13065,"Clinch","Georgia","US","2020-05-24 02:32:43",30.91395822,-82.70432472,47,1,0,46,"Clinch, Georgia, US",6618,15,83,57,26,8,-18,-10,-1,126,8.6226457908,3.9331366765,1.2101959005,-2.722940776,-1.512744876,2302
17027,"Clinton","Illinois","US","2020-05-24 02:32:43",38.60704876,-89.42385254,176,16,0,160,"Clinton, Illinois, US",37562,-135,413,367,46,-2,-180,-182,1,2069,9.7529863538,1.2224451561,-0.053149789,-4.783481045,-4.836630835,12251
18023,"Clinton","Indiana","US","2020-05-24 02:32:43",40.30319754,-86.47277257,204,1,0,203,"Clinton, Indiana, US",32399,207,422,320,102,20,87,107,-2,831,9.9085011844,3.1583347525,0.619281324,2.6938737595,3.3131550835,11908
19045,"Clinton","Iowa","US","2020-05-24 02:32:43",41.89981633,-90.53275096,61,1,0,60,"Clinton, Iowa, US",46429,-8,508,518,-10,12,-9,3,-1,629,11.15585898,-0.215364073,0.2584368876,-0.193827666,0.0646092219,23152
21053,"Clinton","Kentucky","US","2020-05-24 02:32:43",36.72581156,-85.13377529,3,0,0,3,"Clinton, Kentucky, US",10218,66,121,109,12,-2,55,53,1,135,10.702012764,1.1782032401,-0.196367207,5.4000981836,5.2037309769,4158
26037,"Clinton","Michigan","US","2020-05-24 02:32:43",42.94400871,-84.60145248,137,10,0,127,"Clinton, Michigan, US",79595,376,780,594,186,47,149,196,-6,655,7.4804488269,2.342362764,0.5918873651,1.8764088808,2.4682962459,20440
29049,"Clinton","Missouri","US","2020-05-24 02:32:43",39.6013098,-94.40465394,18,0,0,18,"Clinton, Missouri, US",20387,-48,219,238,-19,-2,-25,-27,-2,445,11.660379207,-0.930870609,-0.09798638,-1.224829749,-1.322816129,4740
36019,"Clinton","New York","US","2020-05-24 02:32:43",44.74530905,-73.67875352,95,4,0,91,"Clinton, New York, US",80485,-194,756,744,12,49,-253,-204,-2,6477,9.2328311534,0.1489166315,0.6080762453,-3.139658981,-2.531582736,34201
39027,"Clinton","Ohio","US","2020-05-24 02:32:43",39.41485808,-83.80852286,43,0,0,43,"Clinton, Ohio, US",41968,-117,470,458,12,3,-129,-126,-3,1121,10.897885858,0.2855341273,0.0713835318,-3.069491868,-2.998108336,18329
42035,"Clinton","Pennsylvania","US","2020-05-24 02:32:43",41.23255967,-77.63785995,49,1,0,48,"Clinton, Pennsylvania, US",38632,-64,368,396,-28,8,-41,-33,-3,2058,10.242085661,-0.724187875,0.2069108214,-1.06041796,-0.853507138,15713
20029,"Cloud","Kansas","US","2020-05-24 02:32:43",39.48028352,-97.64925343,4,0,0,4,"Cloud, Kansas, US",8786,52,98,124,-26,5,74,79,-1,498,14.155251142,-2.96803653,0.5707762557,8.4474885845,9.0182648402,4360
28027,"Coahoma","Mississippi","US","2020-05-24 02:32:43",34.22772299,-90.60415045,96,3,0,93,"Coahoma, Mississippi, US",22124,-481,355,282,73,-7,-548,-555,1,724,12.609269154,3.2641015896,-0.312996043,-24.50311878,-24.81611482,8953
40029,"Coal","Oklahoma","US","2020-05-24 02:32:43",34.58840127,-96.29798747,1,0,0,1,"Coal, Oklahoma, US",5495,-25,68,69,-1,0,-23,-23,-1,61,12.528370404,-0.181570586,0,-4.176123468,-4.176123468,1660
13067,"Cobb","Georgia","US","2020-05-24 02:32:43",33.94243204,-84.5761255,2661,141,0,2520,"Cobb, Georgia, US",760141,4071,9155,4719,4436,1754,-2114,-360,-5,9690,6.2247272972,5.8514283302,2.3136621486,-2.788530092,-0.474867944,339971
4003,"Cochise","Arizona","US","2020-05-24 02:32:43",31.87934684,-109.7516088,58,1,0,57,"Cochise, Arizona, US",125922,-489,1348,1312,36,66,-595,-529,4,4436,10.398956934,0.2853372329,0.5231182604,-4.715990378,-4.192872117,48158
48079,"Cochran","Texas","US","2020-05-24 02:32:43",33.60425307,-102.8284499,1,0,0,1,"Cochran, Texas, US",2853,22,41,10,31,14,-23,-9,0,78,3.5186488388,10.9078114,4.9261083744,-8.092892329,-3.166783955,1003
47029,"Cocke","Tennessee","US","2020-05-24 02:32:43",35.9278914,-83.11828725,20,0,0,20,"Cocke, Tennessee, US",36004,146,361,496,-135,-10,292,282,-1,372,13.804235897,-3.757201302,-0.278311208,8.1266872617,7.8483760541,9672
4005,"Coconino","Arizona","US","2020-05-24 02:32:43",35.83883429,-111.7707178,1000,72,0,928,"Coconino, Arizona, US",143476,953,1513,901,612,25,313,338,3,13646,6.3007213312,4.2797352438,0.1748257861,2.188818842,2.3636446281,63547
46029,"Codington","South Dakota","US","2020-05-24 02:32:43",44.97788119,-97.18827677,29,0,0,29,"Codington, South Dakota, US",28009,-24,316,235,81,4,-108,-104,-1,381,8.3865672174,2.890689126,0.1427500803,-3.854252168,-3.711502088,16315
1031,"Coffee","Alabama","US","2020-05-24 02:32:43",31.39932826,-85.98901039,196,1,0,195,"Coffee, Alabama, US",52342,392,599,570,29,34,334,368,-5,498,10.930848004,0.5561308633,0.652015495,6.4050933916,7.0571088866,18383
13069,"Coffee","Georgia","US","2020-05-24 02:32:43",31.54892966,-82.8549206,227,13,0,214,"Coffee, Georgia, US",43273,218,592,411,181,-1,37,36,1,3277,9.521823742,4.1933092392,-0.023167454,0.8571958113,0.834028357,16278
47031,"Coffee","Tennessee","US","2020-05-24 02:32:43",35.49090731,-86.07311784,65,0,0,65,"Coffee, Tennessee, US",56520,643,700,658,42,-20,623,603,-2,616,11.708497558,0.7473509079,-0.355881385,11.085705134,10.72982375,24511
20031,"Coffey","Kansas","US","2020-05-24 02:32:43",38.2365018,-95.73379515,50,8,0,42,"Coffey, Kansas, US",8179,-53,96,84,12,1,-67,-66,1,130,10.237036134,1.4624337335,0.1218694778,-8.165255012,-8.043385534,4701
48081,"Coke","Texas","US","2020-05-24 02:32:43",31.88911733,-100.5297533,1,0,0,1,"Coke, Texas, US",3387,32,35,46,-11,-1,45,44,-1,34,13.645802433,-3.263126669,-0.296647879,13.349154554,13.052506675,970
1033,"Colbert","Alabama","US","2020-05-24 02:32:43",34.69847452,-87.80168544,125,2,0,123,"Colbert, Alabama, US",55241,237,630,719,-89,73,256,329,-3,474,13.04367545,-1.614585695,1.3243230986,4.6442015511,5.9685246496,22500
29051,"Cole","Missouri","US","2020-05-24 02:32:43",38.50455671,-92.27860244,59,1,0,58,"Cole, Missouri, US",76745,25,863,684,179,57,-210,-153,-1,4913,8.9140846447,2.3327794611,0.7428403871,-2.736780373,-1.993939986,49080
48083,"Coleman","Texas","US","2020-05-24 02:32:43",31.76736834,-99.45240766,2,0,0,2,"Coleman, Texas, US",8175,-192,83,118,-35,3,-160,-157,0,46,14.266715028,-4.231652763,0.3627130939,-19.34469834,-18.98198525,2520
17029,"Coles","Illinois","US","2020-05-24 02:32:43",39.51949084,-88.22358557,98,7,0,91,"Coles, Illinois, US",50621,-208,452,500,-48,51,-210,-159,-1,3298,9.8570724495,-0.946278955,1.0054213898,-4.139970429,-3.134549039,26497
31037,"Colfax","Nebraska","US","2020-05-24 02:32:43",41.57486951,-97.0868542,592,2,0,590,"Colfax, Nebraska, US",10709,-25,193,72,121,120,-267,-147,1,76,6.7154782446,11.285734272,11.192463741,-24.90323182,-13.71076808,5185
35007,"Colfax","New Mexico","US","2020-05-24 02:32:43",36.60569702,-104.6472674,5,0,0,5,"Colfax, New Mexico, US",11941,-130,110,124,-14,-3,-112,-115,-1,408,10.328169249,-1.166083625,-0.249875062,-9.328668999,-9.578544061,4996
45029,"Colleton","South Carolina","US","2020-05-24 02:32:43",32.87582989,-80.67641292,69,8,0,61,"Colleton, South Carolina, US",37677,1,449,570,-121,-21,148,127,-5,385,15.12879381,-3.211550967,-0.557376614,3.928178042,3.3708014279,11893
12021,"Collier","Florida","US","2020-05-24 02:32:43",26.11091986,-81.34687065,1195,45,0,1150,"Collier, Florida, US",384902,6701,3160,3867,-707,1906,5485,7391,17,4545,10.134935913,-1.852960872,4.9953938066,14.375516804,19.370910611,146846
48085,"Collin","Texas","US","2020-05-24 02:32:43",33.18820114,-96.57264368,1132,31,0,1101,"Collin, Texas, US",1034730,30423,11299,4956,6343,4100,19952,24052,28,4426,4.8611182632,6.2215643953,4.0215062306,19.570022516,23.591528746,389810
48087,"Collingsworth","Texas","US","2020-05-24 02:32:43",34.96489496,-100.2700111,4,0,0,4,"Collingsworth, Texas, US",2920,-22,29,34,-5,-2,-14,-16,-1,54,11.600136472,-1.705902422,-0.682360969,-4.776526783,-5.458887752,1033
51570,"Colonial Heights","Virginia","US","2020-05-24 02:32:43",37.26420587,-77.39609676,83,8,0,75,"Colonial Heights, Virginia, US",17370,-134,281,210,71,7,-212,-205,0,171,12.043356082,4.071801342,0.4014452027,-12.15805471,-11.75660951,9908
48089,"Colorado","Texas","US","2020-05-24 02:32:43",29.622098,-96.5273805,19,0,0,19,"Colorado, Texas, US",21493,188,257,247,10,62,116,178,0,336,11.542595448,0.4673115566,2.897331651,5.4208140567,8.3181457077,8631
13071,"Colquitt","Georgia","US","2020-05-24 02:32:43",31.18810588,-83.7677946,289,14,0,275,"Colquitt, Georgia, US",45600,145,605,471,134,-18,29,11,0,1232,10.34539564,2.943276042,-0.395365438,0.6369776509,0.2416122124,16588
5027,"Columbia","Arkansas","US","2020-05-24 02:32:43",33.21230701,-93.22642793,20,2,0,18,"Columbia, Arkansas, US",23457,-129,262,279,-17,9,-120,-111,-1,2161,11.861488425,-0.722743022,0.3826286589,-5.101715452,-4.719086793,10045
12023,"Columbia","Florida","US","2020-05-24 02:32:43",30.22509788,-82.62160164,125,2,0,123,"Columbia, Florida, US",71686,1018,804,863,-59,4,1065,1069,8,5474,12.124703205,-0.828919454,0.0561979291,14.962698625,15.018896554,25142
13073,"Columbia","Georgia","US","2020-05-24 02:32:43",33.54534185,-82.263524,223,6,0,217,"Columbia, Georgia, US",156714,2637,1770,1035,735,75,1833,1908,-6,713,6.6604245297,4.729866695,0.4826394587,11.79570837,12.278347829,31281
36021,"Columbia","New York","US","2020-05-24 02:32:43",42.24819348,-73.63089095,359,32,0,327,"Columbia, New York, US",59461,-324,489,676,-187,43,-178,-135,-2,1921,11.337906513,-3.136373547,0.7211981953,-2.985425088,-2.264226892,24704
41009,"Columbia","Oregon","US","2020-05-24 02:32:43",45.94464254,-123.0890898,16,0,0,16,"Columbia, Oregon, US",52354,109,499,503,-4,-8,122,114,-1,452,9.6176827694,-0.076482567,-0.152965134,2.332718286,2.1797531525,10859
42037,"Columbia","Pennsylvania","US","2020-05-24 02:32:43",41.04821986,-76.40565017,342,29,0,313,"Columbia, Pennsylvania, US",64964,-251,515,730,-215,-4,-27,-31,-5,3540,11.215326589,-3.303144132,-0.061453844,-0.414813449,-0.476267293,27865
53013,"Columbia","Washington","US","2020-05-24 02:32:43",46.29442881,-117.9051983,1,0,0,1,"Columbia, Washington, US",3985,-54,38,44,-6,15,-64,-49,1,75,10.967098704,-1.49551346,3.7387836491,-15.95214357,-12.21335992,1562
55021,"Columbia","Wisconsin","US","2020-05-24 02:32:43",43.46492199,-89.33589004,37,1,0,36,"Columbia, Wisconsin, US",57532,199,602,519,83,8,107,115,1,1361,9.0366952509,1.4451747704,0.1392939538,1.8630566317,2.0023505855,21350
39029,"Columbiana","Ohio","US","2020-05-24 02:32:43",40.76932373,-80.78094576,477,50,0,427,"Columbiana, Ohio, US",101883,-590,982,1186,-204,-1,-382,-383,-3,3962,11.607195287,-1.996515884,-0.009786843,-3.738573861,-3.748360704,32795
37047,"Columbus","North Carolina","US","2020-05-24 02:32:43",34.26744084,-78.65801424,289,21,0,268,"Columbus, North Carolina, US",55508,-311,558,761,-203,18,-124,-106,-2,3108,13.671436399,-3.646914046,0.3233716888,-2.227671634,-1.904299945,17827
6011,"Colusa","California","US","2020-05-24 02:32:43",39.17881957,-122.2331726,5,0,0,5,"Colusa, California, US",21547,129,282,129,153,-33,10,-23,-1,253,6.0048876993,7.1220761085,-1.536134063,0.4654951705,-1.070638892,8964
48091,"Comal","Texas","US","2020-05-24 02:32:43",29.80811278,-98.27647225,78,6,0,72,"Comal, Texas, US",156209,8068,1589,1242,347,85,7600,7685,36,1232,8.1616559882,2.2802694266,0.5585674388,49.942500411,50.50106785,51288
20033,"Comanche","Kansas","US","2020-05-24 02:32:43",37.1911452,-99.27113247,1,0,0,1,"Comanche, Kansas, US",1700,-36,20,15,5,-1,-40,-41,0,65,8.7310826542,2.9103608847,-0.582072177,-23.28288708,-23.86495925,970
40031,"Comanche","Oklahoma","US","2020-05-24 02:32:43",34.65973764,-98.47195055,270,3,0,267,"Comanche, Oklahoma, US",120749,221,1630,1095,535,56,-369,-313,-1,10323,9.0767043688,4.4347368377,0.4641967531,-3.058725034,-2.594528281,60654
48093,"Comanche","Texas","US","2020-05-24 02:32:43",31.94854689,-98.55876441,5,1,0,4,"Comanche, Texas, US",13635,95,139,182,-43,7,131,138,0,150,13.394664213,-3.164673413,0.5151793928,9.6412143514,10.156393744,3897
48095,"Concho","Texas","US","2020-05-24 02:32:43",31.32635934,-99.86473038,1,0,0,1,"Concho, Texas, US",2726,43,24,29,-5,26,22,48,0,40,10.722869292,-1.848770568,9.6136069514,8.1345904973,17.748197449,1142
22029,"Concordia","Louisiana","US","2020-05-24 02:32:43",31.44817835,-91.63814433,69,5,0,64,"Concordia, Louisiana, US",19259,-327,254,239,15,-8,-335,-343,1,1476,12.305315999,0.7723001673,-0.411893423,-17.24803707,-17.65993049,6292
1035,"Conecuh","Alabama","US","2020-05-24 02:32:43",31.43401703,-86.99320044,25,1,0,24,"Conecuh, Alabama, US",12067,-225,123,182,-59,1,-167,-166,0,45,14.943142165,-4.844205427,0.0821051767,-13.71156451,-13.62945934,3296
8021,"Conejos","Colorado","US","2020-05-24 02:32:43",37.201606,-106.1917488,1,0,0,1,"Conejos, Colorado, US",8205,24,86,73,13,3,10,13,-2,36,8.9100451605,1.586720371,0.3661662395,1.2205541316,1.586720371,1958
6013,"Contra Costa","California","US","2020-05-24 02:32:43",37.91923498,-121.9289527,1296,36,0,1260,"Contra Costa, California, US",1153526,3007,12070,8478,3592,2916,-3497,-581,-4,10418,7.359231265,3.1179946572,2.5312005625,-3.03553099,-0.504330428,372702
56009,"Converse","Wyoming","US","2020-05-24 02:32:43",42.97272268,-105.5081848,24,0,0,24,"Converse, Wyoming, US",13822,164,154,111,43,5,118,123,-2,103,8.0786026201,3.1295487627,0.3639010189,8.5880640466,8.9519650655,7166
5029,"Conway","Arkansas","US","2020-05-24 02:32:43",35.26205537,-92.70506566,14,1,0,13,"Conway, Arkansas, US",20846,21,227,213,14,-5,14,9,-2,285,10.222936815,0.6719301193,-0.239975043,0.6719301193,0.4319550767,7552
13075,"Cook","Georgia","US","2020-05-24 02:32:43",31.16068491,-83.42947229,44,2,0,42,"Cook, Georgia, US",17270,99,205,203,2,0,97,97,0,143,11.788275602,0.1161406463,0,5.6328213467,5.6328213467,4873
17031,"Cook","Illinois","US","2020-05-24 02:32:43",41.84144849,-87.81658794,70417,3246,0,67171,"Cook, Illinois, US",5150233,-21727,61822,42432,19390,11637,-52810,-41173,56,90978,8.2215087433,3.7569535853,2.254753423,-10.23232176,-7.977568333,2584653
48097,"Cooke","Texas","US","2020-05-24 02:32:43",33.63979567,-97.21240912,13,0,0,13,"Cooke, Texas, US",41257,753,530,417,113,23,616,639,1,644,10.200462323,2.7641540588,0.5626154279,15.068308851,15.630924279,16423
29053,"Cooper","Missouri","US","2020-05-24 02:32:43",38.844478,-92.80896081,9,0,0,9,"Cooper, Missouri, US",17709,83,202,184,18,12,56,68,-3,1539,10.414603085,1.018819867,0.6792132447,3.1696618084,3.8488750531,6087
33007,"Coos","New Hampshire","US","2020-05-24 02:32:43",44.69063265,-71.30633239,4,0,0,4,"Coos, New Hampshire, US",31563,77,225,419,-194,-2,274,272,-1,2370,13.291249663,-6.153943758,-0.063442719,8.6916525242,8.6282098051,13485
41011,"Coos","Oregon","US","2020-05-24 02:32:43",43.17406868,-124.0594514,31,0,0,31,"Coos, Oregon, US",64487,215,599,937,-338,-15,568,553,0,1226,14.554322416,-5.250118438,-0.232993422,8.8226842395,8.5896908177,23136
1037,"Coosa","Alabama","US","2020-05-24 02:32:43",32.93690146,-86.24847739,33,1,0,32,"Coosa, Alabama, US",10663,20,89,122,-33,13,42,55,-2,196,11.452173097,-3.097718952,1.2203135267,3.942551394,5.1628649207,1419
28029,"Copiah","Mississippi","US","2020-05-24 02:32:43",31.86977774,-90.44565118,273,4,0,269,"Copiah, Mississippi, US",28065,-335,339,309,30,11,-374,-363,-2,861,10.944833082,1.0626051536,0.3896218897,-13.24714425,-12.85752236,7404
46031,"Corson","South Dakota","US","2020-05-24 02:32:43",45.70889983,-101.1970473,4,0,0,4,"Corson, South Dakota, US",4086,-92,91,58,33,1,-126,-125,0,1,14.03678606,7.986447241,0.2420135528,-30.49370765,-30.25169409,1135
36023,"Cortland","New York","US","2020-05-24 02:32:43",42.59509207,-76.07048931,38,0,0,38,"Cortland, New York, US",47581,-141,472,422,50,19,-210,-191,0,3789,8.8559646601,1.0492849123,0.3987282667,-4.406996632,-4.008268365,22175
48099,"Coryell","Texas","US","2020-05-24 02:32:43",31.39078397,-97.79936155,226,2,0,224,"Coryell, Texas, US",75951,1210,895,468,427,9,769,778,5,12250,6.2113449951,5.6671887028,0.1194489422,10.206248507,10.325697449,20367
39031,"Coshocton","Ohio","US","2020-05-24 02:32:43",40.30096166,-81.91729018,24,0,0,24,"Coshocton, Ohio, US",36600,4,460,408,52,4,-50,-46,-2,428,11.148150172,1.420842669,0.1092955899,-1.366194874,-1.256899284,13054
8023,"Costilla","Colorado","US","2020-05-24 02:32:43",37.27732493,-105.4276548,3,0,0,3,"Costilla, Colorado, US",3887,75,37,34,3,10,63,73,-1,0,8.8323158852,0.7793219899,2.5977399662,16.365761787,18.963501753,999
48101,"Cottle","Texas","US","2020-05-24 02:32:43",34.07783319,-100.2785062,4,1,0,3,"Cottle, Texas, US",1398,16,13,12,1,0,16,16,-1,0,8.6330935252,0.7194244604,0,11.510791367,11.510791367,568
40033,"Cotton","Oklahoma","US","2020-05-24 02:32:43",34.28845626,-98.37053567,5,2,0,3,"Cotton, Oklahoma, US",5666,-154,63,75,-12,0,-141,-141,-1,48,13.059376632,-2.089500261,0,-24.55162807,-24.55162807,1844
27033,"Cottonwood","Minnesota","US","2020-05-24 02:32:43",44.00715262,-95.18138802,62,0,0,62,"Cottonwood, Minnesota, US",11196,-63,144,134,10,-4,-69,-73,0,244,11.934981073,0.8906702293,-0.356268092,-6.145624582,-6.501892674,5624
1039,"Covington","Alabama","US","2020-05-24 02:32:43",31.2477854,-86.45050893,63,1,0,62,"Covington, Alabama, US",37049,96,413,543,-130,-5,235,230,-4,575,14.675279047,-3.513418556,-0.135131483,6.3511796978,6.2160482149,12903
28031,"Covington","Mississippi","US","2020-05-24 02:32:43",31.63225413,-89.55389939,127,1,0,126,"Covington, Mississippi, US",18636,-189,237,232,5,5,-201,-196,2,237,12.386214997,0.2669442887,0.2669442887,-10.73116041,-10.46421612,5158
51580,"Covington","Virginia","US","2020-05-24 02:32:43",37.7824656,-79.98631446,3,0,0,3,"Covington, Virginia, US",5538,-40,67,73,-6,6,-39,-33,-1,87,13.134220943,-1.079525009,1.079525009,-7.016912558,-5.937387549,2027
13077,"Coweta","Georgia","US","2020-05-24 02:32:43",33.35334302,-84.76129976,316,8,0,308,"Coweta, Georgia, US",148509,2511,1680,1096,584,110,1811,1921,6,637,7.4429470267,3.9659498756,0.7470111067,12.29851922,13.045530327,39158
20035,"Cowley","Kansas","US","2020-05-24 02:32:43",37.23781842,-96.83776647,4,1,0,3,"Cowley, Kansas, US",34908,-241,393,413,-20,19,-240,-221,0,2013,11.790399246,-0.570963644,0.5424154617,-6.851563727,-6.309148265,14165
53015,"Cowlitz","Washington","US","2020-05-24 02:32:43",46.19074721,-122.6782231,71,0,0,71,"Cowlitz, Washington, US",110593,1841,1287,1134,153,22,1664,1686,2,1208,10.339875539,1.3950625727,0.2005972327,15.172445235,15.373042467,38281
40035,"Craig","Oklahoma","US","2020-05-24 02:32:43",36.76268118,-95.20916602,15,0,0,15,"Craig, Oklahoma, US",14142,-158,128,205,-77,0,-81,-81,0,1050,14.415301315,-5.414527811,0,-5.695801983,-5.695801983,6055
51045,"Craig","Virginia","US","2020-05-24 02:32:43",37.48133648,-80.21072274,5,0,0,5,"Craig, Virginia, US",5131,29,39,62,-23,-1,52,51,1,9,12.117658556,-4.495260432,-0.195446106,10.163197498,9.9677513926,558
5031,"Craighead","Arkansas","US","2020-05-24 02:32:43",35.83018283,-90.63235729,181,0,0,181,"Craighead, Arkansas, US",110332,1516,1456,1030,426,47,1044,1091,-1,3837,9.4000401555,3.8877835983,0.4289338712,9.5278076916,9.9567415628,49190
48103,"Crane","Texas","US","2020-05-24 02:32:43",31.43052248,-102.5143314,3,0,0,3,"Crane, Texas, US",4797,42,59,23,36,7,0,7,-1,90,4.8157453936,7.5376884422,1.4656616415,0,1.4656616415,1969
37049,"Craven","North Carolina","US","2020-05-24 02:32:43",35.11833364,-77.08398081,177,4,0,173,"Craven, North Carolina, US",102139,-199,1340,1035,305,20,-514,-494,-10,5261,10.123387961,2.9832206067,0.1956210234,-5.027460301,-4.831839278,48681
5033,"Crawford","Arkansas","US","2020-05-24 02:32:43",35.58928601,-94.2446814,13,0,0,13,"Crawford, Arkansas, US",63257,-122,758,658,100,5,-227,-222,0,540,10.39198964,1.5793297325,0.0789664866,-3.585078493,-3.506112006,18071
13079,"Crawford","Georgia","US","2020-05-24 02:32:43",32.71391813,-83.98061238,25,0,0,25,"Crawford, Georgia, US",12404,70,91,133,-42,7,106,113,-1,142,10.752688172,-3.395585739,0.5659309564,8.5698116258,9.1357425823,1736
17033,"Crawford","Illinois","US","2020-05-24 02:32:43",39.0032229,-87.75954624,11,0,0,11,"Crawford, Illinois, US",18667,-163,196,217,-21,-2,-140,-142,0,1493,11.574259274,-1.120089607,-0.106675201,-7.467264048,-7.573939248,8287
18025,"Crawford","Indiana","US","2020-05-24 02:32:43",38.28814402,-86.44518825,23,0,0,23,"Crawford, Indiana, US",10577,-17,117,121,-4,0,-12,-12,-1,62,11.430730717,-0.377875396,0,-1.133626187,-1.133626187,2276
19047,"Crawford","Iowa","US","2020-05-24 02:32:43",42.03718237,-95.3819718,460,2,0,458,"Crawford, Iowa, US",16820,-269,228,151,77,38,-386,-348,2,552,8.906190097,4.5415671356,2.2412928721,-22.76681707,-20.5255242,7794
20037,"Crawford","Kansas","US","2020-05-24 02:32:43",37.50675523,-94.85245778,8,1,0,7,"Crawford, Kansas, US",38818,-93,448,361,87,85,-268,-183,3,1779,9.2886824737,2.2385467457,2.187085901,-6.895753194,-4.708667293,18799
26039,"Crawford","Michigan","US","2020-05-24 02:32:43",44.68255561,-84.61006219,58,5,0,53,"Crawford, Michigan, US",14029,124,132,169,-37,6,156,162,-1,197,12.099949882,-2.649101453,0.4295840195,11.169184506,11.598768526,4522
29055,"Crawford","Missouri","US","2020-05-24 02:32:43",37.97663738,-91.30528104,9,0,0,9,"Crawford, Missouri, US",23920,-48,250,296,-46,-4,3,-1,-1,332,12.362178416,-1.921149348,-0.167056465,0.1252923488,-0.041764116,6544
39033,"Crawford","Ohio","US","2020-05-24 02:32:43",40.85065156,-82.91989099,104,3,0,101,"Crawford, Ohio, US",41494,10,455,498,-43,13,41,54,-1,580,12.003181566,-1.036419292,0.313336065,0.9882137434,1.3015498084,14400
42039,"Crawford","Pennsylvania","US","2020-05-24 02:32:43",41.68447709,-80.10760592,21,0,0,21,"Crawford, Pennsylvania, US",84629,-481,908,961,-53,22,-447,-425,-3,3821,11.323266898,-0.624488185,0.2592215107,-5.266909785,-5.007688274,33930
55023,"Crawford","Wisconsin","US","2020-05-24 02:32:43",43.23870316,-90.93073686,25,0,0,25,"Crawford, Wisconsin, US",16131,-134,151,181,-30,3,-107,-104,0,765,11.174219039,-1.852080504,0.1852080504,-6.605753797,-6.420545746,7563
40037,"Creek","Oklahoma","US","2020-05-24 02:32:43",35.90230551,-96.37086028,89,7,0,82,"Creek, Oklahoma, US",71522,-208,791,872,-81,49,-170,-121,-6,1062,12.174350096,-1.130874264,0.6841091224,-2.373439812,-1.68933069,20332
1041,"Crenshaw","Alabama","US","2020-05-24 02:32:43",31.72941803,-86.31593104,58,2,0,56,"Crenshaw, Alabama, US",13772,-53,137,179,-42,3,-14,-11,0,132,12.972424539,-3.04380911,0.2174149364,-1.014603037,-0.7971881,3936
13081,"Crisp","Georgia","US","2020-05-24 02:32:43",31.92289565,-83.76811843,211,7,0,204,"Crisp, Georgia, US",22372,-245,256,289,-33,11,-224,-213,1,478,12.847584965,-1.467025273,0.4890084243,-9.957989731,-9.468981307,9030
5035,"Crittenden","Arkansas","US","2020-05-24 02:32:43",35.21247318,-90.30839406,280,9,0,271,"Crittenden, Arkansas, US",47955,-408,722,534,188,-7,-591,-598,2,1053,11.088270105,3.9037355427,-0.145351855,-12.2718495,-12.41720135,15771
21055,"Crittenden","Kentucky","US","2020-05-24 02:32:43",37.35839237,-88.0882609,5,1,0,4,"Crittenden, Kentucky, US",8806,-90,88,108,-20,-2,-68,-70,0,210,12.202011072,-2.25963168,-0.225963168,-7.682747712,-7.90871088,2577
47033,"Crockett","Tennessee","US","2020-05-24 02:32:43",35.81830662,-89.14916269,14,1,0,13,"Crockett, Tennessee, US",14230,-66,148,180,-32,6,-40,-34,0,194,12.620065905,-2.243567272,0.4206688635,-2.80445909,-2.383790226,4221
41013,"Crook","Oregon","US","2020-05-24 02:32:43",44.14230227,-120.356297,4,0,0,4,"Crook, Oregon, US",24404,579,259,266,-7,-11,596,585,1,261,11.030707666,-0.290281781,-0.456157084,24.715420183,24.259263099,6711
56011,"Crook","Wyoming","US","2020-05-24 02:32:43",44.58855102,-104.5697705,5,0,0,5,"Crook, Wyoming, US",7584,139,103,70,33,20,87,107,-1,34,9.3153237075,4.3915097478,2.6615210593,11.577616608,14.239137667,2803
48107,"Crosby","Texas","US","2020-05-24 02:32:43",33.61431553,-101.3000364,3,1,0,2,"Crosby, Texas, US",5737,-27,61,62,-1,1,-27,-26,0,67,10.781671159,-0.173897922,0.1738979219,-4.695243892,-4.52134597,1721
5037,"Cross","Arkansas","US","2020-05-24 02:32:43",35.29631396,-90.77185818,42,0,0,42,"Cross, Arkansas, US",16419,-211,194,207,-13,2,-202,-200,2,225,12.526854065,-0.786710642,0.1210324064,-12.22427305,-12.10324064,6065
27035,"Crow Wing","Minnesota","US","2020-05-24 02:32:43",46.48096553,-94.06755609,42,1,0,41,"Crow Wing, Minnesota, US",65055,261,648,687,-39,6,294,300,0,737,10.581521614,-0.600697734,0.0924150359,4.5283367604,4.6207517963,30645
8025,"Crowley","Colorado","US","2020-05-24 02:32:43",38.32608609,-103.7844965,57,1,0,56,"Crowley, Colorado, US",6061,104,30,35,-5,0,109,109,0,2917,5.8245964387,-0.832085206,0,18.13945748,18.13945748,1533
1043,"Cullman","Alabama","US","2020-05-24 02:32:43",34.13020303,-86.86888037,74,0,0,74,"Cullman, Alabama, US",83768,350,990,1050,-60,34,380,414,-4,1027,12.560860359,-0.717763449,0.4067326212,4.5458351776,4.9525677987,27551
51047,"Culpeper","Virginia","US","2020-05-24 02:32:43",38.48199985,-77.9563087,574,5,0,569,"Culpeper, Virginia, US",52605,810,659,467,192,48,570,618,0,1474,8.9463601533,3.6781609195,0.9195402299,10.91954023,11.83908046,16340
17035,"Cumberland","Illinois","US","2020-05-24 02:32:43",39.27432424,-88.2401158,10,0,0,10,"Cumberland, Illinois, US",10766,-38,119,109,10,0,-48,-48,0,117,10.106629578,0.9272137228,0,-4.450625869,-4.450625869,2475
21057,"Cumberland","Kentucky","US","2020-05-24 02:32:43",36.78926125,-85.39050034,5,0,0,5,"Cumberland, Kentucky, US",6614,-79,67,104,-37,0,-41,-41,-1,86,15.63087097,-5.560982941,0,-6.162170286,-6.162170286,2046
23005,"Cumberland","Maine","US","2020-05-24 02:32:43",43.8370751,-70.37226999,1009,40,0,969,"Cumberland, Maine, US",295003,1330,2716,2708,8,456,872,1328,-6,9430,9.2003071299,0.027179637,1.5492393099,2.9625804347,4.5118197446,177601
34011,"Cumberland","New Jersey","US","2020-05-24 02:32:43",39.37199394,-75.10712559,1924,62,0,1862,"Cumberland, New Jersey, US",149527,-1108,1757,1435,322,74,-1509,-1435,5,9932,9.5615034548,2.1455080923,0.4930670771,-10.05457053,-9.561503455,61733
37051,"Cumberland","North Carolina","US","2020-05-24 02:32:43",35.04762133,-78.82623165,569,16,0,553,"Cumberland, North Carolina, US",335509,2079,5376,2644,2732,330,-978,-648,-5,16690,7.9050556179,8.1681588306,0.9866370476,-2.924033432,-1.937396384,170689
42041,"Cumberland","Pennsylvania","US","2020-05-24 02:32:43",40.1625372,-77.26130755,584,46,0,538,"Cumberland, Pennsylvania, US",253370,2239,2585,2323,262,354,1634,1988,-11,12386,9.2090996846,1.0386500721,1.4033668912,6.4776878539,7.8810547452,128975
47035,"Cumberland","Tennessee","US","2020-05-24 02:32:43",35.95271721,-84.99840585,107,1,0,106,"Cumberland, Tennessee, US",60520,782,512,843,-331,20,1087,1107,6,736,14.019857307,-5.504831279,0.3326182042,18.077799398,18.410417602,20030
51049,"Cumberland","Virginia","US","2020-05-24 02:32:43",37.51328851,-78.24398086,26,0,0,26,"Cumberland, Virginia, US",9932,75,72,107,-35,0,110,110,0,37,10.814088635,-3.537318712,0,11.117287382,11.117287382,1463
31039,"Cuming","Nebraska","US","2020-05-24 02:32:43",41.91637624,-96.78730772,32,0,0,32,"Cuming, Nebraska, US",8846,-89,105,83,22,-2,-108,-110,-1,124,9.3358078848,2.4745514875,-0.224959226,-12.14779821,-12.37275744,4312
37053,"Currituck","North Carolina","US","2020-05-24 02:32:43",36.36123664,-75.95876401,11,0,0,11,"Currituck, North Carolina, US",27763,747,268,243,25,-13,733,720,2,129,8.8720129977,0.9127585389,-0.47463444,26.762080359,26.287445919,6496
35009,"Curry","New Mexico","US","2020-05-24 02:32:43",34.57421077,-103.3468876,45,0,0,45,"Curry, New Mexico, US",48954,-384,824,378,446,-8,-821,-829,-1,1495,7.6913685753,9.0750010174,-0.162780287,-16.70532698,-16.86810727,23644
41015,"Curry","Oregon","US","2020-05-24 02:32:43",42.45911325,-124.157282,6,0,0,6,"Curry, Oregon, US",22925,130,166,345,-179,-24,332,308,1,304,15.091863517,-7.830271216,-1.049868766,14.523184602,13.473315836,7641
8027,"Custer","Colorado","US","2020-05-24 02:32:43",38.10883162,-105.3683478,2,0,0,2,"Custer, Colorado, US",5068,134,33,40,-7,-1,141,140,1,150,7.9984003199,-1.399720056,-0.199960008,28.194361128,27.99440112,1140
16037,"Custer","Idaho","US","2020-05-24 02:32:43",44.24186819,-114.2855494,2,0,0,2,"Custer, Idaho, US",4315,65,33,38,-5,0,69,69,1,21,8.8733216579,-1.167542323,0,16.112084063,16.112084063,1523
31041,"Custer","Nebraska","US","2020-05-24 02:32:43",41.39374521,-99.72805369,30,4,0,26,"Custer, Nebraska, US",10777,-53,125,128,-3,-2,-48,-50,0,132,11.848012218,-0.277687786,-0.185125191,-4.443004582,-4.628129773,5476
40039,"Custer","Oklahoma","US","2020-05-24 02:32:43",35.63853802,-99.00170785,12,0,0,12,"Custer, Oklahoma, US",29003,8,398,277,121,55,-168,-113,0,1524,9.5520535191,4.1725576744,1.8966171247,-5.793303217,-3.896686093,14370
39035,"Cuyahoga","Ohio","US","2020-05-24 02:32:43",41.424119,-81.65918339,3851,207,0,3644,"Cuyahoga, Ohio, US",1235072,-6646,14022,13527,495,1220,-8342,-7122,-19,29999,10.923009218,0.3997109161,0.9851460964,-6.736138308,-5.750992212,700052
13083,"Dade","Georgia","US","2020-05-24 02:32:43",34.8549167,-85.50490424,27,1,0,26,"Dade, Georgia, US",16116,-111,151,183,-32,-7,-73,-80,1,985,11.316204434,-1.978789846,-0.432860279,-4.514114337,-4.946974616,4765
27037,"Dakota","Minnesota","US","2020-05-24 02:32:43",44.67172617,-93.06299363,999,33,0,966,"Dakota, Minnesota, US",429021,3981,5108,2688,2420,427,1160,1587,-26,2825,6.2946323506,5.667042518,0.9999285765,2.7164336037,3.7163621802,180320
31043,"Dakota","Nebraska","US","2020-05-24 02:32:43",42.39040144,-96.56656425,1575,15,0,1560,"Dakota, Nebraska, US",20026,24,361,129,232,0,-208,-208,0,249,6.4454881583,11.59188568,0,-10.39272509,-10.39272509,11817
1045,"Dale","Alabama","US","2020-05-24 02:32:43",31.43037123,-85.61095742,80,0,0,80,"Dale, Alabama, US",49172,29,648,546,102,18,-89,-71,-2,941,11.107155571,2.0749631287,0.3661699639,-1.810507044,-1.44433708,22581
48111,"Dallam","Texas","US","2020-05-24 02:32:43",36.27787176,-102.6020725,22,1,0,21,"Dallam, Texas, US",7287,-16,151,25,126,53,-194,-141,-1,39,3.4270047978,17.272104181,7.2652501714,-26.59355723,-19.32830706,3907
1047,"Dallas","Alabama","US","2020-05-24 02:32:43",32.32688101,-87.1086671,191,3,0,188,"Dallas, Alabama, US",37196,-1098,438,542,-104,5,-1002,-997,3,853,14.359517817,-2.755331832,0.1324678765,-26.54656246,-26.41409458,13012
5039,"Dallas","Arkansas","US","2020-05-24 02:32:43",33.97042763,-92.65167437,1,0,0,1,"Dallas, Arkansas, US",7009,-143,73,79,-6,-2,-133,-135,-2,401,11.157404138,-0.847397783,-0.282465928,-18.78398418,-19.06645011,3278
19049,"Dallas","Iowa","US","2020-05-24 02:32:43",41.68560356,-94.04127625,836,14,0,822,"Dallas, Iowa, US",93453,3500,1299,507,792,115,2577,2692,16,682,5.5287177083,8.636576775,1.2540483954,28.101588825,29.35563722,29971
29059,"Dallas","Missouri","US","2020-05-24 02:32:43",37.6811355,-93.02127031,3,0,0,3,"Dallas, Missouri, US",16878,96,213,207,6,-1,94,93,-3,199,12.299465241,0.3565062389,-0.059417706,5.5852644088,5.5258467023,2654
48113,"Dallas","Texas","US","2020-05-24 02:32:43",32.76670599,-96.7779605,8649,210,0,8439,"Dallas, Texas, US",2635516,6166,38374,17047,21327,9242,-24389,-15147,-14,31478,6.4757583574,8.1016306968,3.5108205983,-9.264813198,-5.753992599,1492757
55025,"Dane","Wisconsin","US","2020-05-24 02:32:43",43.06601594,-89.41733797,594,26,0,568,"Dane, Wisconsin, US",546695,4747,5772,3375,2397,962,1388,2350,0,13097,6.2003797388,4.4036474767,1.7673378693,2.5499635785,4.3173014478,318678
51590,"Danville","Virginia","US","2020-05-24 02:32:43",36.58022376,-79.40395668,46,2,0,44,"Danville, Virginia, US",40044,-605,443,658,-215,21,-410,-389,-1,1578,16.308725664,-5.328838933,0.5204912446,-10.16197192,-9.641480674,25177
37055,"Dare","North Carolina","US","2020-05-24 02:32:43",35.66520691,-75.71767334,22,3,0,19,"Dare, North Carolina, US",37009,402,332,360,-28,40,390,430,0,150,9.7804825038,-0.760704195,1.0867202782,10.595522712,11.682242991,20355
39037,"Darke","Ohio","US","2020-05-24 02:32:43",40.13412966,-84.6194517,147,16,0,131,"Darke, Ohio, US",51113,-186,618,604,14,10,-209,-199,-1,607,11.795492716,0.2734054603,0.1952896145,-4.081552943,-3.886263329,18739
45031,"Darlington","South Carolina","US","2020-05-24 02:32:43",34.33358335,-79.96027485,244,6,0,238,"Darlington, South Carolina, US",66618,-141,737,840,-103,21,-55,-34,-4,1451,12.595874851,-1.544494178,0.3148968713,-0.824729901,-0.50983303,21564
42043,"Dauphin","Pennsylvania","US","2020-05-24 02:32:43",40.41377078,-76.77993242,1061,62,0,999,"Dauphin, Pennsylvania, US",278299,1435,3352,2577,775,725,-52,673,-13,6786,9.2837599047,2.791972808,2.6118455301,-0.187332369,2.424513161,180406
37057,"Davidson","North Carolina","US","2020-05-24 02:32:43",35.79115496,-80.21256572,345,11,0,334,"Davidson, North Carolina, US",167609,1251,1764,1815,-51,-18,1322,1304,-2,1579,10.86933739,-0.305419398,-0.107795082,7.9169498783,7.8091547967,45022
47037,"Davidson","Tennessee","US","2020-05-24 02:32:43",36.17007426,-86.78646056,4465,54,0,4411,"Davidson, Tennessee, US",694144,3628,9985,5565,4420,3453,-4201,-748,-44,25458,8.0380743287,6.3842387301,4.9875059581,-6.067915589,-1.080409631,435676
37059,"Davie","North Carolina","US","2020-05-24 02:32:43",35.93099927,-80.54496571,67,2,0,65,"Davie, North Carolina, US",42846,283,385,406,-21,3,303,306,-2,308,9.5071947921,-0.491751455,0.0702502078,7.0952709902,7.165521198,10707
18027,"Daviess","Indiana","US","2020-05-24 02:32:43",38.70186039,-87.07185406,81,16,0,65,"Daviess, Indiana, US",33351,73,539,327,212,21,-163,-142,3,581,9.8155457834,6.3635954314,0.6303561512,-4.892764412,-4.262408261,12488
21059,"Daviess","Kentucky","US","2020-05-24 02:32:43",37.73028906,-87.0901948,305,6,0,299,"Daviess, Kentucky, US",101511,628,1302,1044,258,42,332,374,-4,2731,10.316511359,2.5494826922,0.4150320662,3.2807296659,3.6957617321,45057
29061,"Daviess","Missouri","US","2020-05-24 02:32:43",39.96145298,-93.98519678,4,0,0,4,"Daviess, Missouri, US",8278,-56,117,80,37,0,-92,-92,-1,152,9.6315916205,4.4546111245,0,-11.07633036,-11.07633036,2066
19051,"Davis","Iowa","US","2020-05-24 02:32:43",40.74773536,-92.41005468,18,0,0,18,"Davis, Iowa, US",9000,28,150,84,66,0,-38,-38,0,91,9.3478744714,7.3447585132,0,-4.228800356,-4.228800356,3016
49011,"Davis","Utah","US","2020-05-24 02:32:43",40.99001837,-112.1139997,407,2,0,405,"Davis, Utah, US",355481,4380,5406,1724,3682,178,532,710,-12,3023,4.8798299419,10.422003391,0.5038339499,1.5058407941,2.009674744,114070
46035,"Davison","South Dakota","US","2020-05-24 02:32:43",43.67490933,-98.14458906,9,0,0,9,"Davison, South Dakota, US",19775,-9,244,199,45,-4,-49,-53,-1,771,10.060921661,2.2750827877,-0.202229581,-2.477312369,-2.67954195,11449
31045,"Dawes","Nebraska","US","2020-05-24 02:32:43",42.71985036,-103.1313774,1,0,0,1,"Dawes, Nebraska, US",8589,-116,77,81,-4,6,-118,-112,0,1001,9.3674106627,-0.462588181,0.6938822713,-13.64635134,-12.95246906,4593
13085,"Dawson","Georgia","US","2020-05-24 02:32:43",34.44244079,-84.16964071,101,1,0,100,"Dawson, Georgia, US",26108,981,271,239,32,6,937,943,6,109,9.3295598712,1.2491460915,0.2342148922,36.576558993,36.810773885,7897
31047,"Dawson","Nebraska","US","2020-05-24 02:32:43",40.87028216,-99.8201461,816,7,0,809,"Dawson, Nebraska, US",23595,-149,404,196,208,116,-474,-358,1,295,8.2806987896,8.7876803481,4.9008217326,-20.02577156,-15.12494983,11904
48115,"Dawson","Texas","US","2020-05-24 02:32:43",32.74255572,-101.9477242,39,1,0,38,"Dawson, Texas, US",12728,123,181,127,54,10,60,70,-1,1335,10.026447716,4.2632139897,0.7894840722,4.736904433,5.5263885051,4727
46037,"Day","South Dakota","US","2020-05-24 02:32:43",45.367281,-97.60737498,12,0,0,12,"Day, South Dakota, US",5424,-83,67,84,-17,1,-66,-65,-1,139,15.369133657,-3.110419907,0.1829658769,-12.07574787,-11.892782,2418
35011,"De Baca","New Mexico","US","2020-05-24 02:32:43",34.34274529,-104.4117842,0,0,0,0,"De Baca, New Mexico, US",1748,-31,13,16,-3,1,-28,-27,-1,9,9.0728664587,-1.701162461,0.5670541537,-15.8775163,-15.31046215,549
22031,"De Soto","Louisiana","US","2020-05-24 02:32:43",32.05457447,-93.74130302,236,16,0,220,"De Soto, Louisiana, US",27463,37,318,292,26,-3,14,11,0,215,10.639654576,0.9473665033,-0.10931152,0.5101204249,0.4008089052,8649
17039,"De Witt","Illinois","US","2020-05-24 02:32:43",40.17514519,-88.90959682,4,0,0,4,"De Witt, Illinois, US",15638,-156,162,205,-43,0,-112,-112,-1,249,13.04403156,-2.736065157,0,-7.126495291,-7.126495291,6486
1049,"DeKalb","Alabama","US","2020-05-24 02:32:43",34.45946862,-85.80782906,214,3,0,211,"DeKalb, Alabama, US",71513,106,795,819,-24,44,90,134,-4,782,11.460957179,-0.335852225,0.6157290792,1.2594458438,1.875174923,23930
13089,"DeKalb","Georgia","US","2020-05-24 02:32:43",33.76944049,-84.22396017,3146,102,0,3044,"DeKalb, Georgia, US",759297,4391,10825,5028,5797,3831,-5190,-1359,-47,11879,6.6411174724,7.6568333308,5.0600877161,-6.855091424,-1.795003708,303932
17037,"DeKalb","Illinois","US","2020-05-24 02:32:43",41.89373302,-88.76958483,309,3,0,306,"DeKalb, Illinois, US",104897,548,1107,729,378,198,-26,172,-2,5646,6.9678751326,3.612972291,1.8925092953,-0.248511322,1.6439979737,41270
18033,"DeKalb","Indiana","US","2020-05-24 02:32:43",41.39804622,-84.99906934,28,1,0,27,"DeKalb, Indiana, US",43475,267,508,406,102,-9,176,167,-2,615,9.3674653623,2.353402628,-0.207653173,4.060773162,3.8531199889,20696
29063,"DeKalb","Missouri","US","2020-05-24 02:32:43",39.89201062,-94.40476508,5,0,0,5,"DeKalb, Missouri, US",12547,32,98,114,-16,-5,54,49,-1,3457,9.0974383529,-1.276833453,-0.399010454,4.309312904,3.9103024499,4009
47041,"DeKalb","Tennessee","US","2020-05-24 02:32:43",35.97616272,-85.83689361,33,0,0,33,"DeKalb, Tennessee, US",20490,357,219,226,-7,54,310,364,0,290,11.126701622,-0.344632351,2.658592423,15.262289836,17.920882259,6191
12027,"DeSoto","Florida","US","2020-05-24 02:32:43",27.18677893,-81.80941373,112,8,0,104,"DeSoto, Florida, US",38001,633,389,362,27,154,450,604,2,3588,9.6060714617,0.7164749433,4.0865607876,11.941249055,16.027809842,12272
28033,"DeSoto","Mississippi","US","2020-05-24 02:32:43",34.87625235,-89.99091418,458,6,0,452,"DeSoto, Mississippi, US",184945,3013,2121,1427,694,66,2257,2323,-4,628,7.7791739466,3.783284316,0.3597936093,12.303851154,12.663644764,53721
48123,"DeWitt","Texas","US","2020-05-24 02:32:43",29.08101855,-97.3568117,17,1,0,16,"DeWitt, Texas, US",20160,54,229,232,-3,-2,59,57,0,1829,11.523369592,-0.14900909,-0.099339393,2.9305120946,2.8311727015,8667
48117,"Deaf Smith","Texas","US","2020-05-24 02:32:43",34.96522957,-102.6054267,141,7,0,134,"Deaf Smith, Texas, US",18546,-165,320,159,161,-2,-325,-327,1,355,8.535308801,8.6426711759,-0.107362375,-17.44638591,-17.55374829,8515
18029,"Dearborn","Indiana","US","2020-05-24 02:32:43",39.14647946,-84.97333539,162,21,0,141,"Dearborn, Indiana, US",49458,-24,457,457,0,-15,-6,-21,-3,530,9.2379219729,0,-0.303214069,-0.121285628,-0.424499697,15428
13087,"Decatur","Georgia","US","2020-05-24 02:32:43",30.87967778,-84.57619536,145,4,0,141,"Decatur, Georgia, US",26404,-169,361,331,30,-4,-194,-198,-1,1053,12.495988825,1.132566963,-0.151008928,-7.323933028,-7.474941956,9154
18031,"Decatur","Indiana","US","2020-05-24 02:32:43",39.30712658,-85.50087166,221,31,0,190,"Decatur, Indiana, US",26559,-166,320,273,47,17,-232,-215,2,377,10.246978455,1.7641318219,0.6380902335,-8.708054951,-8.069964717,14658
19053,"Decatur","Iowa","US","2020-05-24 02:32:43",40.73742757,-93.78645949,1,0,0,1,"Decatur, Iowa, US",7870,-20,98,79,19,3,-42,-39,0,695,10.025380711,2.4111675127,0.3807106599,-5.329949239,-4.949238579,3084
47039,"Decatur","Tennessee","US","2020-05-24 02:32:43",35.60048904,-88.11043779,5,0,0,5,"Decatur, Tennessee, US",11663,-36,108,159,-51,7,7,14,1,216,13.611848301,-4.366064549,0.5992637617,0.5992637617,1.1985275233,3293
30023,"Deer Lodge","Montana","US","2020-05-24 02:32:43",46.05953325,-113.073353,3,0,0,3,"Deer Lodge, Montana, US",9140,11,69,120,-51,-3,65,62,0,853,13.137008046,-5.58322842,-0.328425201,7.1158793585,6.7874541573,3680
39039,"Defiance","Ohio","US","2020-05-24 02:32:43",41.32398837,-84.49076944,32,2,0,30,"Defiance, Ohio, US",38087,-2,427,390,37,9,-46,-37,-2,736,10.239445495,0.9714345726,0.236294896,-1.207729469,-0.971434573,16536
6015,"Del Norte","California","US","2020-05-24 02:32:43",41.74228275,-123.8974063,23,0,0,23,"Del Norte, California, US",27812,72,261,255,6,15,53,68,-2,3046,9.1805875576,0.2160138249,0.5400345622,1.9081221198,2.448156682,8634
18035,"Delaware","Indiana","US","2020-05-24 02:32:43",40.22787247,-85.39732772,340,27,0,313,"Delaware, Indiana, US",114135,-162,1081,1187,-106,180,-233,-53,-3,8600,10.39258948,-0.92806612,1.5759613364,-2.039994397,-0.46403306,52592
19055,"Delaware","Iowa","US","2020-05-24 02:32:43",42.47104597,-91.3664492,14,0,0,14,"Delaware, Iowa, US",17011,-70,196,174,22,5,-98,-93,1,215,10.207673354,1.2906253667,0.293323947,-5.749149361,-5.455825414,7423
36025,"Delaware","New York","US","2020-05-24 02:32:43",42.19837623,-74.96709306,74,4,0,70,"Delaware, New York, US",44135,-391,345,571,-226,19,-182,-163,-2,2268,12.880522439,-5.098070177,0.4285988202,-4.105525541,-3.676926721,19200
39041,"Delaware","Ohio","US","2020-05-24 02:32:43",40.27942393,-83.00457058,292,11,0,281,"Delaware, Ohio, US",209177,4086,2099,1237,862,212,3013,3225,-1,2078,5.9719794915,4.1615572528,1.023492039,14.546139214,15.569631253,75734
40041,"Delaware","Oklahoma","US","2020-05-24 02:32:43",36.40823634,-94.80325046,99,16,0,83,"Delaware, Oklahoma, US",43009,195,425,608,-183,8,370,378,0,356,14.168696037,-4.264591077,0.186430211,8.6223972595,8.8088274705,11711
42045,"Delaware","Pennsylvania","US","2020-05-24 02:32:43",39.91680171,-75.40243663,6114,513,0,5601,"Delaware, Pennsylvania, US",566747,1516,6516,5504,1012,1252,-731,521,-17,22626,9.7245706189,1.7880206152,2.2120571248,-1.291544535,0.9205125895,214001
8029,"Delta","Colorado","US","2020-05-24 02:32:43",38.86246243,-107.8631342,65,1,0,64,"Delta, Colorado, US",31162,278,283,394,-111,2,385,387,2,714,12.70025465,-3.577990523,0.0644682977,12.41014731,12.474615608,9848
26041,"Delta","Michigan","US","2020-05-24 02:32:43",45.9048491,-86.9080745,17,2,0,15,"Delta, Michigan, US",35784,-59,342,434,-92,-3,39,36,-3,633,12.118335265,-2.568863697,-0.083767294,1.0889748279,1.0052075335,14689
48119,"Delta","Texas","US","2020-05-24 02:32:43",33.38570922,-95.66921122,1,0,0,1,"Delta, Texas, US",5331,-1,65,61,4,0,-5,-5,0,54,11.441432993,0.7502579012,0,-0.937822376,-0.937822376,855
48121,"Denton","Texas","US","2020-05-24 02:32:43",33.20521901,-97.11691153,1205,28,0,1177,"Denton, Texas, US",887207,28466,9893,4243,5650,1663,21053,22716,100,11309,4.8603967587,6.4721286086,1.904982279,24.116411256,26.021393535,245571
8031,"Denver","Colorado","US","2020-05-24 02:32:43",39.76018276,-104.8725695,5151,299,0,4852,"Denver, Colorado, US",727211,10946,9372,4995,4377,2242,4268,6510,59,16348,6.9207939723,6.0645275709,3.1063904076,5.913503238,9.0198936456,491015
19057,"Des Moines","Iowa","US","2020-05-24 02:32:43",40.92012606,-91.18326592,56,1,0,55,"Des Moines, Iowa, US",38967,-182,437,434,3,-12,-173,-185,0,628,11.111680066,0.0768088484,-0.307235394,-4.429310257,-4.73654565,21831
41017,"Deschutes","Oregon","US","2020-05-24 02:32:43",43.91570171,-121.2289121,117,0,0,117,"Deschutes, Oregon, US",197692,5787,1857,1548,309,-52,5498,5446,32,1383,7.9466731007,1.5862545143,-0.266942507,28.224036633,27.957094125,72860
5041,"Desha","Arkansas","US","2020-05-24 02:32:43",33.83011025,-91.25500948,19,0,0,19,"Desha, Arkansas, US",11361,-146,135,172,-37,-1,-108,-109,0,56,15.042854644,-3.235962918,-0.087458457,-9.445513381,-9.532971838,4933
46039,"Deuel","South Dakota","US","2020-05-24 02:32:43",44.75994309,-96.66943645,1,0,0,1,"Deuel, South Dakota, US",4351,-1,56,44,12,2,-15,-13,0,50,10.11145582,2.757669769,0.4596116282,-3.447087211,-2.987475583,2017
40043,"Dewey","Oklahoma","US","2020-05-24 02:32:43",35.98772922,-99.00730714,3,0,0,3,"Dewey, Oklahoma, US",4891,-40,59,65,-6,8,-41,-33,-1,93,13.235593565,-1.221747098,1.6289961311,-8.348605172,-6.719609041,1876
46041,"Dewey","South Dakota","US","2020-05-24 02:32:43",45.15639647,-100.8709139,0,0,0,0,"Dewey, South Dakota, US",5892,-33,137,71,66,-1,-99,-100,1,19,12.016586274,11.170347804,-0.169247694,-16.75552171,-16.9247694,2146
48125,"Dickens","Texas","US","2020-05-24 02:32:43",33.61616822,-100.7788855,1,0,0,1,"Dickens, Texas, US",2211,-7,16,20,-4,0,-4,-4,1,315,9.0313840596,-1.806276812,0,-1.806276812,-1.806276812,847
51051,"Dickenson","Virginia","US","2020-05-24 02:32:43",37.12560977,-82.35124171,0,0,0,0,"Dickenson, Virginia, US",14318,-208,123,205,-82,0,-126,-126,0,511,14.214394675,-5.68575787,0,-8.736652337,-8.736652337,3796
19059,"Dickinson","Iowa","US","2020-05-24 02:32:43",43.37787725,-95.1510206,8,0,0,8,"Dickinson, Iowa, US",17258,137,147,178,-31,5,163,168,0,185,10.355158672,-1.80342651,0.2908752436,9.4825329416,9.7734081852,9162
20041,"Dickinson","Kansas","US","2020-05-24 02:32:43",38.86600962,-97.15532383,4,0,0,4,"Dickinson, Kansas, US",18466,-216,198,199,-1,2,-217,-215,0,307,10.713901152,-0.053838699,0.1076773985,-11.68299774,-11.57532034,7430
26043,"Dickinson","Michigan","US","2020-05-24 02:32:43",46.00999672,-87.86961634,5,2,0,3,"Dickinson, Michigan, US",25239,-132,238,305,-67,0,-64,-64,-1,438,12.052953962,-2.647698083,0,-2.529144438,-2.529144438,12886
47043,"Dickson","Tennessee","US","2020-05-24 02:32:43",36.14669837,-87.35891709,101,0,0,101,"Dickson, Tennessee, US",53948,502,630,526,104,-10,407,397,1,720,9.7957055329,1.9367934894,-0.186230143,7.5795668287,7.3933366855,16719
45033,"Dillon","South Carolina","US","2020-05-24 02:32:43",34.39007791,-79.37741872,147,3,0,144,"Dillon, South Carolina, US",30479,-133,413,372,41,42,-215,-173,-1,474,12.178553306,1.3422599074,1.3749979539,-7.038680002,-5.663682048,9712
48127,"Dimmit","Texas","US","2020-05-24 02:32:43",28.42270064,-99.75645095,1,0,0,1,"Dimmit, Texas, US",10124,-71,124,85,39,-2,-108,-110,0,92,8.3665534721,3.8387715931,-0.196860082,-10.63044441,-10.82730449,8809
51053,"Dinwiddie","Virginia","US","2020-05-24 02:32:43",37.07544585,-77.63451754,48,0,0,48,"Dinwiddie, Virginia, US",28544,-89,192,277,-85,4,-7,-3,-1,864,9.6892106966,-2.973223499,0.1399164,-0.2448537,-0.1049373,7314
11001,"District of Columbia","District of Columbia","US","2020-05-24 02:32:43",38.90417773,-77.01655992,7966,427,0,7539,"District of Columbia, District of Columbia, US",705749,4202,9493,5677,3816,2604,-2203,401,-15,38858,8.0679544318,5.4231661285,3.7007139934,-3.130826777,0.5698872163,817204
38023,"Divide","North Dakota","US","2020-05-24 02:32:43",48.8149387,-103.4873611,1,0,0,1,"Divide, North Dakota, US",2264,0,23,22,1,8,-10,-2,1,66,9.7173144876,0.4416961131,3.5335689046,-4.416961131,-0.883392226,1490
12029,"Dixie","Florida","US","2020-05-24 02:32:43",29.60631086,-83.15724673,38,1,0,37,"Dixie, Florida, US",16826,141,141,228,-87,-3,232,229,-1,1761,13.607472173,-5.192324908,-0.179045686,13.846199755,13.667154069,3947
31051,"Dixon","Nebraska","US","2020-05-24 02:32:43",42.49188363,-96.86782408,24,0,0,24,"Dixon, Nebraska, US",5636,-64,76,55,21,8,-93,-85,0,73,9.7035991531,3.7050105857,1.4114326041,-16.40790402,-14.99647142,1779
13091,"Dodge","Georgia","US","2020-05-24 02:32:43",32.17265114,-83.16948926,48,2,0,46,"Dodge, Georgia, US",20605,-188,215,240,-25,5,-166,-161,-2,1817,11.594763032,-1.207787816,0.2415575632,-8.019711097,-7.778153534,5829
27039,"Dodge","Minnesota","US","2020-05-24 02:32:43",44.02238415,-92.86244324,43,0,0,43,"Dodge, Minnesota, US",20934,167,242,146,96,6,66,72,-1,149,7.0022301623,4.6042061341,0.2877628834,3.1653917172,3.4531546006,6482
31053,"Dodge","Nebraska","US","2020-05-24 02:32:43",41.58071748,-96.65598179,351,1,0,350,"Dodge, Nebraska, US",36565,-160,454,400,54,61,-275,-214,0,1123,10.915541002,1.4735980352,1.6646200027,-7.504434439,-5.839814436,17329
55027,"Dodge","Wisconsin","US","2020-05-24 02:32:43",43.41576662,-88.70928178,149,1,0,148,"Dodge, Wisconsin, US",87839,6,771,874,-103,22,90,112,-3,6277,9.9503620383,-1.17263992,0.250466779,1.0246368232,1.2751036022,35978
35013,"Dona Ana","New Mexico","US","2020-05-24 02:32:43",32.35275771,-106.8329387,370,2,0,368,"Dona Ana, New Mexico, US",218195,917,2630,1615,1015,128,-224,-96,-2,4384,7.4172221929,4.6615978488,0.5878665267,-1.028766422,-0.440899895,82181
20043,"Doniphan","Kansas","US","2020-05-24 02:32:43",39.79067154,-95.14056866,12,0,0,12,"Doniphan, Kansas, US",7600,-58,69,71,-2,1,-57,-56,0,427,9.3065932626,-0.262157557,0.1310787783,-7.471490366,-7.340411587,2823
48129,"Donley","Texas","US","2020-05-24 02:32:43",34.96517499,-100.8140093,26,0,0,26,"Donley, Texas, US",3278,-37,33,39,-6,2,-34,-32,1,229,11.830729562,-1.82011224,0.6067040801,-10.31396936,-9.707265281,1187
13093,"Dooly","Georgia","US","2020-05-24 02:32:43",32.15630737,-83.79746561,165,12,0,153,"Dooly, Georgia, US",13390,-319,88,118,-30,-2,-287,-289,0,1879,8.7088084431,-2.214103841,-0.147606923,-21.18159342,-21.32920034,4004
55029,"Door","Wisconsin","US","2020-05-24 02:32:43",44.95856458,-87.30002707,37,3,0,34,"Door, Wisconsin, US",27668,79,214,363,-149,0,231,231,-3,348,13.138606873,-5.392981885,0,8.3609316467,8.3609316467,12346
24019,"Dorchester","Maryland","US","2020-05-24 02:32:43",38.45413522,-76.02752426,126,2,0,124,"Dorchester, Maryland, US",31929,-31,340,395,-55,8,19,27,-3,499,12.365195887,-1.721736136,0.2504343471,0.5947815743,0.8452159214,13082
45035,"Dorchester","South Carolina","US","2020-05-24 02:32:43",33.0794369,-80.40502652,137,3,0,134,"Dorchester, South Carolina, US",162809,2091,1813,1250,563,80,1448,1528,0,1719,7.727330331,3.4803895811,0.4945491412,8.9513394554,9.4458885966,38552
13095,"Dougherty","Georgia","US","2020-05-24 02:32:43",31.53328528,-84.21722377,1725,139,0,1586,"Dougherty, Georgia, US",87956,-1244,1255,951,304,48,-1601,-1553,5,4499,10.73630021,3.432003432,0.5418952787,-18.07446544,-17.53257016,46843
8035,"Douglas","Colorado","US","2020-05-24 02:32:43",39.33133796,-104.930001,675,44,0,631,"Douglas, Colorado, US",351154,8165,3472,1493,1979,562,5604,6166,20,651,4.3017072851,5.701995122,1.6192628896,16.146528885,17.765791775,115915
13097,"Douglas","Georgia","US","2020-05-24 02:32:43",33.70291126,-84.77026156,487,22,0,465,"Douglas, Georgia, US",146343,1319,1720,1047,673,38,615,653,-7,1255,7.1868125079,4.6196034554,0.2608394224,4.2214801264,4.4823195489,43879
17041,"Douglas","Illinois","US","2020-05-24 02:32:43",39.76768052,-88.21854195,27,0,0,27,"Douglas, Illinois, US",19465,7,246,175,71,-3,-61,-64,0,168,8.9921126326,3.6482285538,-0.154150502,-3.134393546,-3.288544049,8139
20045,"Douglas","Kansas","US","2020-05-24 02:32:43",38.88503636,-95.2925121,63,0,0,63,"Douglas, Kansas, US",122259,1150,1107,687,420,387,342,729,1,8806,5.6457710134,3.451563065,3.1803688242,2.8105584958,5.9909273199,53712
27041,"Douglas","Minnesota","US","2020-05-24 02:32:43",45.93348491,-95.45335469,27,0,0,27,"Douglas, Minnesota, US",38141,181,424,430,-6,2,187,189,-2,522,11.300771343,-0.157685182,0.0525617272,4.9145214912,4.9670832184,20219
31055,"Douglas","Nebraska","US","2020-05-24 02:32:43",41.29518299,-96.15085305,3024,23,0,3001,"Douglas, Nebraska, US",571327,4936,8236,3996,4240,1396,-677,719,-23,12463,7.0245878153,7.4535166008,2.4540351827,-1.190101589,1.2639335934,326018
32005,"Douglas","Nevada","US","2020-05-24 02:32:43",38.912862,-119.6171333,26,0,0,26,"Douglas, Nevada, US",48905,416,287,549,-262,-16,691,675,3,230,11.2737951,-5.380208226,-0.328562334,14.189785818,13.861223484,18909
41019,"Douglas","Oregon","US","2020-05-24 02:32:43",43.27941273,-123.167291,25,0,0,25,"Douglas, Oregon, US",110980,866,1065,1473,-408,-35,1309,1274,0,1816,13.324649244,-3.690737876,-0.316607416,11.841117353,11.524509937,37688
46043,"Douglas","South Dakota","US","2020-05-24 02:32:43",43.38520741,-98.36978007,1,0,0,1,"Douglas, South Dakota, US",2921,-5,41,32,9,3,-18,-15,1,178,10.945784163,3.0785017958,1.0261672653,-6.157003592,-5.130836326,1443
53017,"Douglas","Washington","US","2020-05-24 02:32:43",47.7361335,-119.692937,139,3,0,136,"Douglas, Washington, US",43429,680,542,325,217,41,423,464,-1,190,7.5425282555,5.0360880967,0.9515189492,9.8168906217,10.768409571,11587
55031,"Douglas","Wisconsin","US","2020-05-24 02:32:43",46.43222285,-91.91595768,17,0,0,17,"Douglas, Wisconsin, US",43150,7,397,430,-33,-13,53,40,0,1351,9.9660459133,-0.764836082,-0.301299062,1.2283731009,0.9270740385,17767
5043,"Drew","Arkansas","US","2020-05-24 02:32:43",33.59035001,-91.71777921,19,1,0,18,"Drew, Arkansas, US",18219,-109,228,198,30,-5,-134,-139,0,895,10.835362684,1.6417216187,-0.27362027,-7.33302323,-7.6066435,6373
17043,"DuPage","Illinois","US","2020-05-24 02:32:43",41.85116968,-88.08642662,6891,339,0,6552,"DuPage, Illinois, US",922921,-4326,10158,6595,3563,2050,-10009,-7959,70,12828,7.129082332,3.8515421302,2.2160149781,-10.81955801,-8.60354303,570152
18037,"Dubois","Indiana","US","2020-05-24 02:32:43",38.36597551,-86.8792417,171,2,0,169,"Dubois, Indiana, US",42736,62,559,409,150,101,-188,-87,-1,894,9.577332865,3.5124692659,2.365062639,-4.402294813,-2.037232174,26978
19061,"Dubuque","Iowa","US","2020-05-24 02:32:43",42.46815349,-90.88181925,317,16,0,301,"Dubuque, Iowa, US",97311,389,1136,907,229,60,106,166,-6,4258,9.3392986774,2.3579927201,0.6178146865,1.0914726128,1.7092872993,57751
29069,"Dunklin","Missouri","US","2020-05-24 02:32:43",36.27167174,-90.09122243,28,2,0,26,"Dunklin, Missouri, US",29131,-347,357,447,-90,29,-287,-258,1,672,15.253629989,-3.071200669,0.9896091044,-9.793717688,-8.804108584,10043
38025,"Dunn","North Dakota","US","2020-05-24 02:32:43",47.35423935,-102.6160468,12,0,0,12,"Dunn, North Dakota, US",4424,96,67,17,50,9,37,46,0,132,3.8848263254,11.425959781,2.0566727605,8.4552102377,10.511882998,2761
55033,"Dunn","Wisconsin","US","2020-05-24 02:32:43",44.94562799,-91.8962481,21,0,0,21,"Dunn, Wisconsin, US",45368,277,430,320,110,16,155,171,-4,3202,7.0750284659,2.4320410352,0.3537514233,3.4269669132,3.7807183365,18654
37061,"Duplin","North Carolina","US","2020-05-24 02:32:43",34.93449805,-77.93140529,597,13,0,584,"Duplin, North Carolina, US",58741,-250,664,593,71,121,-442,-321,0,361,10.073726769,1.2061291747,2.0555159175,-7.508578806,-5.453062889,20917
37063,"Durham","North Carolina","US","2020-05-24 02:32:43",36.03638492,-78.87608331,1230,44,0,1186,"Durham, North Carolina, US",321488,4509,4186,2235,1951,1376,1176,2552,6,14191,7.00114493,6.1115139858,4.3103245743,3.6838239095,7.9941484838,197066
36027,"Dutchess","New York","US","2020-05-24 02:32:43",41.7648606,-73.74356679,3793,133,0,3660,"Dutchess, New York, US",294218,279,2584,2765,-181,232,247,479,-19,19566,9.4022514397,-0.615481921,0.7889050033,0.8399117923,1.6288167955,118678
12031,"Duval","Florida","US","2020-05-24 02:32:43",30.33225875,-81.66976468,1406,41,0,1365,"Duval, Florida, US",957755,9103,13013,8855,4158,2008,2933,4941,4,20537,9.2897266953,4.3621325352,2.106580599,3.0769924785,5.1835730775,490041
48131,"Duval","Texas","US","2020-05-24 02:32:43",27.68184592,-98.50864568,5,0,0,5,"Duval, Texas, US",11157,10,142,124,18,-1,-8,-9,1,584,11.119081779,1.6140602582,-0.089670014,-0.717360115,-0.807030129,3928
47045,"Dyer","Tennessee","US","2020-05-24 02:32:43",36.05931946,-89.41542855,48,0,0,48,"Dyer, Tennessee, US",37159,-127,445,458,-13,-1,-112,-113,-1,548,12.304385788,-0.349251125,-0.026865471,-3.008932769,-3.03579824,16082
8037,"Eagle","Colorado","US","2020-05-24 02:32:43",39.62754308,-106.6933637,580,8,0,572,"Eagle, Colorado, US",55127,184,559,129,430,118,-364,-246,0,55,2.3439629327,7.8132097756,2.1440901245,-6.613972926,-4.469882802,29722
13099,"Early","Georgia","US","2020-05-24 02:32:43",31.32155345,-84.90255207,236,29,0,207,"Early, Georgia, US",10190,-96,128,142,-14,4,-86,-82,0,137,13.869896464,-1.367454581,0.3907013088,-8.40007814,-8.009376831,3641
22033,"East Baton Rouge","Louisiana","US","2020-05-24 02:32:43",30.53842039,-91.09777565,3370,225,0,3145,"East Baton Rouge, Louisiana, US",440059,-1999,5739,3902,1837,640,-4499,-3859,23,11121,8.8468989941,4.1649803824,1.4510546787,-10.20046094,-8.749406258,266852
22035,"East Carroll","Louisiana","US","2020-05-24 02:32:43",32.73926954,-91.23425694,62,0,0,62,"East Carroll, Louisiana, US",6861,-133,82,66,16,-3,-146,-149,0,1067,9.5272464814,2.3096355106,-0.433056658,-21.07542403,-21.50848069,1884
22037,"East Feliciana","Louisiana","US","2020-05-24 02:32:43",30.84425359,-91.04976723,184,27,0,157,"East Feliciana, Louisiana, US",19135,-151,196,233,-37,1,-114,-113,-1,2420,12.128783738,-1.926030036,0.0520548658,-5.934254704,-5.882199839,4578
48133,"Eastland","Texas","US","2020-05-24 02:32:43",32.32743996,-98.83243566,5,0,0,5,"Eastland, Texas, US",18360,41,187,245,-58,0,99,99,0,873,13.359142834,-3.162572589,0,5.3981842471,5.3981842471,6614
26045,"Eaton","Michigan","US","2020-05-24 02:32:43",42.59599185,-84.83740035,175,6,0,169,"Eaton, Michigan, US",110268,558,1065,1003,62,103,405,508,-12,1711,9.1190937276,0.5636927329,0.9364572821,3.6821864005,4.6186436826,46753
55035,"Eau Claire","Wisconsin","US","2020-05-24 02:32:43",44.726614,-91.28609183,93,0,0,93,"Eau Claire, Wisconsin, US",104646,291,1154,756,398,96,-199,-103,-4,4446,7.2344151463,3.8085942173,0.9186558916,-1.904297109,-0.985641217,60179
13101,"Echols","Georgia","US","2020-05-24 02:32:43",30.71101099,-82.89687287,61,0,0,61,"Echols, Georgia, US",4006,6,26,12,14,7,-14,-7,-1,0,2.9977516862,3.4973769673,1.7486884836,-3.497376967,-1.748688484,361
48135,"Ector","Texas","US","2020-05-24 02:32:43",31.86898877,-102.5429428,130,4,0,126,"Ector, Texas, US",166223,4263,2915,1228,1687,238,2324,2562,14,2425,7.4836295603,10.280849404,1.4504102894,14.162829885,15.613240174,69424
35015,"Eddy","New Mexico","US","2020-05-24 02:32:43",32.47167456,-104.3053527,17,1,0,16,"Eddy, New Mexico, US",58460,731,805,550,255,47,428,475,1,1000,9.4673333964,4.3894000293,0.8090266721,7.3673067158,8.1763333878,29055
38027,"Eddy","North Dakota","US","2020-05-24 02:32:43",47.71701474,-98.90432337,7,0,0,7,"Eddy, North Dakota, US",2287,-22,33,37,-4,0,-18,-18,0,76,16.100957354,-1.740644038,0,-7.832898172,-7.832898172,965
17045,"Edgar","Illinois","US","2020-05-24 02:32:43",39.6809186,-87.74759563,0,0,0,0,"Edgar, Illinois, US",17161,-199,170,227,-57,5,-147,-142,0,283,13.151415081,-3.302337707,0.2896787463,-8.51655514,-8.226876394,7567
37065,"Edgecombe","North Carolina","US","2020-05-24 02:32:43",35.91230639,-77.59436892,184,9,0,175,"Edgecombe, North Carolina, US",51472,-512,589,634,-45,16,-484,-468,1,918,12.256418187,-0.869935045,0.3093102382,-9.356634705,-9.047324466,17620
45037,"Edgefield","South Carolina","US","2020-05-24 02:32:43",33.77221995,-81.96231108,48,2,0,46,"Edgefield, South Carolina, US",27260,128,192,301,-109,3,236,239,-2,2792,11.067804089,-4.007942344,0.1103103398,8.6777467275,8.7880570672,6943
21061,"Edmonson","Kentucky","US","2020-05-24 02:32:43",37.21218923,-86.23955613,54,9,0,45,"Edmonson, Kentucky, US",12150,-99,112,146,-34,-5,-59,-64,-1,353,11.967703594,-2.786999467,-0.409852863,-4.836263781,-5.246116644,1838
17047,"Edwards","Illinois","US","2020-05-24 02:32:43",38.41353228,-88.05720863,2,0,0,2,"Edwards, Illinois, US",6395,8,74,59,15,0,-7,-7,0,52,9.2317321233,2.3470505398,0,-1.095290252,-1.095290252,2796
20047,"Edwards","Kansas","US","2020-05-24 02:32:43",37.88735543,-99.31263309,5,0,0,5,"Edwards, Kansas, US",2798,-22,25,21,4,2,-28,-26,0,35,7.4759700961,1.423994304,0.711997152,-9.967960128,-9.255962976,1154
13103,"Effingham","Georgia","US","2020-05-24 02:32:43",32.36616021,-81.34280942,63,1,0,62,"Effingham, Georgia, US",64296,2068,795,478,317,30,1719,1749,2,607,7.5558787266,5.0109070216,0.4742183301,27.172710316,27.646928646,11245
17049,"Effingham","Illinois","US","2020-05-24 02:32:43",39.05935711,-88.58969584,6,1,0,5,"Effingham, Illinois, US",34008,-173,469,375,94,6,-273,-267,0,440,10.998841455,2.7570429248,0.1759814633,-8.00715658,-7.831175116,21312
6017,"El Dorado","California","US","2020-05-24 02:32:43",38.77965956,-120.5233166,74,0,0,74,"El Dorado, California, US",192843,2097,1624,1699,-75,75,2110,2185,-13,1682,8.858439632,-0.391043539,0.3910435388,11.001358225,11.392401763,56007
8041,"El Paso","Colorado","US","2020-05-24 02:32:43",38.83240149,-104.5251411,1493,88,0,1405,"El Paso, Colorado, US",720403,8314,9512,4845,4667,526,3099,3625,22,19083,6.7644356827,6.5159177154,0.734384555,4.3267257339,5.0611102889,312224
48141,"El Paso","Texas","US","2020-05-24 02:32:43",31.76980765,-106.2363275,2265,57,0,2208,"El Paso, Texas, US",839238,2413,11617,5552,6065,167,-3818,-3651,-1,17215,6.6250492971,7.2371981244,0.1992765188,-4.555914664,-4.356638145,337026
8039,"Elbert","Colorado","US","2020-05-24 02:32:43",39.28656773,-104.1358721,48,2,0,46,"Elbert, Colorado, US",26729,426,196,148,48,34,345,379,-1,73,5.5815356766,1.810227787,1.2822446825,13.011012219,14.293256901,5477
13105,"Elbert","Georgia","US","2020-05-24 02:32:43",34.11302332,-82.83936148,71,0,0,71,"Elbert, Georgia, US",19194,99,206,266,-60,-2,163,161,-2,275,13.894329964,-3.13405939,-0.104468646,8.5141946773,8.409726031,6638
20049,"Elk","Kansas","US","2020-05-24 02:32:43",37.45338105,-96.24369667,0,0,0,0,"Elk, Kansas, US",2530,46,23,33,-10,0,58,58,-2,40,13.163143199,-3.988831272,0,23.13522138,23.13522138,867
42047,"Elk","Pennsylvania","US","2020-05-24 02:32:43",41.42822061,-78.64524744,6,0,0,6,"Elk, Pennsylvania, US",29910,-200,268,359,-91,1,-109,-108,-1,355,11.962679107,-3.032322559,0.0333222259,-3.632122626,-3.5988004,14323
18039,"Elkhart","Indiana","US","2020-05-24 02:32:43",41.59761169,-85.85875695,938,27,0,911,"Elkhart, Indiana, US",206341,724,3054,1669,1385,209,-870,-661,0,3691,8.1027677579,6.7239864258,1.0146665437,-4.223731545,-3.209065002,113756
32007,"Elko","Nevada","US","2020-05-24 02:32:43",41.14531606,-115.3577619,22,1,0,21,"Elko, Nevada, US",52778,239,775,371,404,-45,-120,-165,0,792,7.0453962798,7.6720757333,-0.854562891,-2.278834376,-3.133397267,23971
21063,"Elliott","Kentucky","US","2020-05-24 02:32:43",38.11624059,-83.09771563,1,0,0,1,"Elliott, Kentucky, US",7517,18,68,70,-2,0,20,20,0,1068,9.3233883857,-0.266382525,0,2.6638252531,2.6638252531,1296
20051,"Ellis","Kansas","US","2020-05-24 02:32:43",38.91458712,-99.31751551,8,0,0,8,"Ellis, Kansas, US",28553,-93,294,248,46,44,-184,-140,1,1036,8.6714802706,1.6084197276,1.5384884351,-6.43367891,-4.895190475,16495
48139,"Ellis","Texas","US","2020-05-24 02:32:43",32.34894117,-96.79371841,266,12,0,254,"Ellis, Texas, US",184826,5820,2272,1342,930,39,4841,4880,10,1547,7.3770311572,5.1122496097,0.2143846611,26.611183183,26.825567844,50628
20053,"Ellsworth","Kansas","US","2020-05-24 02:32:43",38.69677695,-98.20462799,2,0,0,2,"Ellsworth, Kansas, US",6102,-61,54,68,-14,2,-49,-47,0,978,11.088463106,-2.282918875,0.3261312678,-7.990216062,-7.664084794,2690
1051,"Elmore","Alabama","US","2020-05-24 02:32:43",32.59785413,-86.14415284,254,7,0,247,"Elmore, Alabama, US",81209,198,932,821,111,25,67,92,-5,4147,10.122056467,1.3685118974,0.3082234003,0.8260387129,1.1342621132,18047
16039,"Elmore","Idaho","US","2020-05-24 02:32:43",43.3507101,-115.4701578,31,2,0,29,"Elmore, Idaho, US",27511,149,456,195,261,40,-153,-113,1,724,7.1073205402,9.5128751845,1.4579119057,-5.576513039,-4.118601134,11053
13107,"Emanuel","Georgia","US","2020-05-24 02:32:43",32.59221302,-82.30239915,26,2,0,24,"Emanuel, Georgia, US",22646,39,295,274,21,-2,22,20,-2,1367,12.109694385,0.9281152631,-0.08839193,0.972311228,0.8839192982,7315
19063,"Emmet","Iowa","US","2020-05-24 02:32:43",43.37782951,-94.67858943,7,0,0,7,"Emmet, Iowa, US",9208,-69,104,108,-4,5,-69,-64,-1,420,11.685150122,-0.432783338,0.5409791723,-7.465512578,-6.924533405,4278
26047,"Emmet","Michigan","US","2020-05-24 02:32:43",45.52625509,-84.89083249,21,2,0,19,"Emmet, Michigan, US",33415,190,288,310,-22,5,207,212,0,505,9.3037214886,-0.660264106,0.150060024,6.212484994,6.362545018,18715
38029,"Emmons","North Dakota","US","2020-05-24 02:32:43",46.28398398,-100.2389766,6,1,0,5,"Emmons, North Dakota, US",3241,-37,32,49,-17,3,-24,-21,1,52,15.032980518,-5.215523853,0.9203865624,-7.363092499,-6.442705936,1460
51595,"Emporia","Virginia","US","2020-05-24 02:32:43",36.69455571,-77.53406129,60,3,0,57,"Emporia, Virginia, US",5346,-17,51,72,-21,-3,9,6,-2,246,13.446633673,-3.921934821,-0.560276403,1.6808292091,1.1205528061,3061
48143,"Erath","Texas","US","2020-05-24 02:32:43",32.23602653,-98.21773417,15,1,0,14,"Erath, Texas, US",42698,475,480,335,145,-7,336,329,1,3682,7.8896857079,3.41493859,-0.164859104,7.9132370085,7.7483779042,18086
36029,"Erie","New York","US","2020-05-24 02:32:43",42.76249024,-78.73063652,5552,480,0,5072,"Erie, New York, US",918702,-1015,9756,9765,-9,1278,-2264,-986,-20,27188,10.623258354,-0.009791022,1.3903250565,-2.462985859,-1.072660803,460674
39043,"Erie","Ohio","US","2020-05-24 02:32:43",41.36796058,-82.62904521,137,4,0,133,"Erie, Ohio, US",74266,-247,778,916,-138,-6,-100,-106,-3,1679,12.313565759,-1.855100518,-0.080656544,-1.344275738,-1.424932282,34999
42049,"Erie","Pennsylvania","US","2020-05-24 02:32:43",41.99253829,-80.03301954,210,4,0,206,"Erie, Pennsylvania, US",269728,-1816,2855,2801,54,525,-2397,-1872,2,12174,10.349694793,0.199529996,1.9398749612,-8.856914823,-6.917039862,131205
1053,"Escambia","Alabama","US","2020-05-24 02:32:43",31.1256789,-87.15918694,40,3,0,37,"Escambia, Alabama, US",36633,109,420,474,-54,-1,166,165,-2,2472,12.958431866,-1.476277048,-0.027338464,4.5381849994,4.5108465355,12408
12033,"Escambia","Florida","US","2020-05-24 02:32:43",30.67652764,-87.37284571,749,26,0,723,"Escambia, Florida, US",318316,3212,3804,3536,268,204,2726,2930,14,17837,11.164787976,0.8461999937,0.6441223833,8.6072432193,9.2513656026,153405
25009,"Essex","Massachusetts","US","2020-05-24 02:32:43",42.6687626,-70.94687179,13334,848,0,12486,"Essex, Massachusetts, US",789034,851,8605,6946,1659,3236,-4047,-811,3,19195,8.8079192654,2.1037054508,4.1034302826,-5.131823966,-1.028393683,320641
34013,"Essex","New Jersey","US","2020-05-24 02:32:43",40.78681335,-74.24657979,17160,1589,0,15571,"Essex, New Jersey, US",798975,405,10165,6457,3708,3009,-6340,-3331,28,23214,8.0836533556,4.6421227571,3.7670300367,-7.937178608,-4.170148572,364441
36031,"Essex","New York","US","2020-05-24 02:32:43",44.11630765,-73.77297842,36,0,0,36,"Essex, New York, US",36885,-403,308,413,-105,4,-300,-296,-2,2081,11.136127701,-2.831218907,0.1078559584,-8.089196878,-7.981340919,17055
50009,"Essex","Vermont","US","2020-05-24 02:32:43",44.72736416,-71.73579864,3,0,0,3,"Essex, Vermont, US",6163,-71,51,59,-8,1,-64,-63,0,16,9.5184318787,-1.290634831,0.1613293539,-10.32507865,-10.16374929,1387
51057,"Essex","Virginia","US","2020-05-24 02:32:43",37.93357639,-76.94230311,41,0,0,41,"Essex, Virginia, US",10953,57,107,117,-10,5,61,66,1,190,10.709872305,-0.915373701,0.4576868507,5.583779578,6.0414664287,4352
1055,"Etowah","Alabama","US","2020-05-24 02:32:43",34.04567266,-86.04051873,228,10,0,218,"Etowah, Alabama, US",102268,-343,1175,1487,-312,37,-62,-25,-6,2085,14.515884986,-3.045700145,0.3611887992,-0.605235285,-0.244046486,36023
32011,"Eureka","Nevada","US","2020-05-24 02:32:43",39.98100864,-116.2683204,0,0,0,0,"Eureka, Nevada, US",2029,31,12,10,2,0,29,29,0,1,4.9664762851,0.993295257,0,14.402781227,14.402781227,4509
22039,"Evangeline","Louisiana","US","2020-05-24 02:32:43",30.72985248,-92.39915924,87,1,0,86,"Evangeline, Louisiana, US",33395,-101,447,391,56,60,-217,-157,0,1380,11.690660926,1.6743657592,1.7939633135,-6.488167317,-4.694204004,8167
13109,"Evans","Georgia","US","2020-05-24 02:32:43",32.15328841,-81.8870105,5,0,0,5,"Evans, Georgia, US",10654,-48,127,128,-1,0,-47,-47,0,403,11.987263532,-0.093650496,0,-4.401573328,-4.401573328,4098
2090,"Fairbanks North Star","Alaska","US","2020-05-24 02:32:43",64.80726247,-146.5692662,85,2,0,83,"Fairbanks North Star, Alaska, US",96849,-1716,1533,506,1027,16,-2763,-2747,4,4689,5.1787487079,10.511017634,0.1637548999,-28.27842427,-28.11466937,50201
51059,"Fairfax","Virginia","US","2020-05-24 02:32:43",38.83677558,-77.27565836,8945,326,0,8619,"Fairfax, Virginia, US",1147532,-931,13769,5708,8061,5146,-14214,-9068,76,10607,4.9721362634,7.0217922948,4.4825881589,-12.38156006,-7.898971905,614465
51600,"Fairfax City","Virginia","US","2020-05-24 02:32:43",38.85157547,-77.2977964,52,3,0,49,"Fairfax City, Virginia, US",24019,294,673,203,470,140,-315,-175,-1,521,8.5036863271,19.688337802,5.8646112601,-13.19537534,-7.330764075,36273
9001,"Fairfield","Connecticut","US","2020-05-24 02:32:43",41.26809896,-73.3881171,14989,1208,0,13781,"Fairfield, Connecticut, US",943332,-639,9603,6960,2643,4737,-8080,-3343,61,19524,7.3756042352,2.8008221255,5.0198616756,-8.562483078,-3.542621402,467601
39045,"Fairfield","Ohio","US","2020-05-24 02:32:43",39.75107189,-82.63088163,233,3,0,230,"Fairfield, Ohio, US",157574,1592,1728,1402,326,118,1160,1278,-12,2868,8.9425812295,2.0793733815,0.7526566227,7.3989973083,8.151653931,42131
45039,"Fairfield","South Carolina","US","2020-05-24 02:32:43",34.39287073,-81.1195624,158,9,0,149,"Fairfield, South Carolina, US",22347,-29,203,302,-99,20,50,70,0,397,13.505355186,-4.427252197,0.8943943832,2.235985958,3.1303803412,7175
46047,"Fall River","South Dakota","US","2020-05-24 02:32:43",43.23929297,-103.5275691,4,0,0,4,"Fall River, South Dakota, US",6713,-27,46,100,-54,0,26,26,1,220,14.866572512,-8.027949156,0,3.865308853,3.865308853,3164
48145,"Falls","Texas","US","2020-05-24 02:32:43",31.25350609,-96.93630086,6,0,0,6,"Falls, Texas, US",17297,66,186,166,20,-3,50,47,-1,1944,9.6153846154,1.1584800741,-0.173772011,2.8962001854,2.7224281742,3932
51610,"Falls Church","Virginia","US","2020-05-24 02:32:43",38.88485255,-77.17560759,47,5,0,42,"Falls Church, Virginia, US",14617,150,201,80,121,22,8,30,-1,42,5.5013065603,8.3207261725,1.5128593041,0.550130656,2.0629899601,10799
13111,"Fannin","Georgia","US","2020-05-24 02:32:43",34.86430205,-84.316964,39,1,0,38,"Fannin, Georgia, US",26188,207,223,349,-126,-5,337,332,1,160,13.379593245,-4.830454868,-0.191684717,12.919549924,12.727865207,7483
48147,"Fannin","Texas","US","2020-05-24 02:32:43",33.59564294,-96.10751083,29,2,0,27,"Fannin, Texas, US",35514,329,321,437,-116,41,405,446,-1,3041,12.362268207,-3.281517419,1.1598466739,11.457022023,12.616868697,9340
27043,"Faribault","Minnesota","US","2020-05-24 02:32:43",43.67381499,-93.94787458,11,0,0,11,"Faribault, Minnesota, US",13653,-83,146,158,-12,-2,-69,-71,0,336,11.53747855,-0.876264194,-0.146044032,-5.038519114,-5.184563146,6405
46049,"Faulk","South Dakota","US","2020-05-24 02:32:43",45.07082625,-99.14535601,1,0,0,1,"Faulk, South Dakota, US",2299,-16,35,20,15,0,-31,-31,0,497,8.6692674469,6.5019505852,0,-13.43736454,-13.43736454,1152
5045,"Faulkner","Arkansas","US","2020-05-24 02:32:43",35.14719007,-92.33717519,100,3,0,97,"Faulkner, Arkansas, US",126007,869,1516,920,596,41,232,273,0,4407,7.3264448824,4.7462621195,0.3265046089,1.8475382747,2.1740428836,46903
51061,"Fauquier","Virginia","US","2020-05-24 02:32:43",38.73564842,-77.80647472,269,5,0,264,"Fauquier, Virginia, US",71222,580,727,605,122,12,453,465,-7,389,8.5292956635,1.7199571421,0.1691761123,6.3863982406,6.5555743529,24316
1057,"Fayette","Alabama","US","2020-05-24 02:32:43",33.72076938,-87.73886638,11,0,0,11,"Fayette, Alabama, US",16302,-143,174,225,-51,5,-97,-92,0,291,13.741716798,-3.114789141,0.3053714844,-5.924206798,-5.618835313,4006
13113,"Fayette","Georgia","US","2020-05-24 02:32:43",33.41357794,-84.49089434,219,11,0,208,"Fayette, Georgia, US",114421,1240,875,897,-22,166,1116,1282,-20,492,7.8821802972,-0.193319918,1.4586866548,9.8065922092,11.265278864,45106
17051,"Fayette","Illinois","US","2020-05-24 02:32:43",39.00072038,-89.02452658,20,2,0,18,"Fayette, Illinois, US",21336,-32,228,218,10,-2,-40,-42,0,1651,10.209816411,0.4683402023,-0.09366804,-1.873360809,-1.96702885,7209
18041,"Fayette","Indiana","US","2020-05-24 02:32:43",39.63684962,-85.17797541,50,4,0,46,"Fayette, Indiana, US",23102,26,271,285,-14,15,27,42,-2,391,12.343540214,-0.606349344,0.6496600113,1.1693880203,1.8190480315,7126
19065,"Fayette","Iowa","US","2020-05-24 02:32:43",42.86271799,-91.8441231,26,0,0,26,"Fayette, Iowa, US",19650,-29,214,228,-14,13,-27,-14,-1,875,11.594497699,-0.711942841,0.6610897811,-1.373032622,-0.711942841,8934
21067,"Fayette","Kentucky","US","2020-05-24 02:32:43",38.0368225,-84.45576892,619,13,0,606,"Fayette, Kentucky, US",323152,726,3841,2405,1436,242,-943,-701,-9,12826,7.4506876009,4.4487265675,0.7497157586,-2.921413059,-2.171697301,184563
39047,"Fayette","Ohio","US","2020-05-24 02:32:43",39.56021306,-83.4562016,34,0,0,34,"Fayette, Ohio, US",28525,-128,330,309,21,4,-151,-147,-2,593,10.808352863,0.7345482528,0.1399139529,-5.281751723,-5.14183777,12242
42051,"Fayette","Pennsylvania","US","2020-05-24 02:32:43",39.92041012,-79.64291195,94,4,0,90,"Fayette, Pennsylvania, US",129274,-1049,1244,1820,-576,7,-476,-469,-4,4372,14.021733687,-4.437647585,0.053929745,-3.667222657,-3.613292912,39786
47047,"Fayette","Tennessee","US","2020-05-24 02:32:43",35.19615831,-89.41399032,104,2,0,102,"Fayette, Tennessee, US",41133,577,414,435,-21,23,570,593,5,465,10.650148735,-0.514145111,0.5631113124,13.955367308,14.51847862,8147
48149,"Fayette","Texas","US","2020-05-24 02:32:43",29.87788372,-96.92076062,31,2,0,29,"Fayette, Texas, US",25346,68,237,291,-54,5,118,123,-1,400,11.496523388,-2.133375474,0.1975347661,4.6618204804,4.8593552465,10526
54019,"Fayette","West Virginia","US","2020-05-24 02:32:43",38.02974928,-81.08286634,42,3,0,39,"Fayette, West Virginia, US",42406,-576,402,670,-268,5,-311,-306,-2,1816,15.693071626,-6.27722865,0.1171124748,-7.284395934,-7.167283459,11670
47049,"Fentress","Tennessee","US","2020-05-24 02:32:43",36.38128818,-84.92870012,9,0,0,9,"Fentress, Tennessee, US",18523,201,184,260,-76,-1,275,274,3,262,14.113176822,-4.125390148,-0.054281449,14.927398562,14.873117112,4620
30027,"Fergus","Montana","US","2020-05-24 02:32:43",47.26331584,-109.2245206,0,0,0,0,"Fergus, Montana, US",11050,-67,104,130,-26,10,-51,-41,0,465,11.72914693,-2.345829386,0.9022420715,-4.601434565,-3.699192493,5324
53019,"Ferry","Washington","US","2020-05-24 02:32:43",48.4711431,-118.5154041,1,0,0,1,"Ferry, Washington, US",7627,-11,64,81,-17,0,8,8,-2,251,10.612512283,-2.227317393,0,1.0481493613,1.0481493613,2140
27045,"Fillmore","Minnesota","US","2020-05-24 02:32:43",43.67394126,-92.08980382,17,1,0,16,"Fillmore, Minnesota, US",21067,23,256,237,19,16,-11,5,-1,360,11.255966375,0.9023770511,0.7598964641,-0.522428819,0.237467645,7112
31059,"Fillmore","Nebraska","US","2020-05-24 02:32:43",40.52458567,-97.59646937,5,0,0,5,"Fillmore, Nebraska, US",5462,-73,65,66,-1,0,-73,-73,1,189,12.00327362,-0.181867782,0,-13.27634809,-13.27634809,2802
20055,"Finney","Kansas","US","2020-05-24 02:32:43",38.04340344,-100.7381938,1418,6,0,1412,"Finney, Kansas, US",36467,-61,613,208,405,105,-574,-469,3,547,5.6990204809,11.096650456,2.8769093774,-15.7271046,-12.85019522,18470
48151,"Fisher","Texas","US","2020-05-24 02:32:43",32.74281316,-100.4019302,2,0,0,2,"Fisher, Texas, US",3830,9,36,45,-9,6,14,20,-2,22,11.763168213,-2.352633643,1.5684224284,3.659652333,5.2280747615,1251
12035,"Flagler","Florida","US","2020-05-24 02:32:43",29.45933576,-81.31508595,173,4,0,169,"Flagler, Florida, US",115081,2996,807,1385,-578,21,3537,3558,16,684,12.193726174,-5.088789696,0.1848868229,31.140223449,31.325110272,25393
30029,"Flathead","Montana","US","2020-05-24 02:32:43",48.29575866,-114.0520569,37,2,0,35,"Flathead, Montana, US",103806,1789,1113,917,196,-42,1629,1587,6,993,8.9105687897,1.9045490543,-0.408117654,15.829134742,15.421017087,42160
21069,"Fleming","Kentucky","US","2020-05-24 02:32:43",38.36758311,-83.69657514,2,0,0,2,"Fleming, Kentucky, US",14581,96,199,161,38,0,59,59,-1,22,11.078235739,2.6147388702,0,4.0597261405,4.0597261405,3708
45041,"Florence","South Carolina","US","2020-05-24 02:32:43",34.02361754,-79.70189312,588,31,0,557,"Florence, South Carolina, US",138293,16,1614,1558,56,107,-142,-35,-5,2926,11.266587121,0.4049607694,0.7737643273,-1.026864808,-0.253100481,67260
55037,"Florence","Wisconsin","US","2020-05-24 02:32:43",45.84963535,-88.39804137,2,0,0,2,"Florence, Wisconsin, US",4295,1,27,47,-20,-2,24,22,-1,55,10.944230993,-4.657119572,-0.465711957,5.5885434859,5.1228315287,1144
13115,"Floyd","Georgia","US","2020-05-24 02:32:43",34.26268279,-85.21577392,226,14,0,212,"Floyd, Georgia, US",98498,534,1133,1140,-7,152,391,543,-2,3726,11.605297717,-0.0712606,1.5473730289,3.9804135151,5.527786544,43760
18043,"Floyd","Indiana","US","2020-05-24 02:32:43",38.32117957,-85.90385377,311,38,0,273,"Floyd, Indiana, US",78522,688,885,758,127,62,504,566,-5,1329,9.6958223541,1.6244979406,0.7930619867,6.4468264729,7.2398884597,30684
19067,"Floyd","Iowa","US","2020-05-24 02:32:43",43.0600053,-92.78940097,17,1,0,16,"Floyd, Iowa, US",15642,-110,187,180,7,-5,-113,-118,1,245,11.46715933,0.445945085,-0.318532204,-7.198827801,-7.517360005,6625
21071,"Floyd","Kentucky","US","2020-05-24 02:32:43",37.56213922,-82.74750924,16,0,0,16,"Floyd, Kentucky, US",35589,-307,416,522,-106,0,-200,-200,-1,673,14.604462475,-2.965657131,0,-5.595579492,-5.595579492,10854
48153,"Floyd","Texas","US","2020-05-24 02:32:43",34.07227468,-101.3031546,5,0,0,5,"Floyd, Texas, US",5712,-71,70,52,18,2,-91,-89,0,33,9.0474119182,3.1317964332,0.3479773815,-15.83297086,-15.48499348,2350
51063,"Floyd","Virginia","US","2020-05-24 02:32:43",36.9302126,-80.36738849,4,0,0,4,"Floyd, Virginia, US",15749,-41,144,192,-48,-6,15,9,-2,85,12.175401883,-3.043850471,-0.380481309,0.9512032721,0.5707219633,4206
51065,"Fluvanna","Virginia","US","2020-05-24 02:32:43",37.84157909,-78.27715475,84,6,0,78,"Fluvanna, Virginia, US",27270,372,290,213,77,4,292,296,-1,1251,7.8644217988,2.8430069414,0.1476886723,10.781273076,10.928961749,4462
55039,"Fond du Lac","Wisconsin","US","2020-05-24 02:32:43",43.75354908,-88.48885325,158,4,0,154,"Fond du Lac, Wisconsin, US",103403,402,1068,911,157,74,179,253,-8,3559,8.8273483072,1.5212883471,0.7170403674,1.7344625104,2.4515028779,47776
17053,"Ford","Illinois","US","2020-05-24 02:32:43",40.59706922,-88.22350769,19,1,0,18,"Ford, Illinois, US",12961,-251,145,186,-41,2,-214,-212,2,411,14.213120391,-3.132999656,0.1528292515,-16.35272991,-16.19990066,5346
20057,"Ford","Kansas","US","2020-05-24 02:32:43",37.69200114,-99.88825298,1555,8,0,1547,"Ford, Kansas, US",33619,-258,559,219,340,240,-842,-602,4,708,6.4892734384,10.074671092,7.1115325353,-24.94962664,-17.83809411,16957
42053,"Forest","Pennsylvania","US","2020-05-24 02:32:43",41.51095103,-79.23229292,7,0,0,7,"Forest, Pennsylvania, US",7247,-37,20,79,-59,0,22,22,0,2645,10.873305347,-8.120569816,0,3.028009084,3.028009084,2161
55041,"Forest","Wisconsin","US","2020-05-24 02:32:43",45.66678019,-88.77084892,11,0,0,11,"Forest, Wisconsin, US",9004,27,97,104,-7,0,33,33,1,316,11.567765975,-0.778599633,0,3.6705411267,3.6705411267,3266
28035,"Forrest","Mississippi","US","2020-05-24 02:32:43",31.18961454,-89.25832496,478,33,0,445,"Forrest, Mississippi, US",74897,-15,1000,764,236,154,-404,-250,-1,2987,10.199654226,3.1506785307,2.0559512446,-5.393534434,-3.337583189,41486
13117,"Forsyth","Georgia","US","2020-05-24 02:32:43",34.22604035,-84.1231513,446,12,0,434,"Forsyth, Georgia, US",244252,7259,2435,1340,1095,409,5743,6152,12,652,5.5688890274,4.5506966306,1.6997579196,23.867260959,25.567018878,73189
37067,"Forsyth","North Carolina","US","2020-05-24 02:32:43",36.12859861,-80.25459052,889,7,0,882,"Forsyth, North Carolina, US",382295,3079,4356,3339,1017,333,1734,2067,-5,10923,8.7694071392,2.671005409,0.8745769923,4.5541036177,5.42868061,184199
48157,"Fort Bend","Texas","US","2020-05-24 02:32:43",29.52704478,-95.77219463,1676,41,0,1635,"Fort Bend, Texas, US",811688,23607,9532,3762,5770,4360,13487,17847,-10,5183,4.7031790215,7.213541455,5.4507869574,16.861184333,22.311971291,170204
38031,"Foster","North Dakota","US","2020-05-24 02:32:43",47.4571084,-98.88279923,1,0,0,1,"Foster, North Dakota, US",3210,3,38,32,6,-2,-1,-3,0,55,9.9735078697,1.8700327256,-0.623344242,-0.311672121,-0.935016363,1852
18045,"Fountain","Indiana","US","2020-05-24 02:32:43",40.12361933,-87.24217689,17,2,0,15,"Fountain, Indiana, US",16346,-44,184,180,4,3,-51,-48,0,172,10.997067449,0.2443792766,0.1832844575,-3.115835777,-2.93255132,5760
1059,"Franklin","Alabama","US","2020-05-24 02:32:43",34.44235334,-87.84289505,434,6,0,428,"Franklin, Alabama, US",31362,64,432,367,65,29,-28,1,-2,272,11.714012129,2.0746887967,0.9256303862,-0.893712097,0.0319182892,10759
5047,"Franklin","Arkansas","US","2020-05-24 02:32:43",35.51202821,-93.89299569,4,0,0,4,"Franklin, Arkansas, US",17715,-49,178,190,-12,-1,-34,-35,-2,447,10.710561177,-0.676456495,-0.056371375,-1.916626737,-1.972998112,5125
12037,"Franklin","Florida","US","2020-05-24 02:32:43",29.83791238,-84.82731662,2,0,0,2,"Franklin, Florida, US",12125,449,94,111,-17,2,458,460,6,1763,9.3273391874,-1.428511407,0.1680601655,38.485777908,38.653838074,4425
13119,"Franklin","Georgia","US","2020-05-24 02:32:43",34.37525597,-83.23159927,36,1,0,35,"Franklin, Georgia, US",23349,315,287,300,-13,26,301,327,1,816,12.935773883,-0.560550202,1.1211004032,12.978893129,14.099993532,8163
17055,"Franklin","Illinois","US","2020-05-24 02:32:43",37.99189086,-88.92567818,11,0,0,11,"Franklin, Illinois, US",38469,-226,460,509,-49,-2,-173,-175,-2,517,13.192680525,-1.27002229,-0.051837644,-4.483956249,-4.535793894,10282
18047,"Franklin","Indiana","US","2020-05-24 02:32:43",39.4142482,-85.06062647,106,8,0,98,"Franklin, Indiana, US",22758,52,275,211,64,6,-18,-12,0,187,9.2820693296,2.8154143938,0.2639450994,-0.791835298,-0.527890199,5172
19069,"Franklin","Iowa","US","2020-05-24 02:32:43",42.73270384,-93.26256925,7,0,0,7,"Franklin, Iowa, US",10070,-15,117,107,10,6,-31,-25,0,187,10.617712726,0.9923096006,0.5953857604,-3.076159762,-2.480774001,4639
20059,"Franklin","Kansas","US","2020-05-24 02:32:43",38.56443815,-95.28644341,32,0,0,32,"Franklin, Kansas, US",25544,-81,295,250,45,9,-136,-127,1,479,9.7715413629,1.7588774453,0.3517754891,-5.315718501,-4.963943012,10427
21073,"Franklin","Kentucky","US","2020-05-24 02:32:43",38.2379395,-84.87962551,24,0,0,24,"Franklin, Kentucky, US",50991,190,605,539,66,28,97,125,-1,1879,10.5902232,1.2967620245,0.5501414649,1.9058472179,2.4559886828,32816
22041,"Franklin","Louisiana","US","2020-05-24 02:32:43",32.13675181,-91.67589857,287,9,0,278,"Franklin, Louisiana, US",20015,-149,272,277,-5,0,-143,-143,-1,732,13.788297369,-0.248886234,0,-7.118146295,-7.118146295,5683
23007,"Franklin","Maine","US","2020-05-24 02:32:43",44.97330019,-70.44381045,36,1,0,35,"Franklin, Maine, US",30199,284,237,341,-104,-1,391,390,-2,1104,11.345110956,-3.460092491,-0.03327012,13.008616961,12.975346841,13354
25011,"Franklin","Massachusetts","US","2020-05-24 02:32:43",42.58119713,-72.58602547,312,46,0,266,"Franklin, Massachusetts, US",70180,-431,526,703,-177,102,-355,-253,-1,1512,9.9864337919,-2.514365265,1.4489562543,-5.042935983,-3.593979729,29454
28037,"Franklin","Mississippi","US","2020-05-24 02:32:43",31.47786634,-90.89672989,25,2,0,23,"Franklin, Mississippi, US",7713,-45,84,88,-4,3,-43,-40,-1,67,11.376123069,-0.517096503,0.3878223774,-5.558787409,-5.170965031,1883
29071,"Franklin","Missouri","US","2020-05-24 02:32:43",38.41127108,-91.07522826,138,16,0,122,"Franklin, Missouri, US",103967,251,1186,1047,139,12,106,118,-6,858,10.082674075,1.3385785067,0.1155607344,1.0207864871,1.1363472215,39299
31061,"Franklin","Nebraska","US","2020-05-24 02:32:43",40.17636348,-98.95299073,6,0,0,6,"Franklin, Nebraska, US",2979,-34,35,27,8,0,-43,-43,1,18,9.0120160214,2.6702269693,0,-14.35246996,-14.35246996,1112
36033,"Franklin","New York","US","2020-05-24 02:32:43",44.59040891,-74.29926032,20,0,0,20,"Franklin, New York, US",50022,-257,444,524,-80,-6,-171,-177,0,6146,10.448549865,-1.595198453,-0.119639884,-3.409736693,-3.529376577,19886
37069,"Franklin","North Carolina","US","2020-05-24 02:32:43",36.081519,-78.28708884,141,22,0,119,"Franklin, North Carolina, US",69685,2060,725,642,83,103,1867,1970,7,1473,9.3511033428,1.2089432671,1.5002548977,27.193940718,28.694195616,14220
39049,"Franklin","Ohio","US","2020-05-24 02:32:43",39.96995815,-83.01115755,5097,224,0,4873,"Franklin, Ohio, US",1316756,9058,18521,10027,8494,3595,-2967,628,-64,30744,7.641208419,6.4729654244,2.7396174595,-2.261041725,0.4785757342,716279
42055,"Franklin","Pennsylvania","US","2020-05-24 02:32:43",39.92956518,-77.72157791,711,29,0,682,"Franklin, Pennsylvania, US",155027,448,1730,1632,98,53,306,359,-9,2613,10.542431348,0.6330626667,0.3423706259,1.9767058778,2.3190765037,61082
47051,"Franklin","Tennessee","US","2020-05-24 02:32:43",35.15634626,-86.09201039,45,1,0,44,"Franklin, Tennessee, US",42208,273,413,456,-43,40,276,316,0,2215,10.838691276,-1.022069572,0.9507623926,6.5602605089,7.5110229015,14422
48159,"Franklin","Texas","US","2020-05-24 02:32:43",33.17653242,-95.21917243,8,0,0,8,"Franklin, Texas, US",10725,-53,115,135,-20,0,-32,-32,-1,80,12.556387481,-1.860205553,0,-2.976328884,-2.976328884,4363
50011,"Franklin","Vermont","US","2020-05-24 02:32:43",44.85627605,-72.91249563,99,5,0,94,"Franklin, Vermont, US",49402,144,569,392,177,6,-37,-31,-2,574,7.9464828705,3.5880802757,0.1216298399,-0.750050679,-0.628420839,18907
51067,"Franklin","Virginia","US","2020-05-24 02:32:43",36.99536167,-79.88023649,32,1,0,31,"Franklin, Virginia, US",56042,-149,456,681,-225,-15,95,80,-4,1160,12.135468178,-4.009515918,-0.267301061,1.6929067208,1.4256056597,16866
53021,"Franklin","Washington","US","2020-05-24 02:32:43",46.53351425,-118.9018212,480,18,0,462,"Franklin, Washington, US",95222,1219,1573,460,1113,60,44,104,2,2882,4.8619368477,11.763773286,0.6341656758,0.4650548289,1.0992205047,31116
51620,"Franklin City","Virginia","US","2020-05-24 02:32:43",36.6831435,-76.93859681,38,1,0,37,"Franklin City, Virginia, US",7967,-122,155,110,45,-1,-166,-167,0,129,13.70204285,5.6053811659,-0.124564026,-20.6776283,-20.80219233,4127
24021,"Frederick","Maryland","US","2020-05-24 02:32:43",39.47296601,-77.39999394,1661,96,0,1565,"Frederick, Maryland, US",259547,4604,2864,1859,1005,325,3280,3605,-6,4353,7.2265738887,3.9067814729,1.2633870435,12.750490777,14.013877821,104990
51069,"Frederick","Virginia","US","2020-05-24 02:32:43",39.20172582,-78.25974949,255,3,0,252,"Frederick, Virginia, US",89313,1140,949,755,194,3,943,946,0,1175,8.5077132844,2.1860879168,0.0338054832,10.626190235,10.659995718,30870
51630,"Fredericksburg","Virginia","US","2020-05-24 02:32:43",38.2977863,-77.4922454,113,0,0,113,"Fredericksburg, Virginia, US",29036,-135,429,201,228,36,-399,-363,0,2677,6.9063858299,7.8341092996,1.2369646262,-13.70969127,-12.47272665,26813
27047,"Freeborn","Minnesota","US","2020-05-24 02:32:43",43.67385583,-93.34884422,82,0,0,82,"Freeborn, Minnesota, US",30281,-199,314,352,-38,25,-187,-162,1,638,11.586379421,-1.250802324,0.8228962657,-6.155264067,-5.332367802,13259
48161,"Freestone","Texas","US","2020-05-24 02:32:43",31.70422788,-96.15072516,7,0,0,7,"Freestone, Texas, US",19717,-72,219,223,-4,13,-79,-66,-2,1612,11.289424391,-0.202500886,0.6581278793,-3.999392497,-3.341264618,6435
8043,"Fremont","Colorado","US","2020-05-24 02:32:43",38.47362326,-105.4399667,26,0,0,26,"Fremont, Colorado, US",47839,-120,381,564,-183,-5,70,65,-2,8237,11.774776091,-3.820539051,-0.104386313,1.4614083801,1.3570220673,13788
16043,"Fremont","Idaho","US","2020-05-24 02:32:43",44.22800938,-111.4809943,3,0,0,3,"Fremont, Idaho, US",13099,-56,183,92,91,5,-151,-146,-1,448,7.0084558543,6.9322769864,0.3808943399,-11.50300907,-11.12211473,3467
19071,"Fremont","Iowa","US","2020-05-24 02:32:43",40.7454272,-95.60129045,4,0,0,4,"Fremont, Iowa, US",6960,-21,78,77,1,2,-24,-22,0,131,11.046553332,0.1434617316,0.2869234632,-3.443081558,-3.156158095,2595
56013,"Fremont","Wyoming","US","2020-05-24 02:32:43",43.04183996,-108.6296893,244,0,0,244,"Fremont, Wyoming, US",39261,-300,505,485,20,-3,-316,-319,-1,1029,12.306208926,0.507472533,-0.07612088,-8.018066022,-8.094186902,17325
6019,"Fresno","California","US","2020-05-24 02:32:43",36.75733899,-119.6466953,1417,22,0,1395,"Fresno, California, US",999101,7151,14506,7467,7039,479,-348,131,-19,17667,7.5005612614,7.0706375678,0.4811529187,-0.349564125,0.1315887941,361256
48163,"Frio","Texas","US","2020-05-24 02:32:43",28.86751206,-99.10804207,35,0,0,35,"Frio, Texas, US",20306,95,251,158,93,236,-235,1,1,3394,7.7991953995,4.5906656465,11.649431103,-11.60006911,0.0493619962,8930
31063,"Frontier","Nebraska","US","2020-05-24 02:32:43",40.52993007,-100.3924658,1,0,0,1,"Frontier, Nebraska, US",2627,27,24,15,9,0,17,17,1,113,5.7394298833,3.44365793,0,6.5046872011,6.5046872011,1155
5049,"Fulton","Arkansas","US","2020-05-24 02:32:43",36.38177105,-91.81729127,6,0,0,6,"Fulton, Arkansas, US",12477,169,134,201,-67,5,232,237,-1,165,16.219487593,-5.406495864,0.4034698406,18.721000605,19.124470446,2967
13121,"Fulton","Georgia","US","2020-05-24 02:32:43",33.79216944,-84.46319413,3977,197,0,3780,"Fulton, Georgia, US",1063937,13806,12612,7418,5194,3003,5556,8559,53,34098,7.0177496656,4.9137492266,2.8409682186,5.256216924,8.0971851426,837900
17057,"Fulton","Illinois","US","2020-05-24 02:32:43",40.47289135,-90.20862357,10,0,0,10,"Fulton, Illinois, US",34340,-490,321,463,-142,5,-353,-348,0,2682,13.387306636,-4.105826225,0.144571346,-10.20673702,-10.06216568,9663
18049,"Fulton","Indiana","US","2020-05-24 02:32:43",41.0469907,-86.26252745,46,1,0,45,"Fulton, Indiana, US",19974,-79,230,207,23,-1,-100,-101,-1,224,10.343018463,1.1492242736,-0.049966273,-4.996627277,-5.046593549,6898
21075,"Fulton","Kentucky","US","2020-05-24 02:32:43",36.55238827,-89.20140068,3,0,0,3,"Fulton, Kentucky, US",5969,-97,54,90,-36,0,-62,-62,1,444,14.956377233,-5.982550893,0,-10.30328209,-10.30328209,2593
36035,"Fulton","New York","US","2020-05-24 02:32:43",43.11363907,-74.41798804,193,15,0,178,"Fulton, New York, US",53383,-250,517,565,-48,0,-203,-203,1,1384,10.559168722,-0.897062122,0,-3.793825222,-3.793825222,18793
39051,"Fulton","Ohio","US","2020-05-24 02:32:43",41.60213491,-84.12571393,35,0,0,35,"Fulton, Ohio, US",42126,-141,487,429,58,10,-209,-199,0,392,10.166719989,1.3745215835,0.2369864799,-4.95301743,-4.71603095,18033
42057,"Fulton","Pennsylvania","US","2020-05-24 02:32:43",39.92913544,-78.11163677,14,1,0,13,"Fulton, Pennsylvania, US",14530,5,144,153,-9,1,15,16,-2,122,10.531750129,-0.619514713,0.0688349682,1.0325245225,1.1013594906,5491
31065,"Furnas","Nebraska","US","2020-05-24 02:32:43",40.17642064,-99.91247454,7,0,0,7,"Furnas, Nebraska, US",4676,-25,56,55,1,0,-27,-27,1,62,11.730830756,0.2132878319,0,-5.758771462,-5.758771462,2235
12039,"Gadsden","Florida","US","2020-05-24 02:32:43",30.57796289,-84.61915825,255,1,0,254,"Gadsden, Florida, US",45660,-267,520,522,-2,41,-303,-262,-3,3269,11.398997674,-0.043674321,0.8953235721,-6.61665957,-5.721335997,11729
31067,"Gage","Nebraska","US","2020-05-24 02:32:43",40.26186809,-96.68946704,44,3,0,41,"Gage, Nebraska, US",21513,18,228,255,-27,1,46,47,-2,485,11.858258929,-1.255580357,0.0465029762,2.1391369048,2.185639881,9632
48165,"Gaines","Texas","US","2020-05-24 02:32:43",32.74055318,-102.6353295,6,0,0,6,"Gaines, Texas, US",21492,672,430,121,309,67,295,362,1,80,5.7194176593,14.605785593,3.1669502742,13.944034789,17.110985063,7216
51640,"Galax","Virginia","US","2020-05-24 02:32:43",36.66601852,-80.91703124,87,0,0,87,"Galax, Virginia, US",6347,-1,69,116,-47,-5,53,48,-2,377,18.274911382,-7.404489957,-0.787711698,8.3497439937,7.5620322962,3885
17059,"Gallatin","Illinois","US","2020-05-24 02:32:43",37.76430935,-88.22953869,2,0,0,2,"Gallatin, Illinois, US",4828,-217,40,79,-39,0,-178,-178,0,25,16.003241163,-7.900334245,0,-36.05793578,-36.05793578,1624
21077,"Gallatin","Kentucky","US","2020-05-24 02:32:43",38.75398691,-84.8558382,8,0,0,8,"Gallatin, Kentucky, US",8869,103,112,84,28,0,75,75,0,85,9.5265097817,3.1755032606,0,8.5058123051,8.5058123051,2415
30031,"Gallatin","Montana","US","2020-05-24 02:32:43",45.54486106,-111.1692571,149,1,0,148,"Gallatin, Montana, US",114434,2752,1262,612,650,111,1973,2084,18,3273,5.4131507722,5.749261441,0.9817969538,17.451219728,18.433016682,50924
39053,"Gallia","Ohio","US","2020-05-24 02:32:43",38.82708533,-82.31647569,7,1,0,6,"Gallia, Ohio, US",29898,-47,353,389,-36,16,-24,-8,-3,883,13.000685126,-1.203148238,0.5347325502,-0.802098825,-0.267366275,11914
48167,"Galveston","Texas","US","2020-05-24 02:32:43",29.40167322,-94.90469073,740,31,0,709,"Galveston, Texas, US",342139,4281,3944,2935,1009,329,2949,3278,-6,5097,8.6323910253,2.9676601514,0.9676513279,8.6735676775,9.6412190054,108816
8045,"Garfield","Colorado","US","2020-05-24 02:32:43",39.59921777,-107.902708,120,2,0,118,"Garfield, Colorado, US",60061,360,781,380,401,54,-94,-40,-1,884,6.3459194068,6.696614953,0.9017885473,-1.569780064,-0.667991517,26872
40047,"Garfield","Oklahoma","US","2020-05-24 02:32:43",36.3791334,-97.78265517,25,1,0,24,"Garfield, Oklahoma, US",61056,-39,864,621,243,147,-430,-283,1,1829,10.167743203,3.9786821229,2.4068570867,-7.040466308,-4.633609221,29408
53023,"Garfield","Washington","US","2020-05-24 02:32:43",46.43197502,-117.5454032,0,0,0,0,"Garfield, Washington, US",2225,-15,27,28,-1,5,-19,-14,0,36,12.541993281,-0.447928331,2.2396416573,-8.510638298,-6.270996641,701
5051,"Garland","Arkansas","US","2020-05-24 02:32:43",34.57692074,-93.14921604,133,1,0,132,"Garland, Arkansas, US",99386,420,1071,1347,-276,-27,726,699,-3,2165,13.581914979,-2.782931354,-0.272243285,7.3203194321,7.0480761475,39806
21079,"Garrard","Kentucky","US","2020-05-24 02:32:43",37.6388668,-84.53289319,4,0,0,4,"Garrard, Kentucky, US",17666,147,192,185,7,-2,144,142,-2,109,10.51584482,0.397896831,-0.113684809,8.1853062385,8.0716214296,2469
24023,"Garrett","Maryland","US","2020-05-24 02:32:43",39.52786077,-79.27355126,7,0,0,7,"Garrett, Maryland, US",29014,-119,260,345,-85,-1,-31,-32,-2,528,11.866476344,-2.923624607,-0.034395584,-1.066263092,-1.100658675,13249
40049,"Garvin","Oklahoma","US","2020-05-24 02:32:43",34.70418038,-97.30811132,15,1,0,14,"Garvin, Oklahoma, US",27711,-35,328,351,-23,29,-39,-10,-2,317,12.658456101,-0.829471482,1.0458553474,-1.406495122,-0.360639775,11840
48169,"Garza","Texas","US","2020-05-24 02:32:43",33.17969345,-101.2984114,4,0,0,4,"Garza, Texas, US",6229,-14,52,34,18,38,-70,-32,0,1828,5.452212957,2.8864656831,6.0936497755,-11.22514432,-5.131494548,2209
29073,"Gasconade","Missouri","US","2020-05-24 02:32:43",38.43947277,-91.50847147,2,0,0,2,"Gasconade, Missouri, US",14706,26,152,197,-45,-1,74,73,-2,250,13.407745185,-3.06268291,-0.06805962,5.0364118968,4.9683522766,6195
37071,"Gaston","North Carolina","US","2020-05-24 02:32:43",35.29373559,-81.17477045,247,6,0,241,"Gaston, North Carolina, US",224529,1899,2580,2422,158,59,1679,1738,3,3412,10.832835747,0.7066837523,0.2638882366,7.5096330388,7.7735212754,71535
37073,"Gates","North Carolina","US","2020-05-24 02:32:43",36.44667547,-76.69749701,21,1,0,20,"Gates, North Carolina, US",11562,-1,96,142,-46,6,40,46,-1,60,12.281081081,-3.978378378,0.5189189189,3.4594594595,3.9783783784,1846
20061,"Geary","Kansas","US","2020-05-24 02:32:43",38.99871131,-96.7577178,16,0,0,16,"Geary, Kansas, US",31670,-1107,851,187,664,24,-1793,-1769,-2,843,5.8032181482,20.606079414,0.7447980511,-55.64262107,-54.89782302,23977
39055,"Geauga","Ohio","US","2020-05-24 02:32:43",41.49952319,-81.17935342,250,29,0,221,"Geauga, Ohio, US",93649,-296,940,822,118,24,-436,-412,-2,865,8.7636065119,1.2580359713,0.255871723,-4.648336301,-4.392464578,35568
16045,"Gem","Idaho","US","2020-05-24 02:32:43",44.06482372,-116.398376,17,0,0,17,"Gem, Idaho, US",18112,525,200,203,-3,-1,528,527,1,148,11.372867587,-0.168071935,-0.056023978,29.580660523,29.524636544,3875
26049,"Genesee","Michigan","US","2020-05-24 02:32:43",43.02244215,-83.70589709,1936,240,0,1696,"Genesee, Michigan, US",405813,-875,4600,4557,43,117,-1026,-909,-9,5680,11.217216963,0.1058460236,0.2879996455,-2.525535353,-2.237535708,144583
36037,"Genesee","New York","US","2020-05-24 02:32:43",43.0022601,-78.19135193,191,4,0,187,"Genesee, New York, US",57280,-207,542,630,-88,2,-120,-118,-1,1956,10.978765673,-1.533541872,0.0348532244,-2.091193462,-2.056340237,25337
1061,"Geneva","Alabama","US","2020-05-24 02:32:43",31.09389027,-85.83572839,31,0,0,31,"Geneva, Alabama, US",26271,-35,278,365,-87,-7,62,55,-3,229,13.884398121,-3.309431881,-0.266276128,2.3584457082,2.0921695799,6081
29075,"Gentry","Missouri","US","2020-05-24 02:32:43",40.21097916,-94.40944419,6,0,0,6,"Gentry, Missouri, US",6571,-27,83,90,-7,0,-19,-19,-1,177,13.668463817,-1.063102741,0,-2.885564583,-2.885564583,2506
28039,"George","Mississippi","US","2020-05-24 02:32:43",30.86259065,-88.64436789,19,1,0,18,"George, Mississippi, US",24500,390,347,249,98,2,290,292,0,608,10.244805596,4.0320921621,0.0822875951,11.931701296,12.013988891,4827
45043,"Georgetown","South Carolina","US","2020-05-24 02:32:43",33.43443342,-79.33202141,56,3,0,53,"Georgetown, South Carolina, US",62680,448,521,879,-358,-13,817,804,2,560,14.073908031,-5.732035353,-0.208146535,13.081209171,12.873062636,22254
18051,"Gibson","Indiana","US","2020-05-24 02:32:43",38.30393723,-87.58054938,13,2,0,11,"Gibson, Indiana, US",33659,49,384,385,-1,64,-12,52,-2,738,11.446580148,-0.029731377,1.9028081286,-0.356776524,1.5460316045,20396
47053,"Gibson","Tennessee","US","2020-05-24 02:32:43",35.99438059,-88.93358327,61,1,0,60,"Gibson, Tennessee, US",49133,-38,579,654,-75,5,34,39,-2,1155,13.305664063,-1.525878906,0.1017252604,0.6917317708,0.7934570313,14915
4007,"Gila","Arizona","US","2020-05-24 02:32:43",33.80190085,-110.8132779,23,1,0,22,"Gila, Arizona, US",54018,217,514,811,-297,9,504,513,1,908,15.043730697,-5.509233067,0.1669464566,9.3490015674,9.515948024,17941
12041,"Gilchrist","Florida","US","2020-05-24 02:32:43",29.72856978,-82.79880657,10,0,0,10,"Gilchrist, Florida, US",18582,298,182,206,-24,3,318,321,1,1208,11.175608962,-1.302012695,0.1627515868,17.251668204,17.414419791,3823
47055,"Giles","Tennessee","US","2020-05-24 02:32:43",35.20222469,-87.03992678,12,0,0,12,"Giles, Tennessee, US",29464,18,301,371,-70,39,51,90,-2,681,12.595484638,-2.376506535,1.3240536411,1.7314547615,3.0555084026,10001
51071,"Giles","Virginia","US","2020-05-24 02:32:43",37.31234791,-80.70636931,5,0,0,5,"Giles, Virginia, US",16720,-79,166,217,-51,-1,-26,-27,-1,136,12.947880307,-3.04305021,-0.059667651,-1.551358931,-1.611026582,5654
48171,"Gillespie","Texas","US","2020-05-24 02:32:43",30.31824095,-98.94676915,5,0,0,5,"Gillespie, Texas, US",26988,286,248,373,-125,12,397,409,2,310,13.894579996,-4.656360589,0.4470106165,14.788601229,15.235611846,11094
13123,"Gilmer","Georgia","US","2020-05-24 02:32:43",34.69316688,-84.45802506,134,0,0,134,"Gilmer, Georgia, US",31369,534,313,367,-54,-1,586,585,3,171,11.799884252,-1.736222751,-0.032152273,18.841232075,18.809079802,8445
54021,"Gilmer","West Virginia","US","2020-05-24 02:32:43",38.9251277,-80.85952723,9,0,0,9,"Gilmer, West Virginia, US",7823,-75,47,79,-32,-2,-41,-43,0,1765,10.050251256,-4.070987851,-0.254436741,-5.215953184,-5.470389924,2790
8047,"Gilpin","Colorado","US","2020-05-24 02:32:43",39.85646523,-105.5252597,3,0,0,3,"Gilpin, Colorado, US",6243,131,36,24,12,0,117,117,2,49,3.8850667746,1.9425333873,0,18.939700526,18.939700526,5683
30035,"Glacier","Montana","US","2020-05-24 02:32:43",48.70513576,-112.9934235,6,0,0,6,"Glacier, Montana, US",13753,-75,238,142,96,3,-175,-172,1,690,10.296943548,6.961313948,0.2175410609,-12.68989522,-12.47235416,4605
12043,"Glades","Florida","US","2020-05-24 02:32:43",26.95635849,-81.18996211,20,1,0,19,"Glades, Florida, US",13811,125,64,129,-65,15,173,188,2,1468,9.3828417646,-4.727788486,1.0910281122,12.583190894,13.674219006,2794
26051,"Gladwin","Michigan","US","2020-05-24 02:32:43",43.98901072,-84.38774817,17,1,0,16,"Gladwin, Michigan, US",25449,123,240,374,-134,2,256,258,-1,289,14.731659281,-5.278188085,0.0787789266,10.08370261,10.162481536,5485
13125,"Glascock","Georgia","US","2020-05-24 02:32:43",33.22879932,-82.61297636,1,0,0,1,"Glascock, Georgia, US",2971,-6,29,35,-6,0,0,0,0,86,11.768661735,-2.017484869,0,0,0,556
48173,"Glasscock","Texas","US","2020-05-24 02:32:43",31.86942909,-101.5207776,1,0,0,1,"Glasscock, Texas, US",1409,18,16,8,8,9,2,11,-1,0,5.7142857143,5.7142857143,6.4285714286,1.4285714286,7.8571428571,844
6021,"Glenn","California","US","2020-05-24 02:32:43",39.59875897,-122.3938452,12,0,0,12,"Glenn, California, US",28393,426,371,251,120,-31,337,306,0,334,8.9070262598,4.2583392477,-1.100070972,11.958836054,10.858765082,8939
34015,"Gloucester","New Jersey","US","2020-05-24 02:32:43",39.71581067,-75.13995546,2044,134,0,1910,"Gloucester, New Jersey, US",291636,111,2841,2694,147,61,-86,-25,-11,4237,9.2393009821,0.50414894,0.2092046622,-0.294944278,-0.085739616,104648
51073,"Gloucester","Virginia","US","2020-05-24 02:32:43",37.40809042,-76.53524337,30,1,0,29,"Gloucester, Virginia, US",37348,7,338,450,-112,-7,130,123,-4,293,12.049967197,-2.999102947,-0.187443934,3.4811016348,3.2936577006,10707
13127,"Glynn","Georgia","US","2020-05-24 02:32:43",31.23279254,-81.53811412,85,1,0,84,"Glynn, Georgia, US",85292,317,916,923,-7,8,318,326,-2,1538,10.841795533,-0.082223801,0.0939700588,3.7353098369,3.8292798957,41007
26053,"Gogebic","Michigan","US","2020-05-24 02:32:43",46.40862701,-89.69377193,5,1,0,4,"Gogebic, Michigan, US",13975,-1141,128,210,-82,3,-1073,-1070,11,372,14.437454883,-5.637482383,0.2062493555,-73.76851947,-73.56227012,5566
30037,"Golden Valley","Montana","US","2020-05-24 02:32:43",46.3816474,-109.1768522,3,0,0,3,"Golden Valley, Montana, US",821,-1,12,5,7,0,-6,-6,-2,89,6.0864272672,8.5209981741,0,-7.303712721,-7.303712721,269
48175,"Goliad","Texas","US","2020-05-24 02:32:43",28.65696592,-97.42760647,7,0,0,7,"Goliad, Texas, US",7658,70,72,62,10,-1,61,60,0,107,8.1332808606,1.3118194936,-0.131181949,8.0020989112,7.8709169618,1728
48177,"Gonzales","Texas","US","2020-05-24 02:32:43",29.45634206,-97.49424032,90,2,0,88,"Gonzales, Texas, US",20837,56,272,198,74,-23,7,-16,-2,312,9.5151136527,3.5561535874,-1.10529098,0.3363929069,-0.768898073,9013
51075,"Goochland","Virginia","US","2020-05-24 02:32:43",37.71714806,-77.90381514,90,5,0,85,"Goochland, Virginia, US",23753,534,161,196,-35,-3,569,566,3,983,8.3453972579,-1.49024951,-0.127735672,24.227199182,24.09946351,12418
27049,"Goodhue","Minnesota","US","2020-05-24 02:32:43",44.40849741,-92.7234195,50,2,0,48,"Goodhue, Minnesota, US",46340,41,503,454,49,3,-10,-7,-1,865,9.8014874945,1.0578697957,0.0647675385,-0.215891795,-0.151124257,22744
16047,"Gooding","Idaho","US","2020-05-24 02:32:43",42.96927962,-114.8108306,35,0,0,35,"Gooding, Idaho, US",15179,63,191,117,74,0,-9,-9,-2,31,7.7240468724,4.8852946031,0,-0.594157452,-0.594157452,6088
13129,"Gordon","Georgia","US","2020-05-24 02:32:43",34.50487351,-84.87296253,138,15,0,123,"Gordon, Georgia, US",57963,335,669,571,98,23,217,240,-3,669,9.8796619114,1.6956337431,0.3979548581,3.754617574,4.1525724321,23420
56015,"Goshen","Wyoming","US","2020-05-24 02:32:43",42.08798185,-104.3534743,5,0,0,5,"Goshen, Wyoming, US",13211,-81,132,142,-10,6,-78,-72,1,1238,10.715768026,-0.754631551,0.4527789307,-5.886126099,-5.433347168,5394
31073,"Gosper","Nebraska","US","2020-05-24 02:32:43",40.51481965,-99.83020279,13,0,0,13,"Gosper, Nebraska, US",1990,-6,20,18,2,0,-8,-8,0,41,9.0316106372,1.003512293,0,-4.014049172,-4.014049172,722
20063,"Gove","Kansas","US","2020-05-24 02:32:43",38.91588178,-100.4829321,1,0,0,1,"Gove, Kansas, US",2636,25,27,35,-8,2,33,35,-2,56,13.340956737,-3.04936154,0.762340385,12.578616352,13.340956737,1492
13131,"Grady","Georgia","US","2020-05-24 02:32:43",30.87454847,-84.23418364,93,4,0,89,"Grady, Georgia, US",24633,-141,299,264,35,0,-178,-178,2,200,10.686744793,1.416803287,0,-7.205456717,-7.205456717,6028
40051,"Grady","Oklahoma","US","2020-05-24 02:32:43",35.0167709,-97.88339847,73,2,0,71,"Grady, Oklahoma, US",55834,386,567,532,35,24,328,352,-1,1074,9.5612947287,0.6290325479,0.4313366043,5.8949335921,6.3262701964,15867
33009,"Grafton","New Hampshire","US","2020-05-24 02:32:43",43.93779815,-71.82057197,69,1,0,68,"Grafton, New Hampshire, US",89886,185,681,830,-149,131,209,340,-6,7102,9.2434307606,-1.659362871,1.4589029273,2.3275626855,3.7864656128,56076
4009,"Graham","Arizona","US","2020-05-24 02:32:43",32.93166885,-109.8882178,21,0,0,21,"Graham, Arizona, US",38837,842,526,323,203,30,607,637,2,2922,8.4079550187,5.2842565598,0.7809246147,15.800708038,16.581632653,10236
37075,"Graham","North Carolina","US","2020-05-24 02:32:43",35.3506925,-83.83369267,2,0,0,2,"Graham, North Carolina, US",8441,-20,72,99,-27,1,7,8,-1,94,11.714589989,-3.194888179,0.1183291918,0.8283043427,0.9466335345,2226
47057,"Grainger","Tennessee","US","2020-05-24 02:32:43",36.27469206,-83.51254721,6,0,0,6,"Grainger, Tennessee, US",23320,183,222,296,-74,-2,257,255,2,151,12.742966614,-3.185741654,-0.086101126,11.063994662,10.977893536,4061
8049,"Grand","Colorado","US","2020-05-24 02:32:43",40.10603347,-106.1178042,6,0,0,6,"Grand, Colorado, US",15734,223,109,66,43,10,170,180,0,222,4.2246759482,2.7524403905,0.6401024164,10.881741079,11.521843495,7819
38035,"Grand Forks","North Dakota","US","2020-05-24 02:32:43",47.92093639,-97.45450447,321,3,0,318,"Grand Forks, North Dakota, US",69451,-904,974,526,448,61,-1419,-1358,6,3026,7.5247128163,6.4088808778,0.8726377981,-20.29955796,-19.42692016,41659
50013,"Grand Isle","Vermont","US","2020-05-24 02:32:43",44.7975824,-73.29679772,6,0,0,6,"Grand Isle, Vermont, US",7235,125,68,57,11,0,114,114,0,0,7.9470198675,1.533635413,0,15.894039735,15.894039735,1497
26055,"Grand Traverse","Michigan","US","2020-05-24 02:32:43",44.69565625,-85.55585247,23,5,0,18,"Grand Traverse, Michigan, US",93088,558,902,867,35,7,517,524,-1,1483,9.3417664235,0.3771185984,0.0754237197,5.5705804394,5.6460041591,51591
5053,"Grant","Arkansas","US","2020-05-24 02:32:43",34.29017991,-92.42320562,16,0,0,16,"Grant, Arkansas, US",18265,85,172,188,-16,-6,107,101,0,143,10.316915901,-0.878035396,-0.329263273,5.8718617094,5.542598436,4103
18053,"Grant","Indiana","US","2020-05-24 02:32:43",40.51587228,-85.65468702,178,20,0,158,"Grant, Indiana, US",65769,-270,750,810,-60,26,-235,-209,-1,4786,12.290604516,-0.910415149,0.3945132314,-3.565792668,-3.171279437,30351
20067,"Grant","Kansas","US","2020-05-24 02:32:43",37.56227336,-101.3079758,18,0,0,18,"Grant, Kansas, US",7150,-144,108,34,74,-9,-210,-219,1,79,4.7078371642,10.246469122,-1.246192191,-29.07781778,-30.32400997,3446
21081,"Grant","Kentucky","US","2020-05-24 02:32:43",38.64962758,-84.62415957,36,3,0,33,"Grant, Kentucky, US",25069,4,363,250,113,-14,-96,-110,1,456,9.973271632,4.5079187777,-0.558503211,-3.829736307,-4.388239518,5348
22043,"Grant","Louisiana","US","2020-05-24 02:32:43",31.59882456,-92.56124347,26,1,0,25,"Grant, Louisiana, US",22389,-47,239,192,47,-1,-91,-92,-2,2961,8.5666480759,2.0970440602,-0.044617959,-4.060234244,-4.104852203,2941
27051,"Grant","Minnesota","US","2020-05-24 02:32:43",45.93424769,-96.01139609,2,0,0,2,"Grant, Minnesota, US",5972,-17,56,59,-3,0,-13,-13,-1,110,9.8653958699,-0.501630298,0,-2.173731293,-2.173731293,2318
35017,"Grant","New Mexico","US","2020-05-24 02:32:43",32.73911281,-108.3827845,16,0,0,16,"Grant, New Mexico, US",26998,-305,256,325,-69,-10,-221,-231,-5,586,11.970313622,-2.541389661,-0.368317342,-8.139813263,-8.508130605,10626
38037,"Grant","North Dakota","US","2020-05-24 02:32:43",46.35821257,-101.6390013,2,0,0,2,"Grant, North Dakota, US",2274,-80,26,24,2,0,-83,-83,1,14,10.371650821,0.8643042351,0,-35.86862576,-35.86862576,1131
40053,"Grant","Oklahoma","US","2020-05-24 02:32:43",36.796297,-97.78638765,2,0,0,2,"Grant, Oklahoma, US",4333,12,48,49,-1,0,12,12,1,73,11.324243125,-0.231107003,0,2.7732840305,2.7732840305,1918
41023,"Grant","Oregon","US","2020-05-24 02:32:43",44.49024544,-119.0068631,1,0,0,1,"Grant, Oregon, US",7199,14,63,86,-23,-2,40,38,-1,126,11.957730812,-3.197997775,-0.278086763,5.5617352614,5.2836484983,2708
46051,"Grant","South Dakota","US","2020-05-24 02:32:43",45.1723937,-96.77002276,10,0,0,10,"Grant, South Dakota, US",7052,-51,82,70,12,-5,-58,-63,0,104,9.8904980572,1.6955139527,-0.706464147,-8.194984105,-8.901448252,4247
53025,"Grant","Washington","US","2020-05-24 02:32:43",47.20753737,-119.4500749,189,4,0,185,"Grant, Washington, US",97733,1061,1486,719,767,81,215,296,-2,1243,7.3969290913,7.8907435508,0.8333119004,2.2118772665,3.0451891669,39430
54023,"Grant","West Virginia","US","2020-05-24 02:32:43",39.10314817,-79.19440518,6,0,0,6,"Grant, West Virginia, US",11568,-62,127,129,-2,-1,-58,-59,-1,126,11.121648418,-0.172428658,-0.086214329,-5.000431072,-5.0866454,4231
55043,"Grant","Wisconsin","US","2020-05-24 02:32:43",42.8671731,-90.7063218,81,10,0,71,"Grant, Wisconsin, US",51439,-5,561,471,90,10,-103,-93,-2,4549,9.1560316087,1.74956018,0.1943955756,-2.002274428,-1.807878853,21656
37077,"Granville","North Carolina","US","2020-05-24 02:32:43",36.30337451,-78.65184241,239,7,0,232,"Granville, North Carolina, US",60443,464,601,599,2,-11,473,462,0,3893,9.9483483084,0.0332165219,-0.18269087,7.8557074289,7.6730165584,20854
26057,"Gratiot","Michigan","US","2020-05-24 02:32:43",43.29265605,-84.60505416,67,5,0,62,"Gratiot, Michigan, US",40711,109,366,423,-57,7,160,167,-1,5563,10.404240404,-1.401989842,0.1721741911,3.935410082,4.1075842731,15194
21083,"Graves","Kentucky","US","2020-05-24 02:32:43",36.72292505,-88.65143315,157,19,0,138,"Graves, Kentucky, US",37266,-53,492,420,72,19,-144,-125,0,463,11.26231816,1.9306831132,0.5094858215,-3.861366226,-3.351880405,12301
20069,"Gray","Kansas","US","2020-05-24 02:32:43",37.73836671,-100.4369088,21,0,0,21,"Gray, Kansas, US",5988,-88,94,41,53,16,-159,-143,2,78,6.7970822281,8.7864721485,2.6525198939,-26.35941645,-23.70689655,2819
48179,"Gray","Texas","US","2020-05-24 02:32:43",35.40081878,-100.8129222,95,1,0,94,"Gray, Texas, US",21886,-165,259,254,5,-1,-170,-171,1,1959,11.562009241,0.2275986071,-0.045519721,-7.738352641,-7.783872363,9137
53027,"Grays Harbor","Washington","US","2020-05-24 02:32:43",47.14003705,-123.7820567,16,0,0,16,"Grays Harbor, Washington, US",75061,1260,734,886,-152,-16,1423,1407,5,2702,11.9036423,-2.042159853,-0.214964195,19.118378095,18.9034139,24033
21085,"Grayson","Kentucky","US","2020-05-24 02:32:43",37.46231118,-86.34248968,121,8,0,113,"Grayson, Kentucky, US",26427,134,300,316,-16,-1,152,151,-1,765,11.987860395,-0.606980273,-0.037936267,5.7663125948,5.7283763278,8273
48181,"Grayson","Texas","US","2020-05-24 02:32:43",33.62744998,-96.67753461,268,1,0,267,"Grayson, Texas, US",136212,2425,1630,1494,136,90,2193,2283,6,2318,11.066707654,1.0074111386,0.6666691358,16.244504609,16.911173745,48343
51077,"Grayson","Virginia","US","2020-05-24 02:32:43",36.65677234,-81.23215889,24,0,0,24,"Grayson, Virginia, US",15550,-85,118,202,-84,-2,2,0,-1,1068,12.954946288,-5.387205387,-0.128266795,0.1282667949,0,4297
31077,"Greeley","Nebraska","US","2020-05-24 02:32:43",41.56742671,-98.52150266,3,0,0,3,"Greeley, Nebraska, US",2356,1,29,23,6,0,-5,-5,0,57,9.7643812354,2.5472298875,0,-2.122691573,-2.122691573,872
21087,"Green","Kentucky","US","2020-05-24 02:32:43",37.26484328,-85.5540745,1,0,0,1,"Green, Kentucky, US",10941,-57,107,137,-30,0,-26,-26,-1,113,12.489174529,-2.734855736,0,-2.370208305,-2.370208305,2138
55045,"Green","Wisconsin","US","2020-05-24 02:32:43",42.6794956,-89.60243287,52,0,0,52,"Green, Wisconsin, US",36960,36,366,369,-3,15,26,41,-2,342,9.9886308267,-0.081208381,0.4060419035,0.7038059661,1.1098478696,17110
55047,"Green Lake","Wisconsin","US","2020-05-24 02:32:43",43.80025981,-89.04679553,14,0,0,14,"Green Lake, Wisconsin, US",18913,64,202,215,-13,-2,80,78,-1,188,11.387108734,-0.688522854,-0.105926593,4.2370637148,4.131137122,7998
54025,"Greenbrier","West Virginia","US","2020-05-24 02:32:43",37.9463652,-80.45335881,9,0,0,9,"Greenbrier, West Virginia, US",34662,-130,342,503,-161,2,31,33,-2,610,14.484406946,-4.636162064,0.0575920753,0.8926771676,0.950269243,15306
1063,"Greene","Alabama","US","2020-05-24 02:32:43",32.85504247,-87.95684022,90,4,0,86,"Greene, Alabama, US",8111,-98,96,93,3,0,-101,-101,0,45,11.397058824,0.3676470588,0,-12.37745098,-12.37745098,1883
5055,"Greene","Arkansas","US","2020-05-24 02:32:43",36.1173546,-90.55832668,45,0,0,45,"Greene, Arkansas, US",45325,-14,587,505,82,-7,-87,-94,-2,602,11.14003353,1.8088767317,-0.154416306,-1.919174093,-2.0735904,16695
13133,"Greene","Georgia","US","2020-05-24 02:32:43",33.5769205,-83.17139104,63,7,0,56,"Greene, Georgia, US",18324,591,176,228,-52,25,616,641,2,177,12.646642816,-2.884322046,1.3866932912,34.168122695,35.554815986,6339
17061,"Greene","Illinois","US","2020-05-24 02:32:43",39.35907414,-90.388865,5,0,0,5,"Greene, Illinois, US",12969,-96,131,153,-22,1,-76,-75,1,284,11.753860336,-1.690097565,0.0768226166,-5.83851886,-5.761696243,3425
18055,"Greene","Indiana","US","2020-05-24 02:32:43",39.03630547,-86.96223202,167,23,0,144,"Greene, Indiana, US",31922,-137,339,416,-77,4,-62,-58,-2,281,13.003860521,-2.406964568,0.1250371204,-1.938075366,-1.813038246,8054
19073,"Greene","Iowa","US","2020-05-24 02:32:43",42.03614551,-94.39658081,13,0,0,13,"Greene, Iowa, US",8888,-77,103,114,-11,-1,-65,-66,0,88,12.770962863,-1.23228589,-0.11202599,-7.281689352,-7.393715342,3940
28041,"Greene","Mississippi","US","2020-05-24 02:32:43",31.21444233,-88.63922281,7,1,0,6,"Greene, Mississippi, US",13586,-410,143,126,17,13,-444,-431,4,2606,9.1363933,1.2326879849,0.9426437532,-32.19490972,-31.25226597,2021
29077,"Greene","Missouri","US","2020-05-24 02:32:43",37.2575872,-93.34230916,121,8,0,113,"Greene, Missouri, US",293086,2032,3269,2773,496,224,1310,1534,2,11278,9.4942993118,1.6982230287,0.7669394323,4.4852261444,5.2521655767,168379
36039,"Greene","New York","US","2020-05-24 02:32:43",42.275797,-74.12384884,217,18,0,199,"Greene, New York, US",47188,-193,384,540,-156,20,-54,-34,-3,3048,11.420232846,-3.299178378,0.4229715869,-1.142023285,-0.719051698,15260
37079,"Greene","North Carolina","US","2020-05-24 02:32:43",35.48544173,-77.67578087,64,2,0,62,"Greene, North Carolina, US",21069,-37,206,223,-17,16,-35,-19,-1,2665,10.574985181,-0.80616479,0.7587433314,-1.659751037,-0.901007706,5295
39057,"Greene","Ohio","US","2020-05-24 02:32:43",39.69116283,-83.89032084,92,5,0,87,"Greene, Ohio, US",168937,1491,1716,1490,226,209,1062,1271,-6,8178,8.8589494713,1.3437064299,1.2426311674,6.3142310997,7.5568622671,81581
42059,"Greene","Pennsylvania","US","2020-05-24 02:32:43",39.85746531,-80.22357106,27,0,0,27,"Greene, Pennsylvania, US",36233,-428,361,430,-69,-1,-360,-361,2,3122,11.797953192,-1.893159931,-0.0274371,-9.877356161,-9.904793261,16286
47059,"Greene","Tennessee","US","2020-05-24 02:32:43",36.17470125,-82.84691273,48,2,0,46,"Greene, Tennessee, US",69069,-95,665,908,-243,9,144,153,-5,1730,13.137239299,-3.515803028,0.130214927,2.0834388315,2.2136537585,26192
51079,"Greene","Virginia","US","2020-05-24 02:32:43",38.29545894,-78.46525378,21,1,0,20,"Greene, Virginia, US",19819,127,224,148,76,12,38,50,1,137,7.491584622,3.847029941,0.6074257802,1.9235149705,2.5309407507,3842
4011,"Greenlee","Arizona","US","2020-05-24 02:32:43",33.21498827,-109.2405279,3,0,0,3,"Greenlee, Arizona, US",9498,50,144,49,95,8,-52,-44,-1,34,5.1725957986,10.028502058,0.8445054365,-5.489285337,-4.644779901,5138
51081,"Greensville","Virginia","US","2020-05-24 02:32:43",36.67878901,-77.56351439,55,7,0,48,"Greensville, Virginia, US",11336,-96,107,126,-19,2,-79,-77,0,3414,11.068165847,-1.669009136,0.1756851722,-6.939564301,-6.763879129,4082
21089,"Greenup","Kentucky","US","2020-05-24 02:32:43",38.54332505,-82.9215658,13,0,0,13,"Greenup, Kentucky, US",35098,-234,352,471,-119,-3,-112,-115,0,454,13.374982252,-3.3792418,-0.08519097,-3.180462871,-3.265653841,8514
45045,"Greenville","South Carolina","US","2020-05-24 02:32:43",34.89502264,-82.37295012,1231,50,0,1181,"Greenville, South Carolina, US",523542,8921,6308,4496,1812,1469,5618,7087,22,10527,8.6614529703,3.4907813128,2.8299987574,10.822963253,13.652962011,248523
20073,"Greenwood","Kansas","US","2020-05-24 02:32:43",37.8774388,-96.23250453,3,0,0,3,"Greenwood, Kansas, US",5982,-29,56,71,-15,0,-14,-14,0,90,11.84024014,-2.501459185,0,-2.334695239,-2.334695239,2070
45047,"Greenwood","South Carolina","US","2020-05-24 02:32:43",34.15272415,-82.12715789,82,1,0,81,"Greenwood, South Carolina, US",70811,214,811,803,8,76,132,208,-2,2607,11.357207513,0.113147771,1.0749038244,1.8669382213,2.9418420457,28880
40055,"Greer","Oklahoma","US","2020-05-24 02:32:43",34.93535801,-99.5605612,66,7,0,59,"Greer, Oklahoma, US",5712,-102,52,54,-2,-2,-99,-101,1,1134,9.3701197293,-0.347041471,-0.347041471,-17.17855284,-17.52559431,1643
48183,"Gregg","Texas","US","2020-05-24 02:32:43",32.47940482,-94.81591935,180,4,0,176,"Gregg, Texas, US",123945,694,1625,1307,318,23,356,379,-3,4069,10.574604767,2.572857166,0.1860871535,2.8803055066,3.0663926601,75739
28043,"Grenada","Mississippi","US","2020-05-24 02:32:43",33.77036166,-89.80245083,72,2,0,70,"Grenada, Mississippi, US",20758,-226,247,288,-41,-3,-182,-185,0,228,13.799051315,-1.964448278,-0.143740118,-8.720233817,-8.863973935,9316
38039,"Griggs","North Dakota","US","2020-05-24 02:32:43",47.45785838,-98.23850925,1,0,0,1,"Griggs, North Dakota, US",2231,3,22,31,-9,0,12,12,0,40,13.904462884,-4.036779547,0,5.3823727293,5.3823727293,1173
48185,"Grimes","Texas","US","2020-05-24 02:32:43",30.54579585,-95.98902499,91,1,0,90,"Grimes, Texas, US",28880,589,306,246,60,11,518,529,0,2913,8.6057616624,2.0989662591,0.3848104808,18.12107537,18.505885851,7445
17063,"Grundy","Illinois","US","2020-05-24 02:32:43",41.28569601,-88.41905692,87,2,0,85,"Grundy, Illinois, US",51054,81,576,405,171,8,-99,-91,1,254,7.9390749507,3.3520538681,0.1568212336,-1.940662766,-1.783841532,18497
19075,"Grundy","Iowa","US","2020-05-24 02:32:43",42.40183723,-92.78829551,19,0,0,19,"Grundy, Iowa, US",12232,-40,124,134,-10,0,-29,-29,-1,152,10.936989879,-0.816193275,0,-2.366960496,-2.366960496,4087
47061,"Grundy","Tennessee","US","2020-05-24 02:32:43",35.38433717,-85.72142731,31,1,0,30,"Grundy, Tennessee, US",13427,79,158,177,-19,0,97,97,1,219,13.221288515,-1.41923436,0,7.2455648926,7.2455648926,2725
35019,"Guadalupe","New Mexico","US","2020-05-24 02:32:43",34.86319296,-104.790669,19,0,0,19,"Guadalupe, New Mexico, US",4300,-34,41,43,-2,0,-32,-32,0,576,9.9606208015,-0.463284688,0,-7.412555015,-7.412555015,1280
48187,"Guadalupe","Texas","US","2020-05-24 02:32:43",29.58165339,-97.94786822,116,0,0,116,"Guadalupe, Texas, US",166847,3571,1840,1158,682,21,2866,2887,2,1888,7.0155669251,4.1317933013,0.1272253069,17.363225222,17.490450529,41057
39059,"Guernsey","Ohio","US","2020-05-24 02:32:43",40.05026529,-81.49248905,30,0,0,30,"Guernsey, Ohio, US",38875,-136,426,462,-36,-1,-97,-98,-2,510,11.863492797,-0.92442801,-0.025678556,-2.490819916,-2.516498472,15886
37081,"Guilford","North Carolina","US","2020-05-24 02:32:43",36.07959451,-79.78824948,1033,52,0,981,"Guilford, North Carolina, US",537174,4567,6111,4602,1509,1132,1947,3079,-21,20255,8.6036300888,2.8211381582,2.116321004,3.6399973453,5.7563183493,280078
12045,"Gulf","Florida","US","2020-05-24 02:32:43",29.93543004,-85.2427099,1,0,0,1,"Gulf, Florida, US",13639,-2507,112,186,-74,-2,-2461,-2463,30,399,12.489508142,-4.968944099,-0.134295786,-165.2509653,-165.385261,4524
8051,"Gunnison","Colorado","US","2020-05-24 02:32:43",38.66611652,-107.0320729,178,6,0,172,"Gunnison, Colorado, US",17462,295,130,70,60,7,226,233,2,1019,4.0428542551,3.4653036472,0.4042854255,13.052643738,13.456929163,9600
19077,"Guthrie","Iowa","US","2020-05-24 02:32:43",41.68378965,-94.50111014,42,3,0,39,"Guthrie, Iowa, US",10689,-31,112,117,-5,5,-30,-25,-1,168,10.929982718,-0.467093279,0.4670932785,-2.802559671,-2.335466393,3608
13135,"Gwinnett","Georgia","US","2020-05-24 02:32:43",33.96044201,-84.02137802,2997,121,0,2876,"Gwinnett, Georgia, US",936250,8913,11368,4729,6639,2348,-59,2289,-15,4947,5.0751588201,7.1249692126,2.5198716239,-0.06331875,2.4565528736,354476
13137,"Habersham","Georgia","US","2020-05-24 02:32:43",34.63331566,-83.53094677,488,19,0,469,"Habersham, Georgia, US",45328,-45,537,449,88,2,-134,-132,-1,2387,9.9006626167,1.940441671,0.0441009471,-2.954763454,-2.910662506,15853
1065,"Hale","Alabama","US","2020-05-24 02:32:43",32.76039258,-87.63284988,122,3,0,119,"Hale, Alabama, US",14651,-98,190,181,9,-3,-103,-106,-1,221,12.31292517,0.612244898,-0.204081633,-7.006802721,-7.210884354,2639
48189,"Hale","Texas","US","2020-05-24 02:32:43",34.07044901,-101.8268114,50,4,0,46,"Hale, Texas, US",33406,-225,427,299,128,0,-354,-354,1,2686,8.9204469174,3.8187866402,0,-10.5613318,-10.5613318,13889
37083,"Halifax","North Carolina","US","2020-05-24 02:32:43",36.25669272,-77.6556109,147,1,0,146,"Halifax, North Carolina, US",50010,-624,540,706,-166,9,-468,-459,1,1412,14.02964906,-3.298756011,0.1788482175,-9.300107309,-9.121259091,16048
51083,"Halifax","Virginia","US","2020-05-24 02:32:43",36.76654925,-78.93512622,29,0,0,29,"Halifax, Virginia, US",33911,-270,359,506,-147,-6,-115,-121,-2,757,14.862245198,-4.317687834,-0.176232156,-3.377782999,-3.554015156,13199
13139,"Hall","Georgia","US","2020-05-24 02:32:43",34.32207823,-83.81896936,2305,41,0,2264,"Hall, Georgia, US",204441,2903,2586,1600,986,73,1830,1903,14,2962,7.882181098,4.8573941017,0.3596245126,9.0152446309,9.3748691435,84225
31079,"Hall","Nebraska","US","2020-05-24 02:32:43",40.87257079,-98.50218293,1460,39,0,1421,"Hall, Nebraska, US",61353,67,953,523,430,208,-572,-364,1,1011,8.5290975954,7.0124511778,3.392069407,-9.328190869,-5.936121462,35317
48191,"Hall","Texas","US","2020-05-24 02:32:43",34.5307555,-100.6813852,1,0,0,1,"Hall, Texas, US",2964,-61,24,27,-3,-1,-57,-58,0,44,9.0165303056,-1.001836701,-0.333945567,-19.03489731,-19.36884288,1255
47063,"Hamblen","Tennessee","US","2020-05-24 02:32:43",36.21990035,-83.26586179,25,2,0,23,"Hamblen, Tennessee, US",64934,305,780,724,56,59,194,253,-4,1020,11.176030194,0.8644443244,0.9107538418,2.9946821238,3.9054359655,29940
12047,"Hamilton","Florida","US","2020-05-24 02:32:43",30.49673973,-82.94998918,161,0,0,161,"Hamilton, Florida, US",14428,166,164,129,35,-2,132,130,1,2707,8.9926803764,2.4398745207,-0.139421401,9.2018124782,9.062391077,3408
17065,"Hamilton","Illinois","US","2020-05-24 02:32:43",38.08163641,-88.53883373,2,0,0,2,"Hamilton, Illinois, US",8116,-32,78,102,-24,0,-7,-7,-1,117,12.543039843,-2.951303492,0,-0.860796852,-0.860796852,2300
18057,"Hamilton","Indiana","US","2020-05-24 02:32:43",40.07306535,-86.05244729,1092,91,0,1001,"Hamilton, Indiana, US",338011,7700,3832,1891,1941,792,4962,5754,5,1868,5.6589488301,5.8085773026,2.3701150044,14.849129611,17.219244616,127933
19079,"Hamilton","Iowa","US","2020-05-24 02:32:43",42.38382428,-93.70197703,19,0,0,19,"Hamilton, Iowa, US",14773,-113,170,178,-8,1,-107,-106,1,199,12.003101925,-0.539465255,0.0674331569,-7.215347787,-7.14791463,6654
20075,"Hamilton","Kansas","US","2020-05-24 02:32:43",37.99978709,-101.7921066,10,0,0,10,"Hamilton, Kansas, US",2539,-61,29,17,12,15,-88,-73,0,0,6.616073166,4.6701692936,5.837711617,-34.24790815,-28.41019654,1310
31081,"Hamilton","Nebraska","US","2020-05-24 02:32:43",40.87349452,-98.02099117,54,10,0,44,"Hamilton, Nebraska, US",9324,64,106,84,22,-1,45,44,-2,122,9.0400344382,2.3676280672,-0.107619458,4.8428755919,4.7352561343,3948
36041,"Hamilton","New York","US","2020-05-24 02:32:43",43.66146647,-74.49721957,5,0,0,5,"Hamilton, New York, US",4416,-16,28,63,-35,-2,20,18,1,80,14.240506329,-7.911392405,-0.452079566,4.52079566,4.068716094,1453
39061,"Hamilton","Ohio","US","2020-05-24 02:32:43",39.19673558,-84.54502924,2349,128,0,2221,"Hamilton, Ohio, US",817473,2028,10671,7868,2803,1071,-1811,-740,-35,23838,9.6367361986,3.4331178908,1.3117621338,-2.218115055,-0.906352922,497491
47065,"Hamilton","Tennessee","US","2020-05-24 02:32:43",35.17670231,-85.16652245,511,14,0,497,"Hamilton, Tennessee, US",367804,3511,4213,3718,495,411,2595,3006,10,9914,10.157123988,1.3522798208,1.1228020331,7.0892245153,8.2120265484,202284
48193,"Hamilton","Texas","US","2020-05-24 02:32:43",31.70470573,-98.11083887,7,0,0,7,"Hamilton, Texas, US",8461,-16,91,116,-25,6,4,10,-1,216,13.697012634,-2.951942378,0.7084661707,0.4723107805,1.1807769512,2966
46057,"Hamlin","South Dakota","US","2020-05-24 02:32:43",44.67385954,-97.18829593,3,0,0,3,"Hamlin, South Dakota, US",6164,94,119,55,64,0,31,31,-1,245,8.991335622,10.462645087,0,5.0678437142,5.0678437142,2159
25013,"Hampden","Massachusetts","US","2020-05-24 02:32:43",42.13440424,-72.63235561,5621,541,0,5080,"Hampden, Massachusetts, US",466372,-2016,4972,4536,436,367,-2820,-2453,1,14610,9.7051649621,0.9328597715,0.7852282939,-6.033634302,-5.248406008,203183
25015,"Hampshire","Massachusetts","US","2020-05-24 02:32:43",42.33997957,-72.65898478,819,77,0,742,"Hampshire, Massachusetts, US",160830,-309,976,1306,-330,490,-469,21,0,22572,8.1125822672,-2.04988679,3.0437712948,-2.913323954,0.1304473412,76536
54027,"Hampshire","West Virginia","US","2020-05-24 02:32:43",39.32103553,-78.60826476,13,1,0,12,"Hampshire, West Virginia, US",23175,-182,205,260,-55,-8,-118,-126,-1,415,11.175105304,-2.363964584,-0.343849394,-5.071778561,-5.415627955,4662
45049,"Hampton","South Carolina","US","2020-05-24 02:32:43",32.77419582,-81.13845571,31,0,0,31,"Hampton, South Carolina, US",19222,-126,196,239,-43,1,-84,-83,0,1367,12.393051595,-2.229712212,0.0518537724,-4.355716878,-4.303863106,6623
51650,"Hampton","Virginia","US","2020-05-24 02:32:43",37.03513786,-76.35879121,172,3,0,169,"Hampton, Virginia, US",134510,180,1686,1307,379,70,-264,-194,-5,4965,9.7232554679,2.8195209046,0.5207558399,-1.963993453,-1.443237613,64911
13141,"Hancock","Georgia","US","2020-05-24 02:32:43",33.2721566,-82.99766919,176,17,0,159,"Hancock, Georgia, US",8457,89,49,120,-71,4,155,159,1,1301,14.26448737,-8.439821694,0.4754829123,18.424962853,18.900445765,1180
17067,"Hancock","Illinois","US","2020-05-24 02:32:43",40.40423981,-91.16313899,13,0,0,13,"Hancock, Illinois, US",17708,-120,178,198,-20,2,-102,-100,0,223,11.143628996,-1.12561909,0.112561909,-5.740657362,-5.628095452,4799
18059,"Hancock","Indiana","US","2020-05-24 02:32:43",39.82304555,-85.77566351,315,27,0,288,"Hancock, Indiana, US",78168,1690,846,631,215,18,1457,1475,0,649,8.16057318,2.780543952,0.2327897262,18.843035061,19.075824787,21728
19081,"Hancock","Iowa","US","2020-05-24 02:32:43",43.08178477,-93.73454884,12,0,0,12,"Hancock, Iowa, US",10630,-80,115,130,-15,1,-66,-65,0,181,12.183692596,-1.405810684,0.0937207123,-6.18556701,-6.091846298,5412
21091,"Hancock","Kentucky","US","2020-05-24 02:32:43",37.83766422,-86.78280584,6,0,0,6,"Hancock, Kentucky, US",8722,-16,106,77,29,0,-47,-47,2,90,8.8201603666,3.3218785796,0,-5.38373425,-5.38373425,4648
23009,"Hancock","Maine","US","2020-05-24 02:32:43",44.59816444,-68.38401854,11,1,0,10,"Hancock, Maine, US",54987,253,448,665,-217,41,432,473,-3,957,12.121654013,-3.955487099,0.7473500971,7.8745180959,8.621868193,25208
28045,"Hancock","Mississippi","US","2020-05-24 02:32:43",30.41830223,-89.48851033,84,11,0,73,"Hancock, Mississippi, US",47632,354,453,473,-20,-22,394,372,2,559,9.9673374776,-0.421451902,-0.463597092,8.3026024655,7.8390053735,17475
39063,"Hancock","Ohio","US","2020-05-24 02:32:43",41.00250487,-83.66838948,48,1,0,47,"Hancock, Ohio, US",75783,-137,881,722,159,98,-394,-296,0,1528,9.5185988412,2.0962011298,1.2919981807,-5.194360032,-3.902361852,45844
47067,"Hancock","Tennessee","US","2020-05-24 02:32:43",36.52692871,-83.22375847,1,0,0,1,"Hancock, Tennessee, US",6620,59,68,93,-25,1,82,83,1,159,14.111220696,-3.793338897,0.1517335559,12.442151582,12.593885138,1302
54029,"Hancock","West Virginia","US","2020-05-24 02:32:43",40.51943859,-80.57461608,15,0,0,15,"Hancock, West Virginia, US",28810,-269,243,440,-197,-12,-59,-71,-1,226,15.201506331,-6.806128971,-0.414586536,-2.038383803,-2.45297034,11775
46059,"Hand","South Dakota","US","2020-05-24 02:32:43",44.54708407,-99.00386459,1,0,0,1,"Hand, South Dakota, US",3191,-49,37,28,9,0,-59,-59,1,61,8.7078214897,2.7989426217,0,-18.34862385,-18.34862385,1655
51085,"Hanover","Virginia","US","2020-05-24 02:32:43",37.7583355,-77.49464673,252,19,0,233,"Hanover, Virginia, US",107766,880,966,907,59,23,806,829,-8,1951,8.4508879489,0.549727,0.2143003559,7.5098298642,7.7241302201,44246
48195,"Hansford","Texas","US","2020-05-24 02:32:43",36.27743284,-101.3545796,18,2,0,16,"Hansford, Texas, US",5399,-71,74,35,39,23,-135,-112,2,69,6.4403348974,7.1763731714,4.2322200754,-24.84129175,-20.60907167,2391
13143,"Haralson","Georgia","US","2020-05-24 02:32:43",33.79602175,-85.21005667,36,2,0,34,"Haralson, Georgia, US",29792,231,350,347,3,-5,235,230,-2,350,11.692753526,0.1010900881,-0.16848348,7.9187235692,7.750240089,8820
12049,"Hardee","Florida","US","2020-05-24 02:32:43",27.49293939,-81.80956574,63,0,0,63,"Hardee, Florida, US",26937,-231,339,193,146,-2,-376,-378,1,1595,7.1342759449,5.3969134091,-0.073930321,-13.89890029,-13.97283061,8679
47069,"Hardeman","Tennessee","US","2020-05-24 02:32:43",35.20772017,-88.99161161,188,0,0,188,"Hardeman, Tennessee, US",25050,-226,218,289,-71,0,-155,-155,0,3853,11.485117037,-2.821603147,0,-6.159837857,-6.159837857,7069
17069,"Hardin","Illinois","US","2020-05-24 02:32:43",37.51810645,-88.26873022,1,0,0,1,"Hardin, Illinois, US",3821,-72,31,65,-34,0,-38,-38,0,17,16.852476018,-8.815141302,0,-9.852216749,-9.852216749,1111
19083,"Hardin","Iowa","US","2020-05-24 02:32:43",42.38353877,-93.23654611,13,0,0,13,"Hardin, Iowa, US",16846,-91,169,210,-41,10,-58,-48,-2,813,12.432288429,-2.427256312,0.5920137347,-3.433679661,-2.841665927,7976
21093,"Hardin","Kentucky","US","2020-05-24 02:32:43",37.6976111,-85.96319251,96,2,0,94,"Hardin, Kentucky, US",110958,679,1443,972,471,-59,271,212,-4,3250,8.7869569737,4.257877299,-0.533364672,2.4498614608,1.9164967885,55397
39065,"Hardin","Ohio","US","2020-05-24 02:32:43",40.66015414,-83.65929931,38,0,0,38,"Hardin, Ohio, US",31365,-53,374,327,47,-1,-100,-101,1,1892,10.416832582,1.4972205852,-0.031855757,-3.185575713,-3.21743147,10170
47071,"Hardin","Tennessee","US","2020-05-24 02:32:43",35.19732531,-88.18593755,11,2,0,9,"Hardin, Tennessee, US",25652,-41,237,356,-119,13,67,80,-2,371,13.866978284,-4.635310157,0.5063784205,2.6097964748,3.1161748953,8621
48199,"Hardin","Texas","US","2020-05-24 02:32:43",30.33364686,-94.38931817,121,4,0,117,"Hardin, Texas, US",57602,495,661,595,66,-3,434,431,-2,423,10.374077012,1.1507379543,-0.052306271,7.5669738207,7.5146675501,12400
35021,"Harding","New Mexico","US","2020-05-24 02:32:43",35.85751555,-103.8220938,1,0,0,1,"Harding, New Mexico, US",625,-25,2,9,-7,0,-18,-18,0,0,14.117647059,-10.98039216,0,-28.23529412,-28.23529412,242
54031,"Hardy","West Virginia","US","2020-05-24 02:32:43",39.00683177,-78.85855301,35,0,0,35,"Hardy, West Virginia, US",13776,12,147,162,-15,7,21,28,-1,58,11.764705882,-1.089324619,0.5083514887,1.5250544662,2.033405955,5989
24025,"Harford","Maryland","US","2020-05-24 02:32:43",39.55010644,-76.3077594,764,46,0,718,"Harford, Maryland, US",255441,1559,2601,2250,351,136,1096,1232,-24,2752,8.8352577834,1.3783002142,0.5340422482,4.3037522358,4.8377944841,98565
21095,"Harlan","Kentucky","US","2020-05-24 02:32:43",36.85699301,-83.21899516,1,0,0,1,"Harlan, Kentucky, US",26010,-299,298,400,-102,0,-197,-197,0,627,15.290812133,-3.899157094,0,-7.530724976,-7.530724976,8151
31083,"Harlan","Nebraska","US","2020-05-24 02:32:43",40.17658508,-99.40438879,1,0,0,1,"Harlan, Nebraska, US",3380,-6,31,39,-8,0,3,3,-1,45,11.528229382,-2.364765001,0,0.8867868756,0.8867868756,1324
37085,"Harnett","North Carolina","US","2020-05-24 02:32:43",35.36731853,-78.87243571,269,21,0,248,"Harnett, North Carolina, US",135976,1640,1873,1105,768,29,836,865,7,3301,8.1757376661,5.6823226494,0.2145668709,6.1854449673,6.4000118382,26812
41025,"Harney","Oregon","US","2020-05-24 02:32:43",43.06422669,-118.9666306,1,0,0,1,"Harney, Oregon, US",7393,101,63,78,-15,5,110,115,1,140,10.62308478,-2.042900919,0.6809669731,14.981273408,15.662240381,2887
20077,"Harper","Kansas","US","2020-05-24 02:32:43",37.19175361,-98.07578384,1,0,0,1,"Harper, Kansas, US",5436,-72,57,91,-34,2,-40,-38,0,129,16.630116959,-6.213450292,0.365497076,-7.30994152,-6.944444444,2842
40059,"Harper","Oklahoma","US","2020-05-24 02:32:43",36.78836519,-99.6679804,1,0,0,1,"Harper, Oklahoma, US",3688,-39,39,52,-13,20,-45,-25,-1,41,14.025623736,-3.506405934,5.3944706676,-12.137559,-6.743088334,1591
13145,"Harris","Georgia","US","2020-05-24 02:32:43",32.73709786,-84.90538572,80,4,0,76,"Harris, Georgia, US",35236,676,307,332,-25,-2,707,705,-4,456,9.5134391656,-0.716373431,-0.057309874,20.259040633,20.201730758,5838
48201,"Harris","Texas","US","2020-05-24 02:32:43",29.86,-95.39,10770,219,0,10551,"Harris, Texas, US",4713325,33280,66937,28172,38765,24889,-30449,-5560,75,48227,5.9982732502,8.2536938287,5.2992695912,-6.483083281,-1.18381369,2348073
18061,"Harrison","Indiana","US","2020-05-24 02:32:43",38.19467379,-86.10948271,183,21,0,162,"Harrison, Indiana, US",40515,301,426,368,58,20,224,244,-1,461,9.1169220478,1.4369061923,0.4954848939,5.5494308117,6.0449157056,11273
19085,"Harrison","Iowa","US","2020-05-24 02:32:43",41.68330137,-95.81558439,18,0,0,18,"Harrison, Iowa, US",14049,-56,154,181,-27,-1,-28,-29,0,278,12.857853236,-1.918022306,-0.071037863,-1.989060169,-2.060098032,4596
21097,"Harrison","Kentucky","US","2020-05-24 02:32:43",38.44188174,-84.32869741,18,0,0,18,"Harrison, Kentucky, US",18886,106,234,218,16,-2,94,92,-2,275,11.575426114,0.8495725588,-0.10619657,4.991238783,4.8850422131,4918
28047,"Harrison","Mississippi","US","2020-05-24 02:32:43",30.51359752,-89.12467576,231,6,0,225,"Harrison, Mississippi, US",208080,1796,2597,2013,584,120,1088,1208,4,5171,9.7160950276,2.818777693,0.5792008958,5.2514214555,5.8306223514,98787
29081,"Harrison","Missouri","US","2020-05-24 02:32:43",40.35570088,-93.99222144,8,0,0,8,"Harrison, Missouri, US",8352,-42,86,114,-28,-3,-10,-13,-1,145,13.615191688,-3.344082169,-0.358294518,-1.19431506,-1.552609578,3424
39067,"Harrison","Ohio","US","2020-05-24 02:32:43",40.29380509,-81.09068544,10,0,0,10,"Harrison, Ohio, US",15040,-127,144,203,-59,1,-69,-68,0,232,13.44059324,-3.906379316,0.0662098189,-4.568477505,-4.502267686,5185
48203,"Harrison","Texas","US","2020-05-24 02:32:43",32.54935988,-94.36934071,217,22,0,195,"Harrison, Texas, US",66553,-31,725,701,24,40,-93,-53,-2,1229,10.53050617,0.3605308817,0.6008848029,-1.397057167,-0.796172364,23370
54033,"Harrison","West Virginia","US","2020-05-24 02:32:43",39.2853852,-80.37919577,38,1,0,37,"Harrison, West Virginia, US",67256,-238,696,877,-181,-5,-47,-52,-5,882,13.016697588,-2.686456401,-0.074211503,-0.697588126,-0.771799629,36540
51660,"Harrisonburg","Virginia","US","2020-05-24 02:32:43",38.43542574,-78.87536254,709,21,0,688,"Harrisonburg, Virginia, US",53016,-472,580,283,297,219,-994,-775,6,7688,5.3143543904,5.5772553144,4.1125215954,-18.6659656,-14.553444,32688
13147,"Hart","Georgia","US","2020-05-24 02:32:43",34.34626973,-82.96567682,26,0,0,26,"Hart, Georgia, US",26205,134,249,312,-63,-2,199,197,0,662,11.936643967,-2.410283878,-0.076516949,7.6134363762,7.5369194277,7044
21099,"Hart","Kentucky","US","2020-05-24 02:32:43",37.29943898,-85.88461055,20,0,0,20,"Hart, Kentucky, US",19035,133,276,191,85,0,47,47,1,227,10.069325461,4.4811134249,0,2.4777921291,2.4777921291,5378
9003,"Hartford","Connecticut","US","2020-05-24 02:32:43",41.80283011,-72.73103891,9545,1169,0,8376,"Hartford, Connecticut, US",891720,-860,9126,8275,851,3454,-5188,-1734,23,25022,9.2753460741,0.9538754694,3.8715462646,-5.815165611,-1.943619347,502938
48205,"Hartley","Texas","US","2020-05-24 02:32:43",35.84008013,-102.6029022,11,2,0,9,"Hartley, Texas, US",5576,-35,64,25,39,13,-85,-72,-2,1134,4.469473496,6.9723786538,2.3241262179,-15.19620989,-12.87208367,2339
20079,"Harvey","Kansas","US","2020-05-24 02:32:43",38.04293782,-97.42747573,11,0,0,11,"Harvey, Kansas, US",34429,246,372,332,40,37,172,209,-3,1317,9.6776074156,1.1659767971,1.0785285373,5.0137002274,6.0922287646,15049
20081,"Haskell","Kansas","US","2020-05-24 02:32:43",37.5620394,-100.8710738,17,0,0,17,"Haskell, Kansas, US",3968,-22,49,21,28,3,-53,-50,0,33,5.2777079668,7.0369439558,0.753958281,-13.31992963,-12.56597135,2080
40061,"Haskell","Oklahoma","US","2020-05-24 02:32:43",35.222576,-95.11513306,6,0,0,6,"Haskell, Oklahoma, US",12627,-9,120,136,-16,6,3,9,-2,78,10.766733959,-1.266674583,0.4750029688,0.2375014844,0.7125044532,3913
48207,"Haskell","Texas","US","2020-05-24 02:32:43",33.17823584,-99.73037358,2,0,0,2,"Haskell, Texas, US",5658,-41,42,66,-24,36,-52,-16,-1,526,11.622787708,-4.226468257,6.3397023862,-9.157347891,-2.817645505,2004
15001,"Hawaii","Hawaii","US","2020-05-24 02:32:43",19.60121157,-155.5210167,81,0,0,81,"Hawaii, Hawaii, US",201513,4,2237,2003,234,427,-643,-216,-14,3741,9.9399040251,1.1612269305,2.1189910228,-3.190892805,-1.071901782,79833
47073,"Hawkins","Tennessee","US","2020-05-24 02:32:43",36.44355426,-82.94885298,31,2,0,29,"Hawkins, Tennessee, US",56786,73,511,731,-220,15,280,295,-2,561,12.881170759,-3.876686138,0.2643195094,4.9339641759,5.1982836853,12778
48209,"Hays","Texas","US","2020-05-24 02:32:43",30.05669873,-98.02944344,250,3,0,247,"Hays, Texas, US",230191,7485,2638,1147,1491,212,5751,5963,31,7674,5.0651693431,6.5842785446,0.9361952055,25.396502958,26.332698163,65919
37087,"Haywood","North Carolina","US","2020-05-24 02:32:43",35.55269063,-82.98196486,39,0,0,39,"Haywood, North Carolina, US",62317,427,587,766,-179,-23,630,607,-1,683,12.334248472,-2.882285217,-0.370349497,10.144355793,9.7740062959,19958
47075,"Haywood","Tennessee","US","2020-05-24 02:32:43",35.58332824,-89.28536625,29,2,0,27,"Haywood, Tennessee, US",17304,-43,189,233,-44,-1,2,1,0,236,13.448385328,-2.539609246,-0.057718392,0.1154367839,0.057718392,5193
13149,"Heard","Georgia","US","2020-05-24 02:32:43",33.29686567,-85.12886832,26,2,0,24,"Heard, Georgia, US",11923,52,125,128,-3,-2,57,55,0,130,10.759014878,-0.252164411,-0.168109607,4.7911238127,4.6230142053,2002
48211,"Hemphill","Texas","US","2020-05-24 02:32:43",35.83764858,-100.2703577,1,0,0,1,"Hemphill, Texas, US",3819,-26,43,20,23,1,-49,-48,-1,37,5.2192066806,6.0020876827,0.260960334,-12.78705637,-12.52609603,2643
5057,"Hempstead","Arkansas","US","2020-05-24 02:32:43",33.73325583,-93.66935133,13,1,0,12,"Hempstead, Arkansas, US",21532,-153,291,233,58,-13,-199,-212,1,301,10.782793808,2.6841289307,-0.601615105,-9.209338918,-9.810954023,9049
17071,"Henderson","Illinois","US","2020-05-24 02:32:43",40.81908672,-90.92491462,8,0,0,8,"Henderson, Illinois, US",6646,-51,63,95,-32,1,-18,-17,-2,51,14.239676235,-4.796522521,0.1498913288,-2.698043918,-2.548152589,1471
21101,"Henderson","Kentucky","US","2020-05-24 02:32:43",37.79344553,-87.57392021,95,3,0,92,"Henderson, Kentucky, US",45210,-302,521,520,1,-5,-297,-302,-1,1164,11.463592072,0.0220453694,-0.110226847,-6.547474703,-6.65770155,19000
37089,"Henderson","North Carolina","US","2020-05-24 02:32:43",35.33788927,-82.4766782,313,42,0,271,"Henderson, North Carolina, US",117417,917,1066,1426,-360,-20,1296,1276,1,1249,12.192358828,-3.078014851,-0.171000825,11.080853465,10.90985264,39794
47077,"Henderson","Tennessee","US","2020-05-24 02:32:43",35.65581134,-88.38600175,12,0,0,12,"Henderson, Tennessee, US",28117,134,305,309,-4,-3,143,140,-2,378,11.016042781,-0.142602496,-0.106951872,5.0980392157,4.991087344,9243
48213,"Henderson","Texas","US","2020-05-24 02:32:43",32.21128872,-95.85846587,51,0,0,51,"Henderson, Texas, US",82737,634,894,1105,-211,9,836,845,0,1254,13.406940063,-2.560058238,0.1091967969,10.143169134,10.252365931,21055
18063,"Hendricks","Indiana","US","2020-05-24 02:32:43",39.76719009,-86.51037283,1103,65,0,1038,"Hendricks, Indiana, US",170311,3403,1731,1139,592,273,2539,2812,-1,4067,6.7552540041,3.5110714402,1.61912585,15.058463491,16.677589341,58425
12051,"Hendry","Florida","US","2020-05-24 02:32:43",26.55386945,-81.16469006,249,12,0,237,"Hendry, Florida, US",42022,686,576,356,220,341,126,467,-1,696,8.5414717244,5.2784375825,8.1815782528,3.0231051609,11.204683414,14566
27053,"Hennepin","Minnesota","US","2020-05-24 02:32:43",45.00761521,-93.47694895,6649,524,0,6125,"Hennepin, Minnesota, US",1265843,7918,16008,8750,7258,3649,-2922,727,-67,25922,6.9340763493,5.7517172735,2.8917079541,-2.315585268,0.5761226864,863170
51087,"Henrico","Virginia","US","2020-05-24 02:32:43",37.53460572,-77.39326555,1411,118,0,1293,"Henrico, Virginia, US",330818,1825,3862,2832,1030,918,-113,805,-10,2751,8.5842764064,3.1221061789,2.7826150216,-0.342522328,2.4400926932,168351
1067,"Henry","Alabama","US","2020-05-24 02:32:43",31.51148016,-85.24267944,52,1,0,51,"Henry, Alabama, US",17205,32,167,213,-46,-1,79,78,0,199,12.39164582,-2.676130083,-0.058176741,4.5959625342,4.5377857932,4181
13151,"Henry","Georgia","US","2020-05-24 02:32:43",33.4533428,-84.1481466,626,19,0,607,"Henry, Georgia, US",234561,4833,2602,1679,923,26,3894,3920,-10,982,7.2325642003,3.9759718624,0.1119992074,16.774035138,16.886034345,60065
17073,"Henry","Illinois","US","2020-05-24 02:32:43",41.3533994,-90.13296166,66,0,0,66,"Henry, Illinois, US",48913,-156,479,543,-64,-1,-88,-89,-3,722,11.083668429,-1.306362393,-0.020411912,-1.796248291,-1.816660203,15145
18065,"Henry","Indiana","US","2020-05-24 02:32:43",39.93029017,-85.39625719,155,6,0,149,"Henry, Indiana, US",47972,-159,448,549,-101,4,-60,-56,-2,3558,11.425241668,-2.101911491,0.0832440194,-1.248660292,-1.165416272,13572
19087,"Henry","Iowa","US","2020-05-24 02:32:43",40.98767962,-91.54436349,57,1,0,56,"Henry, Iowa, US",19954,-79,215,183,32,6,-117,-111,0,1654,9.1529747168,1.6005201691,0.3000975317,-5.851901868,-5.551804336,8822
21103,"Henry","Kentucky","US","2020-05-24 02:32:43",38.44942688,-85.11587507,14,0,0,14,"Henry, Kentucky, US",16126,65,181,166,15,0,51,51,-1,80,10.314723336,0.9320533134,0,3.1689812657,3.1689812657,3518
29083,"Henry","Missouri","US","2020-05-24 02:32:43",38.38482826,-93.79293734,9,3,0,6,"Henry, Missouri, US",21824,16,236,290,-54,-6,76,70,0,233,13.292995966,-2.475247525,-0.275027503,3.4836817015,3.2086541988,8539
39069,"Henry","Ohio","US","2020-05-24 02:32:43",41.3339642,-84.06830637,14,0,0,14,"Henry, Ohio, US",27006,-85,313,262,51,0,-137,-137,1,346,9.6863042313,1.8855019687,0,-5.064975877,-5.064975877,10729
47079,"Henry","Tennessee","US","2020-05-24 02:32:43",36.33160906,-88.30121797,29,0,0,29,"Henry, Tennessee, US",32345,9,300,481,-181,-5,197,192,-2,499,14.872992069,-5.596697639,-0.154604907,6.0914333421,5.9368284349,12130
51089,"Henry","Virginia","US","2020-05-24 02:32:43",36.68542395,-79.87634026,63,2,0,61,"Henry, Virginia, US",50557,-493,400,744,-344,-4,-143,-147,-2,562,14.644660309,-6.771187025,-0.078734733,-2.814766699,-2.893501432,16743
36043,"Herkimer","New York","US","2020-05-24 02:32:43",43.42034246,-74.96145307,100,3,0,97,"Herkimer, New York, US",61319,-394,560,659,-99,2,-297,-295,0,1383,10.712660121,-1.609337408,0.0325118668,-4.828012224,-4.795500358,18739
12053,"Hernando","Florida","US","2020-05-24 02:32:43",28.55364461,-82.42700204,109,5,0,104,"Hernando, Florida, US",193920,3338,1597,2850,-1253,50,4530,4580,11,1833,14.824370224,-6.517521365,0.2600766706,23.562946357,23.823023027,43480
37091,"Hertford","North Carolina","US","2020-05-24 02:32:43",36.3607755,-76.98104134,65,1,0,64,"Hertford, North Carolina, US",23677,-201,224,287,-63,36,-174,-138,0,2687,12.070234465,-2.649563663,1.5140363789,-7.317842498,-5.803806119,9298
21105,"Hickman","Kentucky","US","2020-05-24 02:32:43",36.6794808,-88.97875928,5,0,0,5,"Hickman, Kentucky, US",4380,-51,35,63,-28,0,-24,-24,1,212,14.300306435,-6.355691749,0,-5.447735785,-5.447735785,1634
47081,"Hickman","Tennessee","US","2020-05-24 02:32:43",35.80609681,-87.47643507,54,0,0,54,"Hickman, Tennessee, US",25178,171,255,283,-28,-7,207,200,-1,1534,11.2782704,-1.115871276,-0.278967819,8.2494769353,7.9705091163,4347
35023,"Hidalgo","New Mexico","US","2020-05-24 02:32:43",31.91383467,-108.7151824,1,0,0,1,"Hidalgo, New Mexico, US",4198,-33,41,51,-10,1,-24,-23,0,64,12.101079606,-2.372760707,0.2372760707,-5.694625697,-5.457349626,1872
48215,"Hidalgo","Texas","US","2020-05-24 02:32:43",26.39418217,-98.18299696,482,10,0,472,"Hidalgo, Texas, US",868707,6409,14054,4597,9457,-18,-3038,-3056,8,7404,5.3113653629,10.926600443,-0.020797167,-3.510099624,-3.530896791,279551
39071,"Highland","Ohio","US","2020-05-24 02:32:43",39.1839264,-83.60331456,18,1,0,17,"Highland, Ohio, US",43161,109,530,482,48,-1,65,64,-3,484,11.181608342,1.1135211627,-0.023198358,1.5078932412,1.4846948836,11748
51091,"Highland","Virginia","US","2020-05-24 02:32:43",38.35799465,-79.56124594,3,0,0,3,"Highland, Virginia, US",2190,-18,17,31,-14,0,-4,-4,0,0,14.097316962,-6.366530241,0,-1.81900864,-1.81900864,898
12055,"Highlands","Florida","US","2020-05-24 02:32:43",27.34254618,-81.34071957,112,8,0,104,"Highlands, Florida, US",106221,1288,854,1627,-773,258,1799,2057,4,1733,15.410553435,-7.32167044,2.4437140665,17.039696146,19.483410212,29640
30041,"Hill","Montana","US","2020-05-24 02:32:43",48.62879827,-110.1129252,1,0,0,1,"Hill, Montana, US",16484,142,289,161,128,7,7,14,0,593,9.8092975081,7.7986961555,0.426491196,0.426491196,0.852982392,7781
48217,"Hill","Texas","US","2020-05-24 02:32:43",31.99045053,-97.13423143,23,1,0,22,"Hill, Texas, US",36649,484,404,427,-23,-4,510,506,1,737,11.728513747,-0.631746642,-0.109868981,14.008295108,13.898426127,10227
12057,"Hillsborough","Florida","US","2020-05-24 02:32:43",27.9276559,-82.32013172,1823,72,0,1751,"Hillsborough, Florida, US",1471968,20049,17267,11696,5571,5266,9183,14449,29,23499,8.0003091775,3.8106807821,3.6020543886,6.2813644987,9.8834188873,662689
33011,"Hillsborough","New Hampshire","US","2020-05-24 02:32:43",42.91537785,-71.7200253,2049,81,0,1968,"Hillsborough, New Hampshire, US",417025,2395,4148,3390,758,1002,650,1652,-15,7541,8.1524189718,1.8228712627,2.4096530412,1.5631481804,3.9728012217,195329
26059,"Hillsdale","Michigan","US","2020-05-24 02:32:43",41.88753639,-84.59312019,168,24,0,144,"Hillsdale, Michigan, US",45605,-97,509,480,29,2,-129,-127,1,1563,10.513980308,0.6352196436,0.0438082513,-2.825632208,-2.781823957,15943
28049,"Hinds","Mississippi","US","2020-05-24 02:32:43",32.2656285,-90.44435448,877,24,0,853,"Hinds, Mississippi, US",231840,-3984,2953,2122,831,187,-5018,-4831,16,8295,9.074891375,3.5538335215,0.7997194567,-21.45985152,-20.66013206,121456
8053,"Hinsdale","Colorado","US","2020-05-24 02:32:43",37.82247444,-107.3004345,3,0,0,3,"Hinsdale, Colorado, US",820,12,2,3,-1,0,13,13,0,56,3.6855036855,-1.228501229,0,15.970515971,15.970515971,411
31087,"Hitchcock","Nebraska","US","2020-05-24 02:32:43",40.17609175,-101.0416477,1,0,0,1,"Hitchcock, Nebraska, US",2762,-39,20,37,-17,0,-22,-22,0,26,13.302175085,-6.111810174,0,-7.909401402,-7.909401402,921
39073,"Hocking","Ohio","US","2020-05-24 02:32:43",39.49537927,-82.47991446,64,3,0,61,"Hocking, Ohio, US",28264,-93,289,331,-42,3,-52,-49,-2,310,11.691775136,-1.483548507,0.1059677505,-1.836774342,-1.730806591,8049
48219,"Hockley","Texas","US","2020-05-24 02:32:43",33.60771256,-102.3431676,27,1,0,26,"Hockley, Texas, US",23021,50,306,201,105,-1,-54,-55,0,775,8.7406505479,4.5660114803,-0.043485824,-2.348234476,-2.391720299,10145
20083,"Hodgeman","Kansas","US","2020-05-24 02:32:43",38.08780079,-99.89829881,1,0,0,1,"Hodgeman, Kansas, US",1794,-28,17,25,-8,6,-27,-21,1,14,13.827433628,-4.424778761,3.3185840708,-14.93362832,-11.61504425,850
37093,"Hoke","North Carolina","US","2020-05-24 02:32:43",35.01888303,-79.23651674,187,1,0,186,"Hoke, North Carolina, US",55234,539,847,362,485,4,50,54,0,925,6.5860691901,8.8238772298,0.0727742452,0.9096780649,0.9824523101,9817
12059,"Holmes","Florida","US","2020-05-24 02:32:43",30.86747479,-85.81319222,14,0,0,14,"Holmes, Florida, US",19617,174,198,250,-52,-3,228,225,1,1759,12.800819252,-2.662570405,-0.153609831,11.674347158,11.520737327,3520
28051,"Holmes","Mississippi","US","2020-05-24 02:32:43",33.12345854,-90.08923538,359,23,0,336,"Holmes, Mississippi, US",17010,-434,219,221,-2,0,-431,-431,-1,826,12.828699135,-0.116096825,0,-25.01886573,-25.01886573,3596
39075,"Holmes","Ohio","US","2020-05-24 02:32:43",40.56163713,-81.92635677,22,1,0,21,"Holmes, Ohio, US",43960,41,783,327,456,-2,-415,-417,2,766,7.4420510019,10.377905984,-0.045517132,-9.444804788,-9.49032192,21031
29087,"Holt","Missouri","US","2020-05-24 02:32:43",40.09799248,-95.2163888,1,0,0,1,"Holt, Missouri, US",4403,-9,43,57,-14,0,6,6,-1,101,12.932501418,-3.176403857,0,1.3613159387,1.3613159387,1825
31089,"Holt","Nebraska","US","2020-05-24 02:32:43",42.45522056,-98.78402558,1,0,0,1,"Holt, Nebraska, US",10067,-81,139,120,19,6,-107,-101,1,105,11.872372001,1.8797922335,0.5936186,-10.58619837,-9.992579767,5586
15003,"Honolulu","Hawaii","US","2020-05-24 02:32:43",21.45803166,-157.9712182,414,11,0,403,"Honolulu, Hawaii, US",974563,-5295,12013,8595,3418,3736,-12427,-8691,-22,35133,8.7954437657,3.4977110868,3.8231271563,-12.71680974,-8.893682579,486682
48221,"Hood","Texas","US","2020-05-24 02:32:43",32.42990927,-97.83242024,23,3,0,20,"Hood, Texas, US",61643,1466,627,736,-109,2,1565,1567,8,677,12.08340174,-1.789525529,0.0328353308,25.693646363,25.726481694,17862
41027,"Hood River","Oregon","US","2020-05-24 02:32:43",45.51872811,-121.6552036,12,0,0,12,"Hood River, Oregon, US",23382,115,250,171,79,1,35,36,0,790,7.331346867,3.3869965058,0.0428733735,1.5005680722,1.5434414457,12203
31091,"Hooker","Nebraska","US","2020-05-24 02:32:43",41.91586243,-101.1354293,0,0,0,0,"Hooker, Nebraska, US",682,6,6,7,-1,0,7,7,0,23,10.309278351,-1.47275405,0,10.309278351,10.309278351,421
51670,"Hopewell","Virginia","US","2020-05-24 02:32:43",37.29186313,-77.29754684,67,0,0,67,"Hopewell, Virginia, US",22529,51,347,296,51,27,-25,2,-2,237,13.153509454,2.2663141289,1.1998133624,-1.110938298,0.0888750639,7624
21107,"Hopkins","Kentucky","US","2020-05-24 02:32:43",37.30939025,-87.54670406,218,28,0,190,"Hopkins, Kentucky, US",44686,-338,525,545,-20,7,-325,-318,0,1084,12.150261955,-0.445881173,0.1560584104,-7.245569056,-7.089510645,18576
48223,"Hopkins","Texas","US","2020-05-24 02:32:43",33.14875072,-95.56351139,12,0,0,12,"Hopkins, Texas, US",37084,346,444,386,58,-9,296,287,1,432,10.457587169,1.5713472948,-0.243829753,8.0192896427,7.77545989,13147
45051,"Horry","South Carolina","US","2020-05-24 02:32:43",33.9212828,-78.99555293,371,21,0,350,"Horry, South Carolina, US",354081,9976,3161,3879,-718,293,10315,10608,86,3746,11.111652196,-2.056758514,0.8393178895,29.548000103,30.387317993,128131
5059,"Hot Spring","Arkansas","US","2020-05-24 02:32:43",34.31709259,-92.95396325,29,0,0,29,"Hot Spring, Arkansas, US",33771,99,361,379,-18,-1,119,118,-1,2332,11.239120442,-0.533784084,-0.029654671,3.5289058909,3.4992512195,9819
56017,"Hot Springs","Wyoming","US","2020-05-24 02:32:43",43.71930657,-108.4423174,9,0,0,9,"Hot Springs, Wyoming, US",4413,-155,37,71,-34,1,-122,-121,0,86,15.811156887,-7.571539918,0.2226923505,-27.16846676,-26.94577441,2081
26061,"Houghton","Michigan","US","2020-05-24 02:32:43",46.89988536,-88.68495385,2,0,0,2,"Houghton, Michigan, US",35684,-259,358,348,10,64,-335,-271,2,2881,9.7170061569,0.2792243149,1.7870356151,-9.354014548,-7.566978933,14675
1069,"Houston","Alabama","US","2020-05-24 02:32:43",31.15197924,-85.29939599,161,4,0,157,"Houston, Alabama, US",105882,1112,1304,1137,167,11,936,947,-2,1415,10.795055352,1.5855534246,0.1044376507,8.8866946433,8.991132294,50383
13153,"Houston","Georgia","US","2020-05-24 02:32:43",32.45802497,-83.66879087,342,16,0,326,"Houston, Georgia, US",157863,2340,1958,1284,674,141,1528,1669,-3,1521,8.1943673297,4.3014046575,0.8998487488,9.7515523986,10.651401147,65861
27055,"Houston","Minnesota","US","2020-05-24 02:32:43",43.67129565,-91.49143057,2,0,0,2,"Houston, Minnesota, US",18600,28,204,196,8,0,23,23,-3,257,10.545571936,0.4304315076,0,1.2374905843,1.2374905843,5891
47083,"Houston","Tennessee","US","2020-05-24 02:32:43",36.28872054,-87.71878828,7,0,0,7,"Houston, Tennessee, US",8201,-33,80,93,-13,-1,-18,-19,-1,178,11.317310618,-1.581989656,-0.121691512,-2.190447216,-2.312138728,1821
48225,"Houston","Texas","US","2020-05-24 02:32:43",31.31925973,-95.42226208,81,0,0,81,"Houston, Texas, US",22968,-100,209,300,-91,6,-14,-8,-1,2726,13.033278304,-3.953427752,0.2606655661,-0.608219654,-0.347554088,7241
5061,"Howard","Arkansas","US","2020-05-24 02:32:43",34.09007427,-93.9934871,15,0,0,15,"Howard, Arkansas, US",13202,-100,172,171,1,-2,-99,-101,0,181,12.903712647,0.0754603079,-0.150920616,-7.47057048,-7.621491096,7364
18067,"Howard","Indiana","US","2020-05-24 02:32:43",40.48527731,-86.11351892,344,17,0,327,"Howard, Indiana, US",82544,287,946,950,-4,37,261,298,-7,1281,11.529056256,-0.048543395,0.4490264015,3.1674565082,3.6164829097,39930
19089,"Howard","Iowa","US","2020-05-24 02:32:43",43.35671042,-92.31702714,12,0,0,12,"Howard, Iowa, US",9158,-14,117,120,-3,-4,-6,-10,-1,191,13.093289689,-0.327332242,-0.43644299,-0.654664484,-1.091107474,4359
24027,"Howard","Maryland","US","2020-05-24 02:32:43",39.25305293,-76.93126208,1638,52,0,1586,"Howard, Maryland, US",325690,3069,3447,1845,1602,779,710,1489,-22,1689,5.6917127737,4.9420725547,2.4031676155,2.1903068126,4.5934744282,158635
29089,"Howard","Missouri","US","2020-05-24 02:32:43",39.1435761,-92.69756691,3,0,0,3,"Howard, Missouri, US",10001,-58,107,87,20,0,-78,-78,0,719,8.6739780658,1.9940179462,0,-7.77666999,-7.77666999,2684
31093,"Howard","Nebraska","US","2020-05-24 02:32:43",41.2200529,-98.5166499,39,0,0,39,"Howard, Nebraska, US",6445,-12,72,59,13,0,-25,-25,0,67,9.1458688575,2.0151914432,0,-3.87536816,-3.87536816,1849
48227,"Howard","Texas","US","2020-05-24 02:32:43",32.30621324,-101.4356444,6,1,0,5,"Howard, Texas, US",36664,739,438,349,89,81,568,649,1,5612,9.6157820055,2.4521621733,2.2317431016,15.649754095,17.881497197,14190
29091,"Howell","Missouri","US","2020-05-24 02:32:43",36.77383887,-91.88683935,5,0,0,5,"Howell, Missouri, US",40117,-9,504,508,-4,9,-11,-2,-3,608,12.661540571,-0.09969717,0.2243186322,-0.274167217,-0.049848585,17621
27057,"Hubbard","Minnesota","US","2020-05-24 02:32:43",47.10778564,-94.91693868,1,0,0,1,"Hubbard, Minnesota, US",21491,200,216,199,17,2,182,184,-1,154,9.3029778879,0.7947267542,0.0934972652,8.5082511337,8.6017483989,7215
34017,"Hudson","New Jersey","US","2020-05-24 02:32:43",40.73766234,-74.07515667,18959,1138,0,17821,"Hudson, New Jersey, US",672391,460,10019,4371,5648,5294,-10458,-5164,-24,9528,6.5029062977,8.4027487462,7.8760892108,-15.55877238,-7.682683167,276572
8055,"Huerfano","Colorado","US","2020-05-24 02:32:43",37.68473101,-104.9612585,3,0,0,3,"Huerfano, Colorado, US",6897,10,48,96,-48,4,54,58,0,165,13.929193268,-6.964596634,0.5803830528,7.835171213,8.4155542658,2158
46065,"Hughes","South Dakota","US","2020-05-24 02:32:43",44.39091534,-99.99661148,17,0,0,17,"Hughes, South Dakota, US",17526,-157,228,161,67,-2,-223,-225,1,768,9.145388963,3.8058450964,-0.113607316,-12.66721577,-12.78082309,10171
6023,"Humboldt","California","US","2020-05-24 02:32:43",40.69923009,-123.876044,93,2,0,91,"Humboldt, California, US",135558,-686,1352,1390,-38,-17,-625,-642,-6,5489,10.228033642,-0.279615308,-0.125091059,-4.59893599,-4.724027049,56968
19091,"Humboldt","Iowa","US","2020-05-24 02:32:43",42.7764426,-94.20722537,11,0,0,11,"Humboldt, Iowa, US",9558,-1,107,106,1,5,-7,-2,0,124,11.08960611,0.1046189256,0.5230946278,-0.732332479,-0.209237851,4119
32013,"Humboldt","Nevada","US","2020-05-24 02:32:43",41.40692186,-118.1109427,78,4,0,74,"Humboldt, Nevada, US",16831,53,221,112,109,-1,-55,-56,0,183,6.6648814306,6.4863578208,-0.05950787,-3.272932845,-3.332440715,8355
28053,"Humphreys","Mississippi","US","2020-05-24 02:32:43",33.12825718,-90.52252707,52,7,0,45,"Humphreys, Mississippi, US",8064,-192,94,109,-15,2,-178,-176,-1,83,13.357843137,-1.838235294,0.2450980392,-21.81372549,-21.56862745,2072
47085,"Humphreys","Tennessee","US","2020-05-24 02:32:43",36.03958805,-87.77992872,12,1,0,11,"Humphreys, Tennessee, US",18582,31,230,254,-24,-4,59,55,0,273,13.680553685,-1.292650742,-0.21544179,3.1777664072,2.9623246169,6546
48231,"Hunt","Texas","US","2020-05-24 02:32:43",33.12351514,-96.08551032,71,3,0,68,"Hunt, Texas, US",98594,1988,1206,981,225,73,1686,1759,4,2739,10.051229508,2.3053278689,0.7479508197,17.274590164,18.022540984,31096
34019,"Hunterdon","New Jersey","US","2020-05-24 02:32:43",40.56335249,-74.91284156,938,57,0,881,"Hunterdon, New Jersey, US",124371,-436,972,1009,-37,63,-460,-397,-2,3335,8.0986282898,-0.296976459,0.5056626187,-3.692139756,-3.186477137,56438
42061,"Huntingdon","Pennsylvania","US","2020-05-24 02:32:43",40.42162652,-77.97673273,227,1,0,226,"Huntingdon, Pennsylvania, US",45144,-251,354,532,-178,35,-107,-72,-1,5019,11.751841748,-3.932007201,0.7731474834,-2.363622306,-1.590474823,15018
18069,"Huntington","Indiana","US","2020-05-24 02:32:43",40.82907273,-85.48822092,22,2,0,20,"Huntington, Indiana, US",36520,277,411,390,21,20,238,258,-2,1339,10.719733931,0.5772164424,0.5497299452,6.5417863475,7.0915162926,15514
26063,"Huron","Michigan","US","2020-05-24 02:32:43",43.83353985,-83.04078453,42,1,0,41,"Huron, Michigan, US",30981,-230,310,445,-135,11,-103,-92,-3,524,14.310522254,-4.341394392,0.3537432467,-3.312323128,-2.958579882,14190
39077,"Huron","Ohio","US","2020-05-24 02:32:43",41.14651175,-82.59867951,49,1,0,48,"Huron, Ohio, US",58266,-98,698,589,109,-4,-202,-206,-1,578,10.100317243,1.8691588785,-0.068592986,-3.463945812,-3.532538798,23411
46067,"Hutchinson","South Dakota","US","2020-05-24 02:32:43",43.33449012,-97.75536441,3,0,0,3,"Hutchinson, South Dakota, US",7291,-15,109,94,15,1,-30,-29,-1,832,12.879358772,2.0552168254,0.137014455,-4.110433651,-3.973419196,3196
48233,"Hutchinson","Texas","US","2020-05-24 02:32:43",35.84006574,-101.3546643,31,0,0,31,"Hutchinson, Texas, US",20938,-181,256,215,41,2,-226,-224,2,265,10.224219512,1.9497348836,0.0951090187,-10.74731911,-10.6522101,9799
37095,"Hyde","North Carolina","US","2020-05-24 02:32:43",35.42017674,-76.15180542,1,0,0,1,"Hyde, North Carolina, US",4937,-89,33,49,-16,-1,-72,-73,0,491,9.8363946602,-3.211883971,-0.200742748,-14.45347787,-14.65422062,2149
46069,"Hyde","South Dakota","US","2020-05-24 02:32:43",44.54747703,-99.48572582,1,0,0,1,"Hyde, South Dakota, US",1301,30,18,9,9,0,21,21,0,38,6.99844479,6.99844479,0,16.32970451,16.32970451,811
22045,"Iberia","Louisiana","US","2020-05-24 02:32:43",29.86803617,-91.75871777,388,35,0,353,"Iberia, Louisiana, US",69830,-1075,914,777,137,6,-1221,-1215,3,944,11.042029346,1.9469215192,0.0852666359,-17.3517604,-17.26649376,32050
22047,"Iberville","Louisiana","US","2020-05-24 02:32:43",30.25734305,-91.3499598,541,39,0,502,"Iberville, Louisiana, US",32511,-182,351,313,38,-8,-211,-219,-1,3987,9.6006379977,1.1655726643,-0.245383719,-6.471995583,-6.717379302,16163
19093,"Ida","Iowa","US","2020-05-24 02:32:43",42.38696136,-95.51355387,9,0,0,9,"Ida, Iowa, US",6860,14,68,103,-35,1,50,51,-2,121,15.029913906,-5.107252298,0.1459214942,7.2960747118,7.441996206,4180
16049,"Idaho","Idaho","US","2020-05-24 02:32:43",45.84721541,-115.4634436,3,0,0,3,"Idaho, Idaho, US",16667,191,149,179,-30,1,219,220,1,520,10.801677579,-1.810337024,0.0603445675,13.215460278,13.275804846,5953
6025,"Imperial","California","US","2020-05-24 02:32:43",33.0393082,-115.3669042,1145,23,0,1122,"Imperial, California, US",181215,-308,2728,1079,1649,33,-2000,-1967,10,8745,5.9491974924,9.0919616914,0.1819495063,-11.0272428,-10.8452933,57000
5063,"Independence","Arkansas","US","2020-05-24 02:32:43",35.74242707,-91.57001641,29,0,0,29,"Independence, Arkansas, US",37825,57,513,430,83,-7,-17,-24,-2,966,11.376714775,2.1959705264,-0.185202334,-0.449777096,-0.634979429,16747
12061,"Indian River","Florida","US","2020-05-24 02:32:43",27.69308961,-80.60556721,113,9,0,104,"Indian River, Florida, US",159923,2736,1283,2177,-894,205,3407,3612,18,1328,13.730251332,-5.638421999,1.2929267447,21.4878118,22.780738545,51988
42063,"Indiana","Pennsylvania","US","2020-05-24 02:32:43",40.65241041,-79.08963285,89,5,0,84,"Indiana, Pennsylvania, US",84073,-368,760,896,-136,50,-281,-231,-1,5061,10.634131289,-1.614109213,0.593422505,-3.335034478,-2.741611973,37312
26065,"Ingham","Michigan","US","2020-05-24 02:32:43",42.59716886,-84.37472069,695,25,0,670,"Ingham, Michigan, US",292406,794,3181,2246,935,1294,-1437,-143,2,17551,7.6915437538,3.2019561041,4.431370266,-4.9210812,-0.489710934,163246
6027,"Inyo","California","US","2020-05-24 02:32:43",36.51112084,-117.4111978,19,1,0,18,"Inyo, California, US",18039,93,191,172,19,18,57,75,-1,411,9.5595386967,1.0559955537,1.0004168404,3.1679866611,4.1684035015,8490
26067,"Ionia","Michigan","US","2020-05-24 02:32:43",42.94502238,-85.07413319,141,3,0,138,"Ionia, Michigan, US",64697,421,707,550,157,5,259,264,0,5352,8.5289169051,2.4346180984,0.0775356082,4.0163445062,4.0938801144,17748
26069,"Iosco","Michigan","US","2020-05-24 02:32:43",44.35486835,-83.63484895,77,9,0,68,"Iosco, Michigan, US",25127,24,233,385,-152,-4,182,178,-2,400,15.329484372,-6.052160064,-0.15926737,7.2466653394,7.0873979693,9366
19095,"Iowa","Iowa","US","2020-05-24 02:32:43",41.68630265,-92.0643373,32,0,0,32,"Iowa, Iowa, US",16184,29,182,182,0,-2,34,32,-3,286,11.2557593,0,-0.123689663,2.1027242648,1.9790346022,8824
55049,"Iowa","Wisconsin","US","2020-05-24 02:32:43",43.00050278,-90.13469017,11,0,0,11,"Iowa, Wisconsin, US",23678,-44,248,190,58,3,-103,-100,-2,182,8.0168776371,2.447257384,0.1265822785,-4.345991561,-4.219409283,11272
37097,"Iredell","North Carolina","US","2020-05-24 02:32:43",35.80950511,-80.8743128,219,6,0,213,"Iredell, North Carolina, US",181806,3474,1872,1685,187,165,3116,3281,6,1228,9.3575240602,1.0384908007,0.9163154124,17.304477728,18.22079314,71595
29093,"Iron","Missouri","US","2020-05-24 02:32:43",37.55487945,-90.7735296,2,0,0,2,"Iron, Missouri, US",10125,-62,98,152,-54,2,-9,-7,-1,276,14.966522253,-5.317053958,0.1969279244,-0.88617566,-0.689247735,3605
55051,"Iron","Wisconsin","US","2020-05-24 02:32:43",46.26302338,-90.24295041,2,1,0,1,"Iron, Wisconsin, US",5687,0,33,91,-58,0,58,58,0,92,16.001406717,-10.19869879,0,10.198698787,10.198698787,1964
17075,"Iroquois","Illinois","US","2020-05-24 02:32:43",40.74717633,-87.82466784,128,4,0,124,"Iroquois, Illinois, US",27114,-370,292,359,-67,-2,-302,-304,1,469,13.15066486,-2.454302355,-0.073262757,-11.06267629,-11.13593905,10254
13155,"Irwin","Georgia","US","2020-05-24 02:32:43",31.60213036,-83.27501387,23,1,0,22,"Irwin, Georgia, US",9416,20,104,114,-10,-1,31,30,0,1147,12.119923453,-1.06315118,-0.106315118,3.2957686583,3.1894535403,2190
26073,"Isabella","Michigan","US","2020-05-24 02:32:43",43.64060976,-84.84664923,70,7,0,63,"Isabella, Michigan, US",69872,-591,660,460,200,121,-921,-800,9,5320,6.5557416183,2.8503224427,1.7244450778,-13.12573485,-11.40128977,34570
27059,"Isanti","Minnesota","US","2020-05-24 02:32:43",45.56181234,-93.29487636,24,0,0,24,"Isanti, Minnesota, US",40596,646,448,327,121,13,512,525,0,465,8.1195838403,3.0044943262,0.3227969111,12.71323219,13.036029101,11766
53029,"Island","Washington","US","2020-05-24 02:32:43",48.14713305,-122.5216407,177,10,0,167,"Island, Washington, US",85141,914,916,762,154,59,700,759,1,1908,8.9981578574,1.8185253413,0.6967077606,8.2660242785,8.9627320391,26116
51093,"Isle of Wight","Virginia","US","2020-05-24 02:32:43",36.90579348,-76.70842863,124,3,0,121,"Isle of Wight, Virginia, US",37109,137,376,397,-21,7,156,163,-5,310,10.717997867,-0.56694699,0.1889823302,4.2116062148,4.400588545,10267
27061,"Itasca","Minnesota","US","2020-05-24 02:32:43",47.51009045,-93.63092229,51,6,0,45,"Itasca, Minnesota, US",45130,79,441,502,-61,8,136,144,-4,1016,11.133165523,-1.352834854,0.1774209645,3.0161563966,3.1935773611,18384
28057,"Itawamba","Mississippi","US","2020-05-24 02:32:43",34.27993475,-88.3606733,82,7,0,75,"Itawamba, Mississippi, US",23390,-71,257,254,3,8,-80,-72,-2,998,10.84288489,0.1280655696,0.3415081855,-3.415081855,-3.07357367,6151
5065,"Izard","Arkansas","US","2020-05-24 02:32:43",36.09604046,-91.90847954,14,0,0,14,"Izard, Arkansas, US",13629,47,119,188,-69,2,113,115,1,1002,13.817941274,-5.071478446,0.1469993753,8.3054647018,8.452464077,4091
48237,"Jack","Texas","US","2020-05-24 02:32:43",33.23377248,-98.17283469,4,0,0,4,"Jack, Texas, US",8935,110,82,76,6,0,102,102,2,1120,8.5585585586,0.6756756757,0,11.486486486,11.486486486,3359
1071,"Jackson","Alabama","US","2020-05-24 02:32:43",34.78144169,-85.99750489,69,2,0,67,"Jackson, Alabama, US",51626,5,562,675,-113,-7,128,121,-3,597,13.075440449,-2.188925586,-0.13559716,2.4794909295,2.3438937693,17703
5067,"Jackson","Arkansas","US","2020-05-24 02:32:43",35.59802983,-91.21494602,1,0,0,1,"Jackson, Arkansas, US",16719,-34,187,206,-19,-2,-12,-14,-1,2210,12.308795411,-1.135277247,-0.119502868,-0.717017208,-0.836520076,5545
12063,"Jackson","Florida","US","2020-05-24 02:32:43",30.7954597,-85.21500423,225,0,0,225,"Jackson, Florida, US",46414,-1698,502,636,-134,29,-1606,-1577,13,6320,13.456615111,-2.835198781,0.613587796,-33.98006898,-33.36648118,14942
13157,"Jackson","Georgia","US","2020-05-24 02:32:43",34.13794553,-83.56814788,147,4,0,143,"Jackson, Georgia, US",72977,2652,918,614,304,26,2311,2337,11,724,8.5693151526,4.2427879583,0.3628700227,32.253562407,32.616432429,21995
17077,"Jackson","Illinois","US","2020-05-24 02:32:43",37.78595185,-89.38232563,207,10,0,197,"Jackson, Illinois, US",56750,-539,614,496,118,184,-845,-661,4,3586,8.6987784881,2.0694674629,3.2269662133,-14.81949158,-11.59252536,28546
18071,"Jackson","Indiana","US","2020-05-24 02:32:43",38.9091582,-86.03851889,353,1,0,352,"Jackson, Indiana, US",44231,163,591,456,135,114,-85,29,-1,595,10.328542792,3.057792274,2.582135698,-1.925276617,0.6568590811,21383
19097,"Jackson","Iowa","US","2020-05-24 02:32:43",42.17178824,-90.57354837,11,0,0,11,"Jackson, Iowa, US",19439,12,223,231,-8,2,20,22,-2,198,11.886996346,-0.411670869,0.1029177173,1.0291771729,1.1320948901,6779
20085,"Jackson","Kansas","US","2020-05-24 02:32:43",39.41673394,-95.79356799,84,0,0,84,"Jackson, Kansas, US",13171,-99,173,131,42,-3,-138,-141,0,133,9.9088536742,3.1768843841,-0.226920313,-10.4383344,-10.66525472,4316
21109,"Jackson","Kentucky","US","2020-05-24 02:32:43",37.41866422,-83.99825483,60,13,0,47,"Jackson, Kentucky, US",13329,-74,154,168,-14,-1,-60,-61,1,110,12.569205447,-1.047433787,-0.074816699,-4.489001945,-4.563818644,2500
22049,"Jackson","Louisiana","US","2020-05-24 02:32:43",32.30251776,-92.55692092,82,10,0,72,"Jackson, Louisiana, US",15744,-168,160,220,-60,-3,-104,-107,-1,1037,13.899418752,-3.790750569,-0.189537528,-6.570634319,-6.760171847,3224
26075,"Jackson","Michigan","US","2020-05-24 02:32:43",42.24807035,-84.42258681,432,26,0,406,"Jackson, Michigan, US",158510,-56,1743,1623,120,30,-200,-170,-6,8588,10.237293267,0.7569163229,0.1892290807,-1.261527205,-1.072298124,60114
27063,"Jackson","Minnesota","US","2020-05-24 02:32:43",43.67423373,-95.15398258,38,0,0,38,"Jackson, Minnesota, US",9846,-49,98,109,-11,7,-45,-38,0,110,11.04300694,-1.114431893,0.7091839319,-4.559039562,-3.84985563,5604
28059,"Jackson","Mississippi","US","2020-05-24 02:32:43",30.54020656,-88.64184064,296,13,0,283,"Jackson, Mississippi, US",143617,490,1588,1430,158,76,262,338,-6,1391,9.9740535111,1.10202829,0.5300895572,1.8274139999,2.3575035572,55065
29095,"Jackson","Missouri","US","2020-05-24 02:32:43",39.01002188,-94.34724536,495,16,0,479,"Jackson, Missouri, US",703011,2227,8996,6497,2499,602,-845,-243,-29,11068,9.2563372857,3.5603489113,0.8576750879,-1.203879484,-0.346204396,379713
37099,"Jackson","North Carolina","US","2020-05-24 02:32:43",35.28814273,-83.14093385,27,1,0,26,"Jackson, North Carolina, US",43938,338,362,371,-9,81,267,348,-1,4211,8.4763188558,-0.205624986,1.8506248715,6.1002079097,7.9508327812,18708
39079,"Jackson","Ohio","US","2020-05-24 02:32:43",39.01914254,-82.6181856,11,0,0,11,"Jackson, Ohio, US",32413,47,408,401,7,12,30,42,-2,325,12.380555427,0.2161194214,0.3704904367,0.9262260918,1.2967165285,11270
40065,"Jackson","Oklahoma","US","2020-05-24 02:32:43",34.58781741,-99.41138784,21,1,0,20,"Jackson, Oklahoma, US",24530,-245,359,215,144,45,-434,-389,0,687,8.7212250279,5.8411925768,1.8253726803,-17.60470541,-15.77933272,11924
41029,"Jackson","Oregon","US","2020-05-24 02:32:43",42.43201126,-122.7289309,56,0,0,56,"Jackson, Oregon, US",220944,1533,2251,2325,-74,-41,1652,1611,-4,3669,10.559662091,-0.336092471,-0.186213396,7.5030373222,7.3168239262,86124
47087,"Jackson","Tennessee","US","2020-05-24 02:32:43",36.36380466,-85.67239905,16,0,0,16,"Jackson, Tennessee, US",11786,9,94,163,-69,1,77,78,0,197,13.83525018,-5.856639647,0.0848788355,6.5356703306,6.6205491661,1996
48239,"Jackson","Texas","US","2020-05-24 02:32:43",28.95472367,-96.57749563,16,1,0,15,"Jackson, Texas, US",14760,-74,221,155,66,11,-151,-140,0,238,10.475096303,4.4603635872,0.7433939312,-10.20477124,-9.461377306,5719
54035,"Jackson","West Virginia","US","2020-05-24 02:32:43",38.84263974,-81.68148753,135,18,0,117,"Jackson, West Virginia, US",28576,-119,276,361,-85,-1,-31,-32,-2,180,12.606729409,-2.96834349,-0.034921688,-1.082572332,-1.11749402,8228
55053,"Jackson","Wisconsin","US","2020-05-24 02:32:43",44.31864893,-90.80566792,15,1,0,14,"Jackson, Wisconsin, US",20643,171,220,164,56,6,109,115,0,1288,7.9776237383,2.7240666423,0.2918642831,5.3022011431,5.5940654262,8111
51095,"James City","Virginia","US","2020-05-24 02:32:43",37.31156958,-76.76950618,192,16,0,176,"James City, Virginia, US",76523,490,721,778,-57,37,516,553,-6,1143,10.199533286,-0.747266578,0.4850677784,6.7647290175,7.2497967959,28131
13159,"Jasper","Georgia","US","2020-05-24 02:32:43",33.31535543,-83.68844964,31,1,0,30,"Jasper, Georgia, US",14219,190,145,138,7,-1,180,179,4,95,9.7706032285,0.4956103087,-0.070801473,12.744265081,12.673463608,2786
17079,"Jasper","Illinois","US","2020-05-24 02:32:43",39.01054275,-88.15437049,45,7,0,38,"Jasper, Illinois, US",9610,-14,114,93,21,12,-49,-37,2,54,9.6703753769,2.1836331496,1.2477903712,-5.095144016,-3.847353645,3239
18073,"Jasper","Indiana","US","2020-05-24 02:32:43",41.02078733,-87.11553319,52,1,0,51,"Jasper, Indiana, US",33562,197,362,331,31,3,166,169,-3,932,9.8913741838,0.9263824764,0.0896499171,4.9606287448,5.0502786618,12606
19099,"Jasper","Iowa","US","2020-05-24 02:32:43",41.68576082,-93.05567785,254,16,0,238,"Jasper, Iowa, US",37185,-4,406,378,28,10,-40,-30,-2,1766,10.164842553,0.7529513002,0.2689111786,-1.075644715,-0.806733536,11813
28061,"Jasper","Mississippi","US","2020-05-24 02:32:43",32.01922104,-89.11786866,135,3,0,132,"Jasper, Mississippi, US",16383,-42,182,186,-4,-2,-35,-37,-1,87,11.338697879,-0.243842965,-0.121921483,-2.133625945,-2.255547427,4386
29097,"Jasper","Missouri","US","2020-05-24 02:32:43",37.20351921,-94.34050458,32,0,0,32,"Jasper, Missouri, US",121328,873,1543,1192,351,100,423,523,-1,2488,9.8600811471,2.9034299351,0.8271880157,3.4990053064,4.3261933221,60689
45053,"Jasper","South Carolina","US","2020-05-24 02:32:43",32.43171982,-81.02487495,36,2,0,34,"Jasper, South Carolina, US",30073,926,366,282,84,57,778,835,7,1211,9.5238095238,2.8368794326,1.9250253293,26.274907126,28.199932455,8341
48241,"Jasper","Texas","US","2020-05-24 02:32:43",30.74685667,-94.02667579,26,1,0,25,"Jasper, Texas, US",35529,-240,422,430,-8,-12,-219,-231,-1,876,12.062049426,-0.224410222,-0.336615333,-6.143229824,-6.479845157,10932
18075,"Jay","Indiana","US","2020-05-24 02:32:43",40.43781032,-85.00576229,41,0,0,41,"Jay, Indiana, US",20436,-291,277,226,51,-7,-334,-341,-1,243,10.980735126,2.4779535019,-0.340111265,-16.22816607,-16.56827734,8669
13161,"Jeff Davis","Georgia","US","2020-05-24 02:32:43",31.80405727,-82.6372487,31,1,0,30,"Jeff Davis, Georgia, US",15115,67,190,150,40,9,18,27,0,112,9.9459602825,2.6522560753,0.5967576169,1.1935152339,1.7902728508,4837
1073,"Jefferson","Alabama","US","2020-05-24 02:32:43",33.55554728,-86.895063,1573,88,0,1485,"Jefferson, Alabama, US",658573,-856,8422,7343,1079,460,-2375,-1915,-20,16663,11.142623456,1.6373268022,0.6980262549,-3.603939903,-2.905913648,355854
5069,"Jefferson","Arkansas","US","2020-05-24 02:32:43",34.26767081,-91.92619839,504,23,0,481,"Jefferson, Arkansas, US",66824,-1243,788,827,-39,6,-1214,-1208,4,5424,12.261752081,-0.578244657,0.0889607164,-17.99971829,-17.91075757,29948
8059,"Jefferson","Colorado","US","2020-05-24 02:32:43",39.58635604,-105.2517692,2030,142,0,1888,"Jefferson, Colorado, US",582881,3489,5822,4599,1223,596,1659,2255,11,8309,7.9138033835,2.1044969641,1.0255766072,2.8547509922,3.8803275995,237161
12065,"Jefferson","Florida","US","2020-05-24 02:32:43",30.43669112,-83.89442308,29,3,0,26,"Jefferson, Florida, US",14246,-75,122,146,-24,6,-56,-50,-1,1270,10.221584346,-1.68026044,0.4200651101,-3.920607694,-3.500542584,2600
13163,"Jefferson","Georgia","US","2020-05-24 02:32:43",33.05867328,-82.41609057,26,1,0,25,"Jefferson, Georgia, US",15362,-62,179,226,-47,5,-19,-14,-1,600,14.681998311,-3.053335932,0.3248229715,-1.234327292,-0.90950432,4735
16051,"Jefferson","Idaho","US","2020-05-24 02:32:43",43.82078483,-112.3131749,7,0,0,7,"Jefferson, Idaho, US",29871,466,496,163,333,-1,135,134,-1,141,5.4996963358,11.23557595,-0.033740468,4.5549632229,4.5212227546,6714
17081,"Jefferson","Illinois","US","2020-05-24 02:32:43",38.29980057,-88.9240025,100,16,0,84,"Jefferson, Illinois, US",37684,-24,452,445,7,14,-44,-30,-1,2141,11.804966044,0.1856960951,0.3713921902,-1.167232598,-0.795840407,20727
18077,"Jefferson","Indiana","US","2020-05-24 02:32:43",38.78576239,-85.43633383,41,1,0,40,"Jefferson, Indiana, US",32308,151,372,350,22,10,123,133,-4,2042,10.858605445,0.6825409137,0.3102458699,3.8160241992,4.126270069,13258
19101,"Jefferson","Iowa","US","2020-05-24 02:32:43",41.03192394,-91.94849466,14,0,0,14,"Jefferson, Iowa, US",18295,39,158,185,-27,142,-74,68,-2,1710,10.122842056,-1.47738776,7.769965254,-4.049136823,3.7208284315,8600
20087,"Jefferson","Kansas","US","2020-05-24 02:32:43",39.2347941,-95.38289232,21,0,0,21,"Jefferson, Kansas, US",19043,187,171,149,22,-2,167,165,0,235,7.8630043009,1.1609805008,-0.105543682,8.8128974379,8.707353756,4319
21111,"Jefferson","Kentucky","US","2020-05-24 02:32:43",38.18664655,-85.65931031,2050,141,0,1909,"Jefferson, Kentucky, US",766757,-1344,9603,7744,1859,499,-3669,-3170,-33,17228,10.090835765,2.4223739264,0.6502230174,-4.780898298,-4.130675281,436808
22051,"Jefferson","Louisiana","US","2020-05-24 02:32:43",29.74075478,-90.11115756,7232,432,0,6800,"Jefferson, Louisiana, US",432493,-1391,5577,4345,1232,1033,-3646,-2613,-10,3313,10.030275504,2.8440274846,2.384643175,-8.41665926,-6.032016085,198788
28063,"Jefferson","Mississippi","US","2020-05-24 02:32:43",31.73397872,-91.03764977,40,0,0,40,"Jefferson, Mississippi, US",6990,-103,81,80,1,0,-104,-104,0,357,11.36121565,0.1420151956,0,-14.76958035,-14.76958035,1564
29099,"Jefferson","Missouri","US","2020-05-24 02:32:43",38.25926778,-90.53870896,337,15,0,322,"Jefferson, Missouri, US",225081,671,2464,2150,314,39,329,368,-11,1983,9.56637619,1.3971358715,0.1735296146,1.4638780309,1.6374076455,50991
30043,"Jefferson","Montana","US","2020-05-24 02:32:43",46.14907081,-112.094396,3,0,0,3,"Jefferson, Montana, US",12221,127,105,138,-33,2,158,160,0,230,11.35101789,-2.714373843,0.1645075057,12.996092947,13.160600452,2903
31095,"Jefferson","Nebraska","US","2020-05-24 02:32:43",40.17584531,-97.142601,6,0,0,6,"Jefferson, Nebraska, US",7046,-52,73,82,-9,10,-54,-44,1,93,11.595022624,-1.272624434,1.4140271493,-7.635746606,-6.221719457,3831
36045,"Jefferson","New York","US","2020-05-24 02:32:43",44.04200959,-75.94653457,72,0,0,72,"Jefferson, New York, US",109834,-2032,1913,919,994,-45,-2981,-3026,0,6023,8.2904826342,8.9670726207,-0.405953992,-26.89219666,-27.29815065,57596
39081,"Jefferson","Ohio","US","2020-05-24 02:32:43",40.38614126,-80.76259514,62,2,0,60,"Jefferson, Ohio, US",65325,-449,638,917,-279,-27,-140,-167,-3,2444,13.989427837,-4.256325372,-0.411902455,-2.135790509,-2.547692965,23399
40067,"Jefferson","Oklahoma","US","2020-05-24 02:32:43",34.11130184,-97.83182974,3,0,0,3,"Jefferson, Oklahoma, US",6002,-104,61,83,-22,1,-83,-82,0,144,13.709943839,-3.633961018,0.1651800463,-13.70994384,-13.54476379,1769
41031,"Jefferson","Oregon","US","2020-05-24 02:32:43",44.62806839,-121.17832,25,0,0,25,"Jefferson, Oregon, US",24658,508,281,250,31,-10,484,474,3,944,10.244222259,1.2702835601,-0.40976889,19.832814293,19.423045402,7239
42065,"Jefferson","Pennsylvania","US","2020-05-24 02:32:43",41.12913106,-78.9986361,7,0,0,7,"Jefferson, Pennsylvania, US",43425,-189,459,519,-60,0,-128,-128,-1,759,11.925688484,-1.37869231,0,-2.941210262,-2.941210262,17363
47089,"Jefferson","Tennessee","US","2020-05-24 02:32:43",36.04818632,-83.45148924,27,0,0,27,"Jefferson, Tennessee, US",54495,483,473,668,-195,15,661,676,2,1483,12.312569696,-3.59423816,0.2764798584,12.183545762,12.46002562,15555
48245,"Jefferson","Texas","US","2020-05-24 02:32:43",29.8832777,-94.16434171,465,27,0,438,"Jefferson, Texas, US",251565,-1669,3323,2538,785,359,-2823,-2464,10,15257,10.055487432,3.1101487919,1.422348301,-11.18464973,-9.762301431,126998
53031,"Jefferson","Washington","US","2020-05-24 02:32:43",47.75003077,-123.5609704,30,0,0,30,"Jefferson, Washington, US",32221,475,181,396,-215,5,683,688,2,631,12.381384151,-6.722216143,0.156330608,21.354761049,21.511091657,10644
54037,"Jefferson","West Virginia","US","2020-05-24 02:32:43",39.30776166,-77.86014147,140,1,0,139,"Jefferson, West Virginia, US",57146,256,595,515,80,-39,217,178,-2,1076,9.0322354344,1.4030656986,-0.683994528,3.8058157073,3.1218211793,18136
55055,"Jefferson","Wisconsin","US","2020-05-24 02:32:43",43.02054068,-88.77529134,78,3,0,75,"Jefferson, Wisconsin, US",84769,-280,835,694,141,28,-450,-422,1,2913,8.1734562885,1.6606013497,0.329764807,-5.299791542,-4.970026735,33012
22053,"Jefferson Davis","Louisiana","US","2020-05-24 02:32:43",30.26896765,-92.81210004,73,6,0,67,"Jefferson Davis, Louisiana, US",31368,-169,384,410,-26,6,-149,-143,0,567,13.035529767,-0.826643351,0.1907638503,-4.737302281,-4.546538431,9148
28065,"Jefferson Davis","Mississippi","US","2020-05-24 02:32:43",31.56884708,-89.8267099,70,2,0,68,"Jefferson Davis, Mississippi, US",11128,-87,124,159,-35,-1,-49,-50,-2,108,14.232645571,-3.132972296,-0.089513494,-4.386161214,-4.475674708,2234
13165,"Jenkins","Georgia","US","2020-05-24 02:32:43",32.79248718,-81.96040187,18,1,0,17,"Jenkins, Georgia, US",8676,-89,97,107,-10,9,-88,-79,0,1181,12.26993865,-1.146723238,1.0320509145,-10.0911645,-9.059113583,2093
18079,"Jennings","Indiana","US","2020-05-24 02:32:43",38.99588883,-85.62710784,126,4,0,122,"Jennings, Indiana, US",27735,56,338,302,36,-1,23,22,-2,298,10.899772621,1.2993106435,-0.036091962,0.8301151334,0.794023171,8239
46073,"Jerauld","South Dakota","US","2020-05-24 02:32:43",44.06637798,-98.62965972,16,1,0,15,"Jerauld, South Dakota, US",2013,-13,20,20,0,2,-15,-13,0,176,9.9034414459,0,0.9903441446,-7.427581084,-6.43723694,1245
16053,"Jerome","Idaho","US","2020-05-24 02:32:43",42.68891267,-114.2655033,137,2,0,135,"Jerome, Idaho, US",24412,346,367,152,215,93,41,134,-3,116,6.2708857626,8.8700028879,3.8367919469,1.6914889228,5.5282808697,8819
17083,"Jersey","Illinois","US","2020-05-24 02:32:43",39.08869046,-90.35393073,20,1,0,19,"Jersey, Illinois, US",21773,-22,211,234,-23,20,-18,2,-1,795,10.741828865,-1.055820786,0.9181050312,-0.826294528,0.0918105031,5785
21113,"Jessamine","Kentucky","US","2020-05-24 02:32:43",37.87119786,-84.58252003,51,0,0,51,"Jessamine, Kentucky, US",54115,358,629,430,199,35,125,160,-1,1720,7.9724117473,3.6895579947,0.6489172352,2.3175615544,2.9664787897,18196
20089,"Jewell","Kansas","US","2020-05-24 02:32:43",39.78470589,-98.21820662,4,0,0,4,"Jewell, Kansas, US",2879,34,31,34,-3,0,38,38,-1,27,11.879804333,-1.048218029,0,13.277428372,13.277428372,1094
48247,"Jim Hogg","Texas","US","2020-05-24 02:32:43",27.04453923,-98.6968187,4,0,0,4,"Jim Hogg, Texas, US",5200,8,56,57,-1,20,-11,9,0,19,10.969976905,-0.192455735,3.8491147036,-2.117013087,1.7321016166,1720
48249,"Jim Wells","Texas","US","2020-05-24 02:32:43",27.73103938,-98.0904705,9,0,0,9,"Jim Wells, Texas, US",40482,-274,510,407,103,47,-424,-377,0,357,10.019941407,2.5357591275,1.1570939708,-10.43846476,-9.281370787,19024
17085,"Jo Daviess","Illinois","US","2020-05-24 02:32:43",42.36542373,-90.21094405,26,0,0,26,"Jo Daviess, Illinois, US",21235,-96,165,240,-75,-9,-8,-17,-4,167,11.276605742,-3.523939294,-0.422872715,-0.375886858,-0.798759573,8506
5071,"Johnson","Arkansas","US","2020-05-24 02:32:43",35.56759135,-93.46036368,38,0,0,38,"Johnson, Arkansas, US",26578,-81,326,252,74,-4,-150,-154,-1,690,9.4670999493,2.7800214137,-0.150271428,-5.635178541,-5.785449969,10232
13167,"Johnson","Georgia","US","2020-05-24 02:32:43",32.70211082,-82.66166794,76,2,0,74,"Johnson, Georgia, US",9643,-63,105,113,-8,-2,-54,-56,1,1650,11.680190191,-0.82691612,-0.20672903,-5.581683808,-5.788412838,2304
17087,"Johnson","Illinois","US","2020-05-24 02:32:43",37.45939802,-88.88165419,7,0,0,7,"Johnson, Illinois, US",12417,-6,101,144,-43,0,38,38,-1,1276,11.594202899,-3.46215781,0,3.0595813205,3.0595813205,2963
18081,"Johnson","Indiana","US","2020-05-24 02:32:43",39.48994426,-86.10149107,1065,102,0,963,"Johnson, Indiana, US",158167,2074,1810,1299,511,302,1268,1570,-7,2417,8.2670400305,3.2520842614,1.9219754344,8.0697511615,9.9917265958,49331
19103,"Johnson","Iowa","US","2020-05-24 02:32:43",41.67169354,-91.58754744,593,7,0,586,"Johnson, Iowa, US",151140,591,1730,765,965,478,-855,-377,3,8188,5.0714477492,6.3973164418,3.1688261753,-5.668088661,-2.499262486,86796
20091,"Johnson","Kansas","US","2020-05-24 02:32:43",38.88548175,-94.82250877,688,60,0,628,"Johnson, Kansas, US",602401,4274,7125,4070,3055,937,299,1236,-17,5160,6.7803499793,5.0894273186,1.5609798355,0.4981141631,2.0590939986,317531
21115,"Johnson","Kentucky","US","2020-05-24 02:32:43",37.85106355,-82.8264322,5,0,0,5,"Johnson, Kentucky, US",22188,-203,253,312,-59,-4,-138,-142,-2,528,13.997622199,-2.646986249,-0.179456695,-6.191255973,-6.370712667,5850
29101,"Johnson","Missouri","US","2020-05-24 02:32:43",38.74719601,-93.80691168,72,0,0,72,"Johnson, Missouri, US",54062,441,686,378,308,41,94,135,-2,3684,7.020606781,5.7204944142,0.7614943863,1.7458651783,2.5073595646,23459
31097,"Johnson","Nebraska","US","2020-05-24 02:32:43",40.39257596,-96.26522753,7,0,0,7,"Johnson, Nebraska, US",5071,-44,41,57,-16,2,-30,-28,0,1036,11.191831926,-3.141566856,0.3926958571,-5.890437856,-5.497741999,1974
47091,"Johnson","Tennessee","US","2020-05-24 02:32:43",36.4552395,-81.84886538,15,0,0,15,"Johnson, Tennessee, US",17788,14,154,237,-83,-6,104,98,-1,1694,13.328834149,-4.667903942,-0.337438839,5.8489398796,5.5115010404,4626
48251,"Johnson","Texas","US","2020-05-24 02:32:43",32.37877812,-97.36615819,144,4,0,140,"Johnson, Texas, US",175817,4696,2155,1464,691,-18,4018,4000,5,2596,8.4395482766,3.9834206688,-0.103764938,23.162640011,23.058875073,44002
56019,"Johnson","Wyoming","US","2020-05-24 02:32:43",44.04057166,-106.5845174,16,1,0,15,"Johnson, Wyoming, US",8445,-1,67,92,-25,2,21,23,1,71,10.89337517,-2.960156296,0.2368125037,2.4865312889,2.7233437926,3227
37101,"Johnston","North Carolina","US","2020-05-24 02:32:43",35.51745004,-78.36622717,320,20,0,300,"Johnston, North Carolina, US",209339,6647,2371,1618,753,121,5752,5873,21,1745,7.8537779924,3.6550647888,0.5873344481,27.920229303,28.507563751,50912
40069,"Johnston","Oklahoma","US","2020-05-24 02:32:43",34.31440473,-96.66011537,3,0,0,3,"Johnston, Oklahoma, US",11085,65,130,147,-17,1,83,84,-2,292,13.300158335,-1.538113549,0.0904772676,7.5096132097,7.6000904773,3223
13169,"Jones","Georgia","US","2020-05-24 02:32:43",33.02512137,-83.56019163,33,0,0,33,"Jones, Georgia, US",28735,55,216,292,-76,0,133,133,-2,306,10.171557955,-2.647391797,0,4.632935644,4.632935644,4728
19105,"Jones","Iowa","US","2020-05-24 02:32:43",42.12118609,-91.13139641,36,0,0,36,"Jones, Iowa, US",20681,8,200,202,-2,11,1,12,-2,1183,9.7693088939,-0.096725831,0.5319920685,0.0483629153,0.5803549838,6971
28067,"Jones","Mississippi","US","2020-05-24 02:32:43",31.62257767,-89.168969,435,13,0,422,"Jones, Mississippi, US",68098,-98,883,813,70,20,-186,-166,-2,1919,11.9300923,1.027191219,0.2934832054,-2.72939381,-2.435910605,28387
37103,"Jones","North Carolina","US","2020-05-24 02:32:43",35.02254606,-77.35870791,28,3,0,25,"Jones, North Carolina, US",9419,-194,91,118,-27,-2,-166,-168,1,90,12.400168138,-2.837326608,-0.210172341,-17.44430433,-17.65447667,2009
48253,"Jones","Texas","US","2020-05-24 02:32:43",32.73997145,-99.87861576,134,0,0,134,"Jones, Texas, US",20083,217,156,156,0,1,218,219,-2,5259,7.8099576961,0,0.0500638314,10.913915242,10.963979073,4215
41033,"Josephine","Oregon","US","2020-05-24 02:32:43",42.3665549,-123.5561938,25,1,0,24,"Josephine, Oregon, US",87487,337,866,1190,-324,-26,693,667,-6,1557,13.628268924,-3.710553892,-0.297760497,7.9364624908,7.6387019933,26273
2110,"Juneau","Alaska","US","2020-05-24 02:32:43",58.45031811,-134.200436,31,0,0,31,"Juneau, Alaska, US",31974,-63,340,177,163,20,-247,-227,1,985,5.5302994798,5.0928746622,0.6248925966,-7.717423568,-7.092530971,17899
55057,"Juneau","Wisconsin","US","2020-05-24 02:32:43",43.92456975,-90.11120239,22,1,0,21,"Juneau, Wisconsin, US",26687,94,270,255,15,1,78,79,0,1634,9.5720720721,0.5630630631,0.0375375375,2.9279279279,2.9654654655,10081
42067,"Juniata","Pennsylvania","US","2020-05-24 02:32:43",40.53358749,-77.3997513,94,4,0,90,"Juniata, Pennsylvania, US",24763,45,276,252,24,14,9,23,-2,292,10.185727855,0.9700693195,0.5658737697,0.3637759948,0.9296497646,7587
26077,"Kalamazoo","Michigan","US","2020-05-24 02:32:43",42.24542231,-85.53038622,793,47,0,746,"Kalamazoo, Michigan, US",265066,386,3010,2209,801,303,-715,-412,-3,8255,8.3398458884,3.0240907907,1.1439444564,-2.699406886,-1.555462429,127003
26079,"Kalkaska","Michigan","US","2020-05-24 02:32:43",44.68512729,-85.09085699,19,2,0,17,"Kalkaska, Michigan, US",18038,232,171,173,-2,3,229,232,2,138,9.65294052,-0.111594688,0.1673920321,12.777591787,12.944983819,4633
27065,"Kanabec","Minnesota","US","2020-05-24 02:32:43",45.9459309,-93.29275192,11,1,0,10,"Kanabec, Minnesota, US",16337,91,180,142,38,9,44,53,0,246,8.7162017003,2.3325046804,0.552435319,2.700794893,3.2532302121,4477
54039,"Kanawha","West Virginia","US","2020-05-24 02:32:43",38.33860077,-81.52857054,212,18,0,194,"Kanawha, West Virginia, US",178124,-2286,1834,2471,-637,-18,-1633,-1651,2,3306,13.783908918,-3.553358956,-0.100408887,-9.109317387,-9.209726274,102677
27067,"Kandiyohi","Minnesota","US","2020-05-24 02:32:43",45.1526059,-95.00586446,449,1,0,448,"Kandiyohi, Minnesota, US",43199,289,568,370,198,193,-100,93,-2,1047,8.5937590728,4.5988224227,4.4826905434,-2.322637587,2.1600529561,22562
17089,"Kane","Illinois","US","2020-05-24 02:32:43",41.93842729,-88.42861412,5484,152,0,5332,"Kane, Illinois, US",532403,-317,6249,3464,2785,-81,-3026,-3107,5,6818,6.5044131053,5.2294429845,-0.15209511,-5.68197288,-5.83406799,219452
17091,"Kankakee","Illinois","US","2020-05-24 02:32:43",41.13746989,-87.86205334,783,42,0,741,"Kankakee, Illinois, US",109862,-91,1240,1167,73,29,-192,-163,-1,6268,10.618019698,0.6641948912,0.2638582444,-1.746923549,-1.483065305,45084
48255,"Karnes","Texas","US","2020-05-24 02:32:43",28.90705334,-97.85960149,4,0,0,4,"Karnes, Texas, US",15601,-59,165,157,8,86,-154,-68,1,3014,10.044464349,0.5118198394,5.5020632737,-9.852531909,-4.350468635,8119
15007,"Kauai","Hawaii","US","2020-05-24 02:32:43",22.03935037,-159.5966786,20,0,0,20,"Kauai, Hawaii, US",72293,125,794,704,90,269,-230,39,-4,1179,9.7465752002,1.2460110341,3.7241885353,-3.184250421,0.5399381148,33256
48257,"Kaufman","Texas","US","2020-05-24 02:32:43",32.5991417,-96.28734728,173,2,0,171,"Kaufman, Texas, US",136154,7875,1796,1056,740,-4,7124,7120,15,1270,7.9869002734,5.5968808734,-0.03025341,53.881323435,53.851070025,28885
40071,"Kay","Oklahoma","US","2020-05-24 02:32:43",36.81799745,-97.14421435,52,7,0,45,"Kay, Oklahoma, US",43538,-406,537,576,-39,-2,-363,-365,-2,1276,13.168423218,-0.891611989,-0.045723692,-8.298850049,-8.344573741,20272
31099,"Kearney","Nebraska","US","2020-05-24 02:32:43",40.50663314,-98.94877182,11,0,0,11,"Kearney, Nebraska, US",6495,-44,80,62,18,-1,-60,-61,-1,73,9.513579868,2.7620070585,-0.153444837,-9.206690195,-9.360135031,3240
20093,"Kearny","Kansas","US","2020-05-24 02:32:43",38.00017981,-101.321681,40,1,0,39,"Kearny, Kansas, US",3838,-103,59,23,36,5,-146,-141,2,81,5.9133564726,9.2556883918,1.2855122766,-37.53695848,-36.2514462,1548
31101,"Keith","Nebraska","US","2020-05-24 02:32:43",41.19930341,-101.6620164,2,0,0,2,"Keith, Nebraska, US",8034,31,85,82,3,-5,34,29,-1,25,10.226351562,0.3741348132,-0.623558022,4.2401945501,3.616636528,4040
28069,"Kemper","Mississippi","US","2020-05-24 02:32:43",32.75462946,-88.64105766,118,10,0,108,"Kemper, Mississippi, US",9742,9,90,113,-23,0,33,33,-1,1061,11.604621309,-2.362002567,0,3.3889602054,3.3889602054,3626
2122,"Kenai Peninsula","Alaska","US","2020-05-24 02:32:43",60.24429722,-151.5388884,26,2,0,24,"Kenai Peninsula, Alaska, US",58708,147,665,541,124,20,6,26,-3,1686,9.2266498393,2.1147958966,0.3410961124,0.1023288337,0.4434249461,23631
17093,"Kendall","Illinois","US","2020-05-24 02:32:43",41.59081014,-88.42869583,689,19,0,670,"Kendall, Illinois, US",128990,1273,1473,580,893,107,277,384,-4,208,4.518770427,6.9573482609,0.8336352339,2.1581024281,2.991737662,31906
48259,"Kendall","Texas","US","2020-05-24 02:32:43",29.94414155,-98.7113588,24,0,0,24,"Kendall, Texas, US",47431,1828,403,392,11,27,1789,1816,1,527,8.4270266784,0.2364726874,0.58043296,38.459057979,39.039490939,13985
23011,"Kennebec","Maine","US","2020-05-24 02:32:43",44.40759555,-69.76738544,126,9,0,117,"Kennebec, Maine, US",122302,258,1113,1390,-277,40,500,540,-5,3757,11.377309225,-2.267276731,0.327404582,4.0925572753,4.4199618574,59723
55059,"Kenosha","Wisconsin","US","2020-05-24 02:32:43",42.57639354,-88.04051686,983,22,0,961,"Kenosha, Wisconsin, US",169561,635,1831,1369,462,-48,227,179,-6,4371,8.0889369459,2.729794645,-0.283615028,1.3412627368,1.0576477088,59853
10001,"Kent","Delaware","US","2020-05-24 02:32:43",39.08646628,-75.56884914,1296,56,0,1240,"Kent, Delaware, US",180786,2246,2127,1757,370,62,1812,1874,2,4578,9.7794203592,2.059411231,0.3450905306,10.085549056,10.430639586,67012
24029,"Kent","Maryland","US","2020-05-24 02:32:43",39.24976208,-76.04741541,148,15,0,133,"Kent, Maryland, US",19422,-12,142,284,-142,8,124,132,-2,1506,14.618077002,-7.309038501,0.411776817,6.382540663,6.7943174799,9154
26081,"Kent","Michigan","US","2020-05-24 02:32:43",43.03197711,-85.54934642,3308,67,0,3241,"Kent, Michigan, US",656955,3605,8637,4816,3821,1018,-1208,-190,-26,11461,7.3509602726,5.8322299007,1.5538367021,-1.843845517,-0.290008815,348435
44003,"Kent","Rhode Island","US","2020-05-24 02:32:43",41.67106337,-71.57641596,1005,0,0,1005,"Kent, Rhode Island, US",164292,239,1547,1673,-126,153,223,376,-11,1155,10.190500845,-0.767485419,0.9319465806,1.3583273691,2.2902739497,73241
21117,"Kenton","Kentucky","US","2020-05-24 02:32:43",38.93950319,-84.53241199,527,32,0,495,"Kenton, Kentucky, US",166998,706,2236,1501,735,-25,2,-23,-6,2685,9.0071709322,4.4105733745,-0.150019503,0.0120015602,-0.138017942,63755
19107,"Keokuk","Iowa","US","2020-05-24 02:32:43",41.33649833,-92.1785067,13,0,0,13,"Keokuk, Iowa, US",10246,33,121,103,18,4,12,16,-1,141,10.068918324,1.7596167946,0.3910259543,1.173077863,1.5641038174,3075
6029,"Kern","California","US","2020-05-24 02:32:43",35.34329425,-118.7277796,1757,29,0,1728,"Kern, California, US",900202,6444,13144,6478,6666,81,-291,-210,-12,32373,7.2220116391,7.4316038262,0.0903030168,-0.324421949,-0.234118932,322560
48265,"Kerr","Texas","US","2020-05-24 02:32:43",30.06040006,-99.34930144,11,0,0,11,"Kerr, Texas, US",52600,185,530,747,-217,29,374,403,-1,1988,14.226539066,-4.132742941,0.5523020521,7.1227919821,7.6750940342,20331
45055,"Kershaw","South Carolina","US","2020-05-24 02:32:43",34.33988254,-80.58763164,299,13,0,286,"Kershaw, South Carolina, US",66551,749,725,794,-69,28,793,821,-3,402,11.99821689,-1.042666203,0.4231109231,11.983105785,12.406216708,19531
2130,"Ketchikan Gateway","Alaska","US","2020-05-24 02:32:43",55.57445008,-130.975561,16,0,0,16,"Ketchikan Gateway, Alaska, US",13901,45,153,88,65,24,-42,-18,-2,267,6.3407428757,4.6835032604,1.7292935115,-3.026263645,-1.296970134,6884
55061,"Kewaunee","Wisconsin","US","2020-05-24 02:32:43",44.51727459,-87.61468386,33,1,0,32,"Kewaunee, Wisconsin, US",20434,39,196,192,4,28,8,36,-1,161,9.4050797227,0.1959391609,1.3715741262,0.3918783218,1.763452448,7977
31103,"Keya Paha","Nebraska","US","2020-05-24 02:32:43",42.87990694,-99.71343729,0,0,0,0,"Keya Paha, Nebraska, US",806,0,6,8,-2,0,2,2,0,0,9.9255583127,-2.481389578,0,2.4813895782,2.4813895782,362
31105,"Kimball","Nebraska","US","2020-05-24 02:32:43",41.19774275,-103.7148131,8,0,0,8,"Kimball, Nebraska, US",3632,54,34,43,-9,1,62,63,0,50,11.927877947,-2.496532594,0.2773925104,17.198335645,17.475728155,1648
48267,"Kimble","Texas","US","2020-05-24 02:32:43",30.48678918,-99.74856473,1,0,0,1,"Kimble, Texas, US",4337,-1,48,66,-18,0,16,16,1,34,15.216138329,-4.149855908,0,3.6887608069,3.6887608069,1885
53033,"King","Washington","US","2020-05-24 02:32:43",47.49137892,-121.8346131,7669,542,0,7127,"King, Washington, US",2252782,24418,25188,13917,11271,17969,-4784,13185,-38,39737,6.2113575411,5.0304096318,8.0198235005,-2.135168102,5.8846553984,1225496
51099,"King George","Virginia","US","2020-05-24 02:32:43",38.26818502,-77.15852768,52,4,0,48,"King George, Virginia, US",26836,224,287,169,118,3,104,107,-1,301,6.3239036072,4.4155066607,0.1122586439,3.8916329891,4.003891633,12584
51101,"King William","Virginia","US","2020-05-24 02:32:43",37.70965316,-77.09384941,20,0,0,20,"King William, Virginia, US",17148,229,204,141,63,1,166,167,-1,72,8.2778055009,3.6985939472,0.0587078404,9.7455015117,9.8042093522,4422
51097,"King and Queen","Virginia","US","2020-05-24 02:32:43",37.71044922,-76.88689628,7,0,0,7,"King and Queen, Virginia, US",7025,-20,59,94,-35,1,14,15,0,0,13.361762615,-4.975124378,0.1421464108,1.9900497512,2.132196162,1425
40073,"Kingfisher","Oklahoma","US","2020-05-24 02:32:43",35.94530008,-97.94193268,13,0,0,13,"Kingfisher, Oklahoma, US",15765,-49,180,145,35,9,-93,-84,0,155,9.1833180278,2.2166629722,0.56999905,-5.889990183,-5.319991133,6933
6031,"Kings","California","US","2020-05-24 02:32:43",36.07409056,-119.8159973,506,2,0,504,"Kings, California, US",152940,1558,2321,887,1434,-74,197,123,1,16513,5.829351805,9.4242282845,-0.486326983,1.2946812915,0.8083543089,54129
46077,"Kingsbury","South Dakota","US","2020-05-24 02:32:43",44.36956169,-97.4913945,0,0,0,0,"Kingsbury, South Dakota, US",4939,13,66,50,16,1,-2,-1,-2,203,10.13684744,3.2437911809,0.2027369488,-0.405473898,-0.202736949,2098
20097,"Kiowa","Kansas","US","2020-05-24 02:32:43",37.55848695,-99.2856537,2,0,0,2,"Kiowa, Kansas, US",2475,-14,29,23,6,1,-20,-19,-1,149,9.2667203868,2.4174053183,0.4029008864,-8.058017728,-7.655116841,1444
40075,"Kiowa","Oklahoma","US","2020-05-24 02:32:43",34.91671958,-98.97720696,6,0,0,6,"Kiowa, Oklahoma, US",8708,-24,113,107,6,2,-32,-30,0,171,12.270642202,0.6880733945,0.2293577982,-3.669724771,-3.440366972,3192
8063,"Kit Carson","Colorado","US","2020-05-24 02:32:43",39.30497777,-102.6022199,26,3,0,23,"Kit Carson, Colorado, US",7097,-62,78,74,4,8,-75,-67,1,58,10.381593715,0.5611672278,1.1223344557,-10.52188552,-9.399551066,3673
53035,"Kitsap","Washington","US","2020-05-24 02:32:43",47.63479026,-122.6436061,160,2,0,158,"Kitsap, Washington, US",271473,2197,3023,2375,648,75,1469,1544,5,9132,8.7841124071,2.396675722,0.2773930234,5.4332046846,5.710597708,106982
53037,"Kittitas","Washington","US","2020-05-24 02:32:43",47.12521214,-120.679439,66,0,0,66,"Kittitas, Washington, US",47935,577,426,307,119,81,376,457,1,2595,6.4432854459,2.4975601566,1.7000199385,7.8914505787,9.5914705172,17647
27069,"Kittson","Minnesota","US","2020-05-24 02:32:43",48.77754106,-96.78317184,1,0,0,1,"Kittson, Minnesota, US",4298,30,66,52,14,3,14,17,-1,111,12.141022648,3.2687368667,0.7004436143,3.2687368667,3.969180481,1953
41035,"Klamath","Oregon","US","2020-05-24 02:32:43",42.68762984,-121.6496461,41,0,0,41,"Klamath, Oregon, US",68238,551,767,834,-67,-2,620,618,0,1095,12.271473239,-0.985837778,-0.029427993,9.1226779474,9.093249954,24675
48273,"Kleberg","Texas","US","2020-05-24 02:32:43",27.42435506,-97.69894948,14,1,0,13,"Kleberg, Texas, US",30680,-42,402,245,157,41,-241,-200,1,1587,7.9801960848,5.1138399401,1.3354613856,-7.849907169,-6.514445784,13199
53039,"Klickitat","Washington","US","2020-05-24 02:32:43",45.87325839,-120.7913598,24,3,0,21,"Klickitat, Washington, US",22425,289,222,223,-1,-4,293,289,1,198,10.008752048,-0.044882296,-0.179529185,13.15051278,12.970983596,7012
21119,"Knott","Kentucky","US","2020-05-24 02:32:43",37.35388197,-82.94981134,4,0,0,4,"Knott, Kentucky, US",14806,-270,142,205,-63,-2,-205,-207,0,816,13.720634496,-4.216585235,-0.133859849,-13.7206345,-13.85449434,3230
17095,"Knox","Illinois","US","2020-05-24 02:32:43",40.93148779,-90.2133034,94,0,0,94,"Knox, Illinois, US",49699,-279,559,620,-61,77,-296,-219,1,3930,12.440181787,-1.223953369,1.5449903187,-5.939183563,-4.394193244,21097
18083,"Knox","Indiana","US","2020-05-24 02:32:43",38.68861576,-87.4194665,24,0,0,24,"Knox, Indiana, US",36594,-2,390,394,-4,20,-17,3,-1,1878,10.766498155,-0.10930455,0.546522749,-0.464544337,0.0819784124,18564
21121,"Knox","Kentucky","US","2020-05-24 02:32:43",36.89225732,-83.85403396,8,0,0,8,"Knox, Kentucky, US",31145,-155,385,419,-34,-3,-117,-120,-1,691,13.419809432,-1.088958283,-0.096084554,-3.747297622,-3.843382176,8575
23013,"Knox","Maine","US","2020-05-24 02:32:43",44.11486325,-69.10529169,20,0,0,20,"Knox, Maine, US",39772,55,307,452,-145,3,199,202,-2,1478,11.372642756,-3.648303539,0.0754821422,5.0069820982,5.0824642403,20677
31107,"Knox","Nebraska","US","2020-05-24 02:32:43",42.63758421,-97.89178836,8,0,0,8,"Knox, Nebraska, US",8332,-73,100,99,1,2,-75,-73,-1,201,11.830077075,0.119495728,0.2389914561,-8.962179602,-8.723188146,3611
39083,"Knox","Ohio","US","2020-05-24 02:32:43",40.39830217,-82.42027563,23,1,0,22,"Knox, Ohio, US",62322,422,741,630,111,-5,319,314,-3,3629,10.143130846,1.7871230539,-0.080501038,5.135966254,5.0554652155,23284
47093,"Knox","Tennessee","US","2020-05-24 02:32:43",35.99508821,-83.94635435,326,5,0,321,"Knox, Tennessee, US",470313,4055,5154,4548,606,818,2627,3445,4,12458,9.7120239683,1.2940823493,1.7467976267,5.6098256299,7.3566232565,239358
48275,"Knox","Texas","US","2020-05-24 02:32:43",33.60519951,-99.7422906,1,0,0,1,"Knox, Texas, US",3664,2,41,37,4,4,-6,-2,0,104,10.101010101,1.092001092,1.092001092,-1.638001638,-0.546000546,1545
2150,"Kodiak Island","Alaska","US","2020-05-24 02:32:43",57.65529415,-153.7493579,1,0,0,1,"Kodiak Island, Alaska, US",12998,-252,168,53,115,33,-400,-367,0,390,4.0384029259,8.7625723865,2.5144772935,-30.47851265,-27.96403536,7743
27071,"Koochiching","Minnesota","US","2020-05-24 02:32:43",48.24539665,-93.78352843,4,0,0,4,"Koochiching, Minnesota, US",12229,-202,96,149,-53,3,-153,-150,1,241,12.084347121,-4.298459043,0.2433090024,-12.40875912,-12.16545012,5614
16055,"Kootenai","Idaho","US","2020-05-24 02:32:43",47.67282258,-116.7020872,66,0,0,66,"Kootenai, Idaho, US",165697,4488,1815,1503,312,-118,4277,4159,17,1476,9.1953038488,1.9088055894,-0.721920063,26.166543288,25.444623225,56443
18085,"Kosciusko","Indiana","US","2020-05-24 02:32:43",41.24521668,-85.86312322,71,1,0,70,"Kosciusko, Indiana, US",79456,40,1029,724,305,85,-346,-261,-4,1575,9.1142555013,3.8395689612,1.0700438089,-4.35570774,-3.285663931,37094
19109,"Kossuth","Iowa","US","2020-05-24 02:32:43",43.20405458,-94.20691791,7,0,0,7,"Kossuth, Iowa, US",14813,-65,164,152,12,5,-83,-78,1,238,10.2387929,0.8083257553,0.336802398,-5.590919807,-5.254117409,7857
55063,"La Crosse","Wisconsin","US","2020-05-24 02:32:43",43.90632465,-91.11451093,48,0,0,48,"La Crosse, Wisconsin, US",118016,-25,1160,997,163,-11,-172,-183,-5,5367,8.44711235,1.3810223802,-0.093197829,-1.45727515,-1.550472979,70844
4012,"La Paz","Arizona","US","2020-05-24 02:32:43",33.72854224,-113.9810029,49,1,0,48,"La Paz, Arizona, US",21108,69,191,310,-119,68,123,191,-3,374,14.710418298,-5.646902508,3.2268014331,5.8367143569,9.06351579,6770
8067,"La Plata","Colorado","US","2020-05-24 02:32:43",37.28632032,-107.8429014,76,1,0,75,"La Plata, Colorado, US",56221,-78,472,367,105,-11,-169,-180,-3,1872,6.5232847494,1.8663348738,-0.195520796,-3.003910416,-3.199431212,28037
48283,"La Salle","Texas","US","2020-05-24 02:32:43",28.34453111,-99.09908775,4,0,0,4,"La Salle, Texas, US",7520,27,92,41,51,21,-45,-24,0,1634,5.4619329914,6.7941117698,2.7975754346,-5.994804503,-3.197229068,5216
18087,"LaGrange","Indiana","US","2020-05-24 02:32:43",41.64232188,-85.42674232,59,2,0,57,"LaGrange, Indiana, US",39614,239,727,261,466,0,-230,-230,3,325,6.6085151097,11.799111269,0,-5.823595691,-5.823595691,14554
18091,"LaPorte","Indiana","US","2020-05-24 02:32:43",41.54366008,-86.74072188,387,21,0,366,"LaPorte, Indiana, US",109888,-93,1248,1215,33,7,-127,-120,-6,6384,11.05203553,0.3001787428,0.0636742788,-1.155233343,-1.091559065,41547
17099,"LaSalle","Illinois","US","2020-05-24 02:32:43",41.3442613,-88.88633881,134,10,0,124,"LaSalle, Illinois, US",108669,-490,1124,1252,-128,29,-389,-360,-2,3385,11.495308225,-1.17523918,0.2662651266,-3.571625319,-3.305360192,46219
22059,"LaSalle","Louisiana","US","2020-05-24 02:32:43",31.67884782,-92.15907765,45,1,0,44,"LaSalle, Louisiana, US",14892,-9,175,173,2,4,-14,-10,-1,1240,11.61346625,0.1342597254,0.2685194509,-0.939818078,-0.671298627,4737
20099,"Labette","Kansas","US","2020-05-24 02:32:43",37.19113093,-95.29849679,22,0,0,22,"Labette, Kansas, US",19618,-288,248,222,26,-3,-312,-315,1,480,11.233680802,1.3156563101,-0.151806497,-15.78787572,-15.93968222,10086
27073,"Lac qui Parle","Minnesota","US","2020-05-24 02:32:43",44.9973857,-96.17488219,3,0,0,3,"Lac qui Parle, Minnesota, US",6623,-41,58,98,-40,3,-4,-1,0,154,14.751260631,-6.020922706,0.451569203,-0.602092271,-0.150523068,2777
42069,"Lackawanna","Pennsylvania","US","2020-05-24 02:32:43",41.43564672,-75.60379201,1476,152,0,1324,"Lackawanna, Pennsylvania, US",209674,-595,2037,2530,-493,395,-489,-94,-8,7431,12.049254304,-2.347937696,1.8812076877,-2.328887492,-0.447679804,98495
29105,"Laclede","Missouri","US","2020-05-24 02:32:43",37.65896829,-92.5888493,3,0,0,3,"Laclede, Missouri, US",35723,127,474,396,78,-2,53,51,-2,345,11.105035124,2.1873554032,-0.056086036,1.4862799534,1.4301939175,14656
5073,"Lafayette","Arkansas","US","2020-05-24 02:32:43",33.24116713,-93.60677071,9,1,0,8,"Lafayette, Arkansas, US",6624,-55,61,94,-33,-1,-20,-21,-1,105,14.132150643,-4.961286928,-0.150342028,-3.006840562,-3.15718259,1711
12067,"Lafayette","Florida","US","2020-05-24 02:32:43",29.98484137,-83.18166636,8,0,0,8,"Lafayette, Florida, US",8422,-269,63,77,-14,-5,-254,-259,4,1261,8.9990066032,-1.636183019,-0.584351078,-29.68503477,-30.26938585,1940
22055,"Lafayette","Louisiana","US","2020-05-24 02:32:43",30.2049055,-92.06959876,637,23,0,614,"Lafayette, Louisiana, US",244390,1277,3208,1999,1209,184,-113,71,-3,5157,8.2009751735,4.9599694771,0.7548671495,-0.463586891,0.2912802588,142027
28071,"Lafayette","Mississippi","US","2020-05-24 02:32:43",34.35687874,-89.48490961,118,3,0,115,"Lafayette, Mississippi, US",54019,477,513,395,118,19,342,361,-2,4625,7.3446695364,2.1941038109,0.3532879017,6.3591822315,6.7124701332,23287
29107,"Lafayette","Missouri","US","2020-05-24 02:32:43",39.06986886,-93.78076396,69,3,0,66,"Lafayette, Missouri, US",32708,166,356,371,-15,-7,192,185,-4,724,11.37164751,-0.459770115,-0.214559387,5.8850574713,5.6704980843,10335
55065,"Lafayette","Wisconsin","US","2020-05-24 02:32:43",42.66005229,-90.1317729,18,0,0,18,"Lafayette, Wisconsin, US",16665,-7,206,152,54,6,-67,-61,0,106,9.1189969103,3.2396436392,0.3599604044,-4.019557849,-3.659597444,5751
22057,"Lafourche","Louisiana","US","2020-05-24 02:32:43",29.52470226,-90.40976986,766,64,0,702,"Lafourche, Louisiana, US",97614,-367,1148,907,241,50,-656,-606,-2,1627,9.2742657021,2.4642756717,0.5112605128,-6.707737928,-6.196477415,39302
6033,"Lake","California","US","2020-05-24 02:32:43",39.10124298,-122.7536244,12,0,0,12,"Lake, California, US",64386,69,731,848,-117,-26,215,189,-3,1110,13.177626007,-1.818139437,-0.404030986,3.3410254617,2.9369944757,18046
8065,"Lake","Colorado","US","2020-05-24 02:32:43",39.20278823,-106.3555697,27,0,0,27,"Lake, Colorado, US",8127,281,86,28,58,0,220,220,3,154,3.5059162336,7.2622550554,0,27.546484693,27.546484693,3142
12069,"Lake","Florida","US","2020-05-24 02:32:43",28.76202069,-81.7125123,271,15,0,256,"Lake, Florida, US",367118,10398,3388,4431,-1043,215,11162,11377,64,3947,12.243070963,-2.881860306,0.594055576,30.841155065,31.435210641,89441
17097,"Lake","Illinois","US","2020-05-24 02:32:43",42.3224907,-88.00367925,7465,250,0,7215,"Lake, Illinois, US",696535,-3052,7261,4780,2481,817,-6404,-5587,54,18684,6.8475391119,3.5541306562,1.1703848231,-9.173983362,-8.003598539,359429
18089,"Lake","Indiana","US","2020-05-24 02:32:43",41.41874274,-87.38277575,3191,167,0,3024,"Lake, Indiana, US",485493,1053,5438,5029,409,260,413,673,-29,6488,10.369788429,0.8433572216,0.5361195052,0.851605214,1.3877247191,196435
26085,"Lake","Michigan","US","2020-05-24 02:32:43",43.99050893,-85.802173,5,0,0,5,"Lake, Michigan, US",11853,-23,115,162,-47,3,23,26,-2,264,13.654178431,-3.961397446,0.2528551561,1.9385561971,2.1914113532,2099
27075,"Lake","Minnesota","US","2020-05-24 02:32:43",47.64270764,-91.44557998,1,0,0,1,"Lake, Minnesota, US",10641,31,105,134,-29,5,58,63,-3,224,12.611171239,-2.729283328,0.470566091,5.4585666557,5.9291327467,4454
30047,"Lake","Montana","US","2020-05-24 02:32:43",47.64514965,-114.0898013,5,0,0,5,"Lake, Montana, US",30458,238,317,331,-14,-5,261,256,-4,585,10.910049771,-0.461452256,-0.164804377,8.6027884901,8.4379841129,10420
39085,"Lake","Ohio","US","2020-05-24 02:32:43",41.69710807,-81.23676539,263,12,0,251,"Lake, Ohio, US",230149,47,2192,2481,-289,69,281,350,-14,2811,10.781073805,-1.255836489,0.2998363936,1.2210728494,1.520909243,95724
46079,"Lake","South Dakota","US","2020-05-24 02:32:43",44.02193107,-97.12926365,5,0,0,5,"Lake, South Dakota, US",12797,-258,129,113,16,-3,-273,-276,2,879,8.742070246,1.2378152561,-0.232090361,-21.12022281,-21.35231317,5999
47095,"Lake","Tennessee","US","2020-05-24 02:32:43",36.3418017,-89.48921915,408,0,0,408,"Lake, Tennessee, US",7016,-391,57,92,-35,0,-360,-360,4,2184,12.757401373,-4.853359218,0,-49.92026624,-49.92026624,1959
1075,"Lamar","Alabama","US","2020-05-24 02:32:43",33.77995024,-88.09668032,18,0,0,18,"Lamar, Alabama, US",13805,-77,159,172,-13,-1,-64,-65,1,217,12.424603605,-0.939068877,-0.072236067,-4.623108318,-4.695344385,4113
13171,"Lamar","Georgia","US","2020-05-24 02:32:43",33.07841647,-84.14263877,50,1,0,49,"Lamar, Georgia, US",19077,116,215,236,-21,25,113,138,-1,1174,12.408643988,-1.104158999,1.3144749987,5.9414269941,7.2559019927,4574
28073,"Lamar","Mississippi","US","2020-05-24 02:32:43",31.20572971,-89.5077704,218,4,0,214,"Lamar, Mississippi, US",63343,706,793,438,355,34,317,351,0,395,6.9534846801,5.6358152088,0.5397682172,5.0325448484,5.5723130656,20663
48277,"Lamar","Texas","US","2020-05-24 02:32:43",33.66981763,-95.57404777,126,9,0,117,"Lamar, Texas, US",49859,130,619,661,-42,2,172,174,-2,701,13.27469173,-0.843475117,0.0401654818,3.4542314335,3.4943969153,21253
48279,"Lamb","Texas","US","2020-05-24 02:32:43",34.06859623,-102.3516289,11,0,0,11,"Lamb, Texas, US",12893,-210,167,141,26,0,-236,-236,0,179,10.847822742,2.0003077397,0,-18.15663948,-18.15663948,5078
50015,"Lamoille","Vermont","US","2020-05-24 02:32:43",44.60353043,-72.64356694,29,1,0,28,"Lamoille, Vermont, US",25362,67,228,181,47,4,18,22,-2,738,7.1461002428,1.8556171901,0.1579248672,0.7106619026,0.8685867698,12256
48281,"Lampasas","Texas","US","2020-05-24 02:32:43",31.19531316,-98.24206613,8,0,0,8,"Lampasas, Texas, US",21428,294,204,210,-6,1,298,299,1,225,9.8679573328,-0.281941638,0.046990273,14.003101358,14.050091631,5325
31109,"Lancaster","Nebraska","US","2020-05-24 02:32:43",40.78416049,-96.68777155,1033,6,0,1027,"Lancaster, Nebraska, US",319090,2563,3883,2145,1738,799,36,835,-10,15145,6.7493474844,5.4687020643,2.5140926061,0.113275762,2.6273683681,167067
42071,"Lancaster","Pennsylvania","US","2020-05-24 02:32:43",40.03904563,-76.24770128,2790,279,0,2511,"Lancaster, Pennsylvania, US",545724,1755,7132,5160,1972,647,-852,-205,-12,12690,9.4705573038,3.6193680238,1.1874904216,-1.563743183,-0.376252761,241271
45057,"Lancaster","South Carolina","US","2020-05-24 02:32:43",34.68270843,-80.70513032,121,5,0,116,"Lancaster, South Carolina, US",98012,2977,1010,1026,-16,45,2933,2978,15,1991,10.629535813,-0.165762742,0.4662077111,30.386382591,30.852590302,23905
51103,"Lancaster","Virginia","US","2020-05-24 02:32:43",37.71889653,-76.46400482,10,0,0,10,"Lancaster, Virginia, US",10603,-93,62,206,-144,4,48,52,-1,183,19.343631156,-13.52176159,0.3756044885,4.5072538617,4.8828583502,5242
32015,"Lander","Nevada","US","2020-05-24 02:32:43",39.9332233,-117.0397075,19,0,0,19,"Lander, Nevada, US",5532,-15,76,37,39,-2,-53,-55,1,16,6.6793031862,7.0403466017,-0.361043415,-9.56765051,-9.928693925,2759
20101,"Lane","Kansas","US","2020-05-24 02:32:43",38.48119447,-100.4660754,1,0,0,1,"Lane, Kansas, US",1535,-11,13,17,-4,0,-7,-7,0,3,11.035378124,-2.596559559,0,-4.543979228,-4.543979228,874
41039,"Lane","Oregon","US","2020-05-24 02:32:43",43.93727035,-122.847753,67,2,0,65,"Lane, Oregon, US",382067,3518,3425,3631,-206,230,3487,3717,7,8711,9.5475246379,-0.541666228,0.6047729735,9.1688841676,9.7736571411,156340
55067,"Langlade","Wisconsin","US","2020-05-24 02:32:43",45.26271619,-89.07483625,1,0,0,1,"Langlade, Wisconsin, US",19189,-47,188,236,-48,9,-6,3,-2,281,12.283669486,-2.498373455,0.4684450228,-0.312296682,0.1561483409,7945
13173,"Lanier","Georgia","US","2020-05-24 02:32:43",31.0382857,-83.06472457,12,2,0,10,"Lanier, Georgia, US",10423,68,116,114,2,-4,70,66,0,260,10.973144672,0.19251131,-0.38502262,6.7378958514,6.3528732313,1663
26087,"Lapeer","Michigan","US","2020-05-24 02:32:43",43.09052506,-83.22153148,187,30,0,157,"Lapeer, Michigan, US",87607,-314,753,892,-139,10,-183,-173,-2,1579,10.163620619,-1.583792899,0.1139419352,-2.085137414,-1.971195479,24559
56021,"Laramie","Wyoming","US","2020-05-24 02:32:43",41.3070252,-104.6887497,182,0,0,182,"Laramie, Wyoming, US",99500,635,1269,874,395,1,242,243,-3,2080,8.812038414,3.9825574068,0.0100824238,2.4399465632,2.450028987,50324
8069,"Larimer","Colorado","US","2020-05-24 02:32:43",40.66671597,-105.4625784,530,21,0,509,"Larimer, Colorado, US",356899,6239,3337,2295,1042,537,4638,5175,22,9367,6.4870915358,2.9453374206,1.5178946208,13.109860803,14.627755424,152968
21123,"Larue","Kentucky","US","2020-05-24 02:32:43",37.54567114,-85.70138352,7,0,0,7,"Larue, Kentucky, US",14398,99,174,157,17,-3,86,83,-1,313,10.941910304,1.1847928355,-0.209081089,5.9936578736,5.784576785,3383
8071,"Las Animas","Colorado","US","2020-05-24 02:32:43",37.3153406,-104.0376458,5,0,0,5,"Las Animas, Colorado, US",14506,-2,117,160,-43,18,24,42,-1,902,11.029158337,-2.964086303,1.240780313,1.6543737506,2.8951540636,6129
6035,"Lassen","California","US","2020-05-24 02:32:43",40.67311306,-120.5935099,2,0,0,2,"Lassen, California, US",30573,-45,281,202,79,7,-133,-126,2,7661,6.6022781128,2.5820790639,0.2287918158,-4.3470445,-4.118252684,10037
16057,"Latah","Idaho","US","2020-05-24 02:32:43",46.81587887,-116.7113698,7,0,0,7,"Latah, Idaho, US",40108,279,422,215,207,52,20,72,0,2773,5.3792361485,5.1790785243,1.3010245568,0.5003940603,1.8014186172,15334
40077,"Latimer","Oklahoma","US","2020-05-24 02:32:43",34.87844729,-95.25215049,5,1,0,4,"Latimer, Oklahoma, US",10073,-102,121,116,5,2,-109,-107,0,574,11.45792177,0.4938759384,0.1975503753,-10.76649546,-10.56894508,3664
1077,"Lauderdale","Alabama","US","2020-05-24 02:32:43",34.90171875,-87.65624729,126,2,0,124,"Lauderdale, Alabama, US",92729,125,876,1136,-260,35,355,390,-5,2280,12.259014854,-2.805760442,0.377698521,3.830942142,4.208640663,34315
28075,"Lauderdale","Mississippi","US","2020-05-24 02:32:43",32.40419769,-88.66229662,670,54,0,616,"Lauderdale, Mississippi, US",74125,-1113,910,861,49,-26,-1140,-1166,4,3468,11.528959649,0.6561196548,-0.348145123,-15.26482462,-15.61296974,37346
47097,"Lauderdale","Tennessee","US","2020-05-24 02:32:43",35.75893438,-89.6301591,51,1,0,50,"Lauderdale, Tennessee, US",25633,-364,283,265,18,-1,-381,-382,0,2176,10.265349603,0.6972690296,-0.038737168,-14.75886113,-14.7975983,7931
21125,"Laurel","Kentucky","US","2020-05-24 02:32:43",37.10975748,-84.11321779,21,2,0,19,"Laurel, Kentucky, US",60813,153,724,673,51,-9,115,106,-4,695,11.080651667,0.8396927712,-0.148181077,1.8934248763,1.745243799,23899
13175,"Laurens","Georgia","US","2020-05-24 02:32:43",32.46325233,-82.92221316,100,1,0,99,"Laurens, Georgia, US",47546,210,615,561,54,2,155,157,-1,1203,11.825214477,1.138255939,0.0421576274,3.2672161211,3.3093737484,18087
45059,"Laurens","South Carolina","US","2020-05-24 02:32:43",34.48244419,-82.00490796,57,3,0,54,"Laurens, South Carolina, US",67493,603,783,850,-67,49,621,670,0,2243,12.65040965,-0.997149937,0.7292589092,9.242240462,9.9714993712,22093
48285,"Lavaca","Texas","US","2020-05-24 02:32:43",29.38508402,-96.93186692,8,1,0,7,"Lavaca, Texas, US",20154,40,224,241,-17,12,47,59,-2,407,11.969802324,-0.844342903,0.5960067547,2.3343597894,2.9303665442,6924
1079,"Lawrence","Alabama","US","2020-05-24 02:32:43",34.52041498,-87.31069453,41,0,0,41,"Lawrence, Alabama, US",32924,-17,349,428,-79,-3,69,66,-4,229,12.99628027,-2.398846125,-0.091095422,2.0951947165,2.004099294,6961
5075,"Lawrence","Arkansas","US","2020-05-24 02:32:43",36.04188196,-91.10867198,82,5,0,77,"Lawrence, Arkansas, US",16406,-26,194,249,-55,-3,32,29,0,663,15.165357208,-3.349777697,-0.182715147,1.9489615689,1.7662464218,5450
17101,"Lawrence","Illinois","US","2020-05-24 02:32:43",38.71987914,-87.72884035,4,0,0,4,"Lawrence, Illinois, US",15678,-135,145,198,-53,4,-86,-82,0,2419,12.575021435,-3.366041091,0.2540408371,-5.461877997,-5.20783716,4507
18093,"Lawrence","Indiana","US","2020-05-24 02:32:43",38.84112637,-86.48361629,142,22,0,120,"Lawrence, Indiana, US",45370,-260,465,563,-98,5,-164,-159,-3,654,12.373626374,-2.153846154,0.1098901099,-3.604395604,-3.494505495,15633
21127,"Lawrence","Kentucky","US","2020-05-24 02:32:43",38.07136018,-82.72882223,1,0,0,1,"Lawrence, Kentucky, US",15317,-266,174,225,-51,-4,-210,-214,-1,108,14.563106796,-3.300970874,-0.258899676,-13.59223301,-13.85113269,3762
28077,"Lawrence","Mississippi","US","2020-05-24 02:32:43",31.55147224,-90.10841127,86,1,0,85,"Lawrence, Mississippi, US",12586,138,145,150,-5,0,145,145,-2,0,11.983702165,-0.399456739,0,11.584245426,11.584245426,3250
29109,"Lawrence","Missouri","US","2020-05-24 02:32:43",37.10626634,-93.83293097,8,0,0,8,"Lawrence, Missouri, US",38355,91,502,461,41,-22,75,53,-3,559,12.033568697,1.0702306216,-0.57427009,1.957738942,1.3834688524,10373
39087,"Lawrence","Ohio","US","2020-05-24 02:32:43",38.59743452,-82.53466552,28,0,0,28,"Lawrence, Ohio, US",59463,-304,610,793,-183,-24,-95,-119,-2,669,13.302021303,-3.069697224,-0.402583242,-1.593558668,-1.996141911,13507
42073,"Lawrence","Pennsylvania","US","2020-05-24 02:32:43",40.99206278,-80.33393706,74,8,0,66,"Lawrence, Pennsylvania, US",85512,-616,863,1090,-227,9,-396,-387,-2,2093,12.701002097,-2.645071079,0.1048706595,-4.614309019,-4.509438359,32145
46081,"Lawrence","South Dakota","US","2020-05-24 02:32:43",44.35919441,-103.7929428,9,0,0,9,"Lawrence, South Dakota, US",25844,117,224,233,-9,17,110,127,-1,1075,9.0360861725,-0.349033371,0.6592852572,4.2659634291,4.9252486863,12331
47099,"Lawrence","Tennessee","US","2020-05-24 02:32:43",35.21675201,-87.39787695,24,0,0,24,"Lawrence, Tennessee, US",44142,371,585,539,46,-5,331,326,-1,546,12.26212278,1.0464891427,-0.11374882,7.5301718745,7.4164230546,12089
40079,"Le Flore","Oklahoma","US","2020-05-24 02:32:43",34.89851864,-94.70392124,13,1,0,12,"Le Flore, Oklahoma, US",49853,-240,591,678,-87,39,-189,-150,-3,1612,13.567326356,-1.740940108,0.7804214276,-3.782042303,-3.001620875,14168
27079,"Le Sueur","Minnesota","US","2020-05-24 02:32:43",44.37136597,-93.72844721,41,1,0,40,"Le Sueur, Minnesota, US",28887,299,343,222,121,30,148,178,0,270,7.7250978686,4.2105263158,1.0439321444,5.1500652458,6.1939973902,8736
35025,"Lea","New Mexico","US","2020-05-24 02:32:43",32.79215361,-103.4123733,21,0,0,21,"Lea, New Mexico, US",71070,1527,1086,507,579,22,923,945,3,2072,7.2112820294,8.2353694182,0.312915591,13.128231387,13.441146978,30744
28079,"Leake","Mississippi","US","2020-05-24 02:32:43",32.7536828,-89.52402044,382,8,0,374,"Leake, Mississippi, US",22786,-5,299,274,25,-7,-23,-30,0,1678,12.023608399,1.097044562,-0.307172477,-1.009280997,-1.316453474,5816
20103,"Leavenworth","Kansas","US","2020-05-24 02:32:43",39.20183497,-95.03620809,1067,7,0,1060,"Leavenworth, Kansas, US",81758,261,940,639,301,17,-58,-41,1,6498,7.8282441579,3.6874827724,0.2082631466,-0.710544853,-0.502281707,26943
42075,"Lebanon","Pennsylvania","US","2020-05-24 02:32:43",40.36680311,-76.45651841,900,24,0,876,"Lebanon, Pennsylvania, US",141793,454,1581,1504,77,124,260,384,-7,3690,10.624019892,0.543915912,0.8759165336,1.8365991834,2.7125157171,54466
1081,"Lee","Alabama","US","2020-05-24 02:32:43",32.60154883,-85.35132246,488,32,0,456,"Lee, Alabama, US",164542,886,1825,1133,692,303,-112,191,3,4913,6.9043687043,4.2169665872,1.8464463525,-0.682514823,1.1639315291,56537
5077,"Lee","Arkansas","US","2020-05-24 02:32:43",34.78498904,-90.78383866,14,1,0,13,"Lee, Arkansas, US",8857,-119,81,120,-39,0,-80,-80,0,1738,13.45819548,-4.373913531,0,-8.97213032,-8.97213032,2375
12071,"Lee","Florida","US","2020-05-24 02:32:43",26.58410348,-81.88399313,1677,92,0,1585,"Lee, Florida, US",770577,16107,6760,7950,-1190,2183,15043,17226,71,8475,10.425908185,-1.56060764,2.8628625872,19.727916582,22.590779169,243397
13177,"Lee","Georgia","US","2020-05-24 02:32:43",31.7793306,-84.14324253,342,22,0,320,"Lee, Georgia, US",29992,241,325,245,80,3,161,164,-3,906,8.2017977001,2.6781380245,0.1004301759,5.3897527744,5.4901829503,4865
17103,"Lee","Illinois","US","2020-05-24 02:32:43",41.74583951,-89.29977132,76,1,0,75,"Lee, Illinois, US",34096,-200,338,376,-38,7,-169,-162,0,3041,10.995438063,-1.111241081,0.2047023044,-4.942098491,-4.737396187,14252
19111,"Lee","Iowa","US","2020-05-24 02:32:43",40.64181461,-91.48183025,20,0,0,20,"Lee, Iowa, US",33657,-252,370,398,-28,-5,-219,-224,0,1273,11.781073321,-0.828819229,-0.148003434,-6.482550395,-6.630553829,18638
28081,"Lee","Mississippi","US","2020-05-24 02:32:43",34.2918775,-88.68149954,101,5,0,96,"Lee, Mississippi, US",85436,160,1121,965,156,18,-12,6,-2,1060,11.305590702,1.8276395332,0.2108814846,-0.140587656,0.0702938282,50903
37105,"Lee","North Carolina","US","2020-05-24 02:32:43",35.47623147,-79.17569362,362,3,0,359,"Lee, North Carolina, US",61779,571,774,563,211,56,304,360,0,1035,9.1554391928,3.4312569621,0.9106653549,4.9436119265,5.8542772813,26957
45061,"Lee","South Carolina","US","2020-05-24 02:32:43",34.16393091,-80.25690731,187,13,0,174,"Lee, South Carolina, US",16828,-466,165,272,-107,2,-364,-362,3,1509,15.942793506,-6.271613622,0.1172264228,-21.33520896,-21.21798253,3712
48287,"Lee","Texas","US","2020-05-24 02:32:43",30.31120597,-96.97045773,8,0,0,8,"Lee, Texas, US",17239,142,208,164,44,-9,108,99,-1,488,9.5526561044,2.5629077353,-0.524231128,6.2907735322,5.7665424045,7040
51105,"Lee","Virginia","US","2020-05-24 02:32:43",36.70586667,-83.12606515,9,0,0,9,"Lee, Virginia, US",23423,-233,197,329,-132,-7,-95,-102,1,1460,13.976507572,-5.607595743,-0.297372502,-4.035769664,-4.333142165,5168
26089,"Leelanau","Michigan","US","2020-05-24 02:32:43",44.94430054,-85.80150326,11,0,0,11,"Leelanau, Michigan, US",21761,47,175,222,-47,9,87,96,-2,284,10.212765957,-2.162162162,0.4140310523,4.0023001725,4.4163312248,7582
28083,"Leflore","Mississippi","US","2020-05-24 02:32:43",33.55545125,-90.29900733,240,25,0,215,"Leflore, Mississippi, US",28183,-433,412,363,49,-5,-478,-483,1,1207,12.781915175,1.7253824891,-0.176059438,-16.83128224,-17.00734168,12699
42077,"Lehigh","Pennsylvania","US","2020-05-24 02:32:43",40.6154815,-75.59435245,3628,202,0,3426,"Lehigh, Pennsylvania, US",369318,959,4273,3347,926,818,-777,41,-8,9139,9.0744323057,2.5105839005,2.2177728193,-2.106613057,0.1111597623,180405
16059,"Lemhi","Idaho","US","2020-05-24 02:32:43",44.9438088,-113.9309747,1,0,0,1,"Lemhi, Idaho, US",8027,95,75,99,-24,-4,124,120,-1,80,12.406792406,-3.00770725,-0.501284542,15.539820791,15.038536249,3028
26091,"Lenawee","Michigan","US","2020-05-24 02:32:43",41.89475156,-84.06603727,145,3,0,142,"Lenawee, Michigan, US",98451,310,952,1007,-55,5,367,372,-7,5219,10.244567429,-0.559534467,0.0508667698,3.7336209001,3.7844876699,31225
37107,"Lenoir","North Carolina","US","2020-05-24 02:32:43",35.2403259,-77.64245615,182,7,0,175,"Lenoir, North Carolina, US",55949,-41,608,768,-160,42,80,122,-3,1128,13.721759172,-2.858699828,0.7504087047,1.4293499138,2.1797586185,27604
12073,"Leon","Florida","US","2020-05-24 02:32:43",30.45955727,-84.27491114,330,6,0,324,"Leon, Florida, US",293582,1925,2984,1945,1039,420,479,899,-13,15020,6.646857096,3.5506861299,1.4353110439,1.6369380715,3.0722491153,156788
48289,"Leon","Texas","US","2020-05-24 02:32:43",31.29872538,-95.9936328,9,0,0,9,"Leon, Texas, US",17404,144,196,212,-16,4,155,159,1,107,12.231710132,-0.923147934,0.2307869836,8.942995615,9.1737825987,6746
21131,"Leslie","Kentucky","US","2020-05-24 02:32:43",37.09246661,-83.37999606,6,0,0,6,"Leslie, Kentucky, US",9877,-274,95,163,-68,-1,-206,-207,1,227,16.277211903,-6.790493309,-0.099860196,-20.57120032,-20.67106052,1870
21133,"Letcher","Kentucky","US","2020-05-24 02:32:43",37.12306748,-82.85346474,4,0,0,4,"Letcher, Kentucky, US",21553,-260,233,310,-77,1,-185,-184,1,243,14.296914634,-3.551169119,0.0461190795,-8.532029701,-8.485910621,6024
12075,"Levy","Florida","US","2020-05-24 02:32:43",29.31829741,-82.74007147,27,0,0,27,"Levy, Florida, US",41503,705,409,551,-142,-1,845,844,3,334,13.389873756,-3.450747865,-0.024301041,20.534379898,20.510078857,9284
16061,"Lewis","Idaho","US","2020-05-24 02:32:43",46.23315327,-116.434146,0,0,0,0,"Lewis, Idaho, US",3838,6,34,37,-3,3,7,10,-1,72,9.6479791395,-0.782268579,0.7822685789,1.8252933507,2.6075619296,1528
21135,"Lewis","Kentucky","US","2020-05-24 02:32:43",38.53184419,-83.37735618,7,0,0,7,"Lewis, Kentucky, US",13275,7,164,164,0,-1,10,9,-2,139,12.357307011,0,-0.075349433,0.75349433,0.678144897,2630
29111,"Lewis","Missouri","US","2020-05-24 02:32:43",40.09673161,-91.72070156,7,1,0,6,"Lewis, Missouri, US",9776,-63,125,103,22,-2,-81,-83,-2,788,10.502166709,2.2431812388,-0.203925567,-8.25898547,-8.462911037,3258
36049,"Lewis","New York","US","2020-05-24 02:32:43",43.7844157,-75.44903992,19,0,0,19,"Lewis, New York, US",26296,-190,322,271,51,8,-250,-242,1,316,10.268652192,1.9324769808,0.303133644,-9.472926376,-9.169792732,8042
47101,"Lewis","Tennessee","US","2020-05-24 02:32:43",35.52853208,-87.49022694,3,0,0,3,"Lewis, Tennessee, US",12268,194,141,142,-1,-1,196,195,0,208,11.667077479,-0.082162517,-0.082162517,16.103853422,16.021690905,3261
53041,"Lewis","Washington","US","2020-05-24 02:32:43",46.57756476,-122.3925769,35,3,0,32,"Lewis, Washington, US",80707,1138,895,910,-15,65,1087,1152,1,907,11.355411914,-0.187177119,0.811100851,13.564101924,14.375202775,26497
54041,"Lewis","West Virginia","US","2020-05-24 02:32:43",38.9947249,-80.49988181,5,1,0,4,"Lewis, West Virginia, US",15907,-110,139,224,-85,4,-29,-25,0,248,14.033329157,-5.325147225,0.2505951635,-1.816814935,-1.566219772,6681
30049,"Lewis and Clark","Montana","US","2020-05-24 02:32:43",47.12610041,-112.394698,16,0,0,16,"Lewis and Clark, Montana, US",69432,810,742,653,89,-17,740,723,-2,1961,9.4600663508,1.289350544,-0.246280441,10.720442725,10.474162284,35712
45063,"Lexington","South Carolina","US","2020-05-24 02:32:43",33.89665987,-81.27146426,548,29,0,519,"Lexington, South Carolina, US",298750,4400,3191,2555,636,372,3398,3770,-6,2322,8.615747766,2.1446636318,1.2544258978,11.458438712,12.71286461,113352
51678,"Lexington","Virginia","US","2020-05-24 02:32:43",37.78258621,-79.44262866,6,0,0,6,"Lexington, Virginia, US",7446,149,115,58,57,0,91,91,1,2751,7.8681408126,7.7324832124,0,12.34484162,12.34484162,5188
12077,"Liberty","Florida","US","2020-05-24 02:32:43",30.23766008,-84.8829258,204,0,0,204,"Liberty, Florida, US",8354,-73,71,77,-6,-5,-62,-67,0,2050,9.1770454681,-0.715094452,-0.595912043,-7.389309338,-7.985221381,2432
13179,"Liberty","Georgia","US","2020-05-24 02:32:43",31.82588896,-81.49251135,64,0,0,64,"Liberty, Georgia, US",61435,829,1361,384,977,-45,-101,-146,-2,1310,6.2929671176,16.011012692,-0.737457084,-1.655181455,-2.39263854,35523
30051,"Liberty","Montana","US","2020-05-24 02:32:43",48.56084317,-111.024307,1,0,0,1,"Liberty, Montana, US",2337,-79,16,20,-4,-1,-73,-74,-1,403,8.415737429,-1.683147486,-0.420786871,-30.71744162,-31.13822849,984
48291,"Liberty","Texas","US","2020-05-24 02:32:43",30.15152688,-94.81205615,81,3,0,78,"Liberty, Texas, US",88219,2417,1208,828,380,-7,2050,2043,-6,4886,9.5160928853,4.3672890053,-0.080450061,23.560374897,23.479924837,17939
39089,"Licking","Ohio","US","2020-05-24 02:32:43",40.09136236,-82.48185785,201,10,0,191,"Licking, Ohio, US",176862,1196,1924,1662,262,57,886,943,-9,3608,9.4290382608,1.4864067535,0.3233785685,5.0265510825,5.349929651,61650
1083,"Limestone","Alabama","US","2020-05-24 02:32:43",34.81185586,-86.98310072,72,0,0,72,"Limestone, Alabama, US",98915,2738,1014,864,150,32,2545,2577,11,2648,8.8573596047,1.5377360425,0.3280503557,26.090254854,26.41830521,25357
48293,"Limestone","Texas","US","2020-05-24 02:32:43",31.5454767,-96.58095444,18,1,0,17,"Limestone, Texas, US",23437,94,253,279,-26,6,114,120,0,1578,11.928174434,-1.111586148,0.2565198803,4.8738777255,5.1303976058,9459
5079,"Lincoln","Arkansas","US","2020-05-24 02:32:43",33.95317155,-91.74002806,970,8,0,962,"Lincoln, Arkansas, US",13024,-160,100,146,-46,1,-113,-112,-2,3547,11.141636142,-3.51037851,0.0763125763,-8.623321123,-8.547008547,2841
8073,"Lincoln","Colorado","US","2020-05-24 02:32:43",38.98749519,-103.5136649,3,0,0,3,"Lincoln, Colorado, US",5701,95,61,44,17,4,73,77,1,1018,7.7827894225,3.0069868223,0.7075263111,12.912355178,13.619881489,2186
13181,"Lincoln","Georgia","US","2020-05-24 02:32:43",33.79201475,-82.45024131,15,0,0,15,"Lincoln, Georgia, US",7921,-4,75,94,-19,2,14,16,-1,67,11.864192856,-2.398081535,0.2524296352,1.7670074467,2.0194370819,1389
16063,"Lincoln","Idaho","US","2020-05-24 02:32:43",43.0012336,-114.1358773,30,0,0,30,"Lincoln, Idaho, US",5366,-32,66,41,25,23,-78,-55,-2,37,7.6179858789,4.6451133408,4.2735042735,-14.49275362,-10.21924935,1436
21137,"Lincoln","Kentucky","US","2020-05-24 02:32:43",37.45475628,-84.6565327,8,1,0,7,"Lincoln, Kentucky, US",24549,-63,329,288,41,-1,-104,-105,1,219,11.716604626,1.667988853,-0.040682655,-4.230996115,-4.27167877,4886
22061,"Lincoln","Louisiana","US","2020-05-24 02:32:43",32.6003154,-92.6659741,133,14,0,119,"Lincoln, Louisiana, US",46742,-370,516,417,99,85,-556,-471,2,4900,8.8861423061,2.1096596842,1.8113239713,-11.84818974,-10.03686577,20919
23015,"Lincoln","Maine","US","2020-05-24 02:32:43",44.05996956,-69.54227124,19,0,0,19,"Lincoln, Maine, US",34634,235,307,425,-118,15,341,356,-3,502,12.312951777,-3.418654846,0.4345747686,9.8793330726,10.313907841,12970
27081,"Lincoln","Minnesota","US","2020-05-24 02:32:43",44.41311883,-96.26688165,5,0,0,5,"Lincoln, Minnesota, US",5639,-29,70,75,-5,0,-24,-24,0,135,13.266118334,-0.884407889,0,-4.245157867,-4.245157867,2214
28085,"Lincoln","Mississippi","US","2020-05-24 02:32:43",31.53288662,-90.45391915,238,20,0,218,"Lincoln, Mississippi, US",34153,-57,413,403,10,6,-71,-65,-2,658,11.790003364,0.2925559147,0.1755335488,-2.077146995,-1.901613446,11436
29113,"Lincoln","Missouri","US","2020-05-24 02:32:43",39.05345619,-90.95588181,106,1,0,105,"Lincoln, Missouri, US",59013,1400,790,467,323,2,1072,1074,3,631,8.008505822,5.5390736199,0.0342976695,18.383550838,18.417848507,12157
30053,"Lincoln","Montana","US","2020-05-24 02:32:43",48.54265777,-115.4046155,7,1,0,6,"Lincoln, Montana, US",19980,183,158,282,-124,9,297,306,1,209,14.179048194,-6.23475878,0.4525228147,14.933252885,15.3857757,6593
31111,"Lincoln","Nebraska","US","2020-05-24 02:32:43",41.04658298,-100.7475374,47,2,0,45,"Lincoln, Nebraska, US",34914,-234,414,346,68,17,-320,-303,1,612,9.8769661157,1.9411378493,0.4852844623,-9.13476635,-8.649481887,17927
32017,"Lincoln","Nevada","US","2020-05-24 02:32:43",37.64268459,-114.8790388,2,0,0,2,"Lincoln, Nevada, US",5183,-54,55,62,-7,-2,-47,-49,2,291,11.900191939,-1.343570058,-0.383877159,-9.021113244,-9.404990403,1601
35027,"Lincoln","New Mexico","US","2020-05-24 02:32:43",33.74526079,-105.4586166,3,0,0,3,"Lincoln, New Mexico, US",19572,54,174,207,-33,18,71,89,-2,116,10.590943975,-1.688411358,0.92095165,3.6326426196,4.5535942696,7284
37109,"Lincoln","North Carolina","US","2020-05-24 02:32:43",35.48508185,-81.21740317,58,0,0,58,"Lincoln, North Carolina, US",86111,2019,834,891,-57,40,2031,2071,5,706,10.469850708,-0.669788429,0.4700269678,23.86561929,24.335646258,24752
40081,"Lincoln","Oklahoma","US","2020-05-24 02:32:43",35.70270942,-96.8812462,21,2,0,19,"Lincoln, Oklahoma, US",34877,40,354,379,-25,3,64,67,-2,386,10.872995381,-0.717216054,0.0860659265,1.8360730987,1.9221390252,8687
41041,"Lincoln","Oregon","US","2020-05-24 02:32:43",44.64252874,-123.869912,8,0,0,8,"Lincoln, Oregon, US",49962,738,385,609,-224,0,959,959,3,822,12.279958865,-4.516766479,0,19.337406489,19.337406489,19216
46083,"Lincoln","South Dakota","US","2020-05-24 02:32:43",43.27841182,-96.7203905,225,0,0,225,"Lincoln, South Dakota, US",61128,2333,866,252,614,-17,1727,1710,9,284,4.2026967304,10.239903938,-0.283515256,28.801814498,28.518299242,16435
47103,"Lincoln","Tennessee","US","2020-05-24 02:32:43",35.13738622,-86.58910106,26,0,0,26,"Lincoln, Tennessee, US",34366,177,386,433,-47,14,212,226,-2,297,12.63219313,-1.371161841,0.4084311866,6.184815112,6.5932462986,9880
53043,"Lincoln","Washington","US","2020-05-24 02:32:43",47.57705241,-118.4194388,2,0,0,2,"Lincoln, Washington, US",10939,213,105,118,-13,1,225,226,0,94,10.893145627,-1.200092315,0.0923147934,20.770828525,20.863143319,3578
54043,"Lincoln","West Virginia","US","2020-05-24 02:32:43",38.172154,-82.07017953,5,0,0,5,"Lincoln, West Virginia, US",20409,-174,208,313,-105,-6,-62,-68,-1,65,15.271272443,-5.12295082,-0.292740047,-3.024980484,-3.317720531,3137
55069,"Lincoln","Wisconsin","US","2020-05-24 02:32:43",45.33737523,-89.73411273,3,0,0,3,"Lincoln, Wisconsin, US",27593,-80,264,291,-27,0,-54,-54,1,588,10.530886983,-0.977092607,0,-1.954185213,-1.954185213,11339
56023,"Lincoln","Wyoming","US","2020-05-24 02:32:43",42.26376367,-110.6563997,15,0,0,15,"Lincoln, Wyoming, US",19830,385,222,138,84,0,302,302,-1,71,7.0273711012,4.2775302355,0,15.378739656,15.378739656,6928
19113,"Linn","Iowa","US","2020-05-24 02:32:43",42.07923082,-91.59809485,922,75,0,847,"Linn, Iowa, US",226706,943,2734,1801,933,168,-149,19,-9,5217,7.9607663729,4.124039437,0.7425923102,-0.658608656,0.0839836541,123819
20107,"Linn","Kansas","US","2020-05-24 02:32:43",38.21267844,-94.84254089,7,0,0,7,"Linn, Kansas, US",9703,-68,90,121,-31,0,-36,-36,-1,63,12.426825511,-3.183732156,0,-3.697237342,-3.697237342,2708
29115,"Linn","Missouri","US","2020-05-24 02:32:43",39.87001769,-93.10704106,5,1,0,4,"Linn, Missouri, US",11920,-119,124,163,-39,5,-84,-79,-1,152,13.606577904,-3.255561584,0.4173796903,-7.011978797,-6.594599107,5046
41043,"Linn","Oregon","US","2020-05-24 02:32:43",44.48899494,-122.5373154,112,9,0,103,"Linn, Oregon, US",129749,2298,1512,1310,202,21,2066,2087,9,1175,10.186625194,1.5707620529,0.1632970451,16.065318818,16.228615863,43647
48295,"Lipscomb","Texas","US","2020-05-24 02:32:43",36.27783108,-100.2733151,2,0,0,2,"Lipscomb, Texas, US",3233,-109,38,34,4,6,-119,-113,0,38,10.342205323,1.216730038,1.825095057,-36.19771863,-34.37262357,1437
9005,"Litchfield","Connecticut","US","2020-05-24 02:32:43",41.7937534,-73.2451475,1304,122,0,1182,"Litchfield, Connecticut, US",180333,-762,1382,1838,-456,263,-562,-299,-7,2470,10.170767068,-2.523324148,1.4553382693,-3.10988634,-1.65454807,69889
5081,"Little River","Arkansas","US","2020-05-24 02:32:43",33.70375665,-94.23468591,1,0,0,1,"Little River, Arkansas, US",12259,-38,136,176,-40,-3,6,3,-1,123,14.33458218,-3.257859586,-0.244339469,0.4886789379,0.244339469,3871
48297,"Live Oak","Texas","US","2020-05-24 02:32:43",28.35101362,-98.1246786,9,0,0,9,"Live Oak, Texas, US",12207,59,129,106,23,12,26,38,-2,1128,8.7045781154,1.8887292137,0.9854239376,2.1350851981,3.1205091357,5790
17105,"Livingston","Illinois","US","2020-05-24 02:32:43",40.89188292,-88.55784752,31,2,0,29,"Livingston, Illinois, US",35648,-66,422,412,10,32,-106,-74,-2,2322,11.546761582,0.2802612034,0.896835851,-2.970768756,-2.073932905,15359
21139,"Livingston","Kentucky","US","2020-05-24 02:32:43",37.21137452,-88.34797529,8,0,0,8,"Livingston, Kentucky, US",9194,-50,94,122,-28,0,-21,-21,-1,69,13.233539429,-3.037205771,0,-2.277904328,-2.277904328,2645
22063,"Livingston","Louisiana","US","2020-05-24 02:32:43",30.44143993,-90.73061664,366,26,0,340,"Livingston, Louisiana, US",140789,1395,1788,1170,618,-7,780,773,4,1189,8.3516844348,4.4114025476,-0.049967343,5.5677896232,5.5178222804,27644
26093,"Livingston","Michigan","US","2020-05-24 02:32:43",42.60302282,-83.91297209,390,26,0,364,"Livingston, Michigan, US",191995,805,1760,1607,153,53,611,664,-12,1387,8.3875934601,0.7985698814,0.2766287824,3.1890601146,3.465688897,57570
29117,"Livingston","Missouri","US","2020-05-24 02:32:43",39.78110272,-93.54645978,3,0,0,3,"Livingston, Missouri, US",15227,46,153,165,-12,3,55,58,0,1995,10.852407261,-0.789265983,0.1973164957,3.6174690871,3.8147855827,7253
36051,"Livingston","New York","US","2020-05-24 02:32:43",42.72596275,-77.77966158,114,7,0,107,"Livingston, New York, US",62914,-299,478,552,-74,50,-276,-226,1,5834,8.7530822108,-1.173420441,0.7928516495,-4.376541105,-3.583689456,22468
48299,"Llano","Texas","US","2020-05-24 02:32:43",30.70645047,-98.68475262,3,0,0,3,"Llano, Texas, US",21795,195,161,348,-187,-4,383,379,3,147,16.038714138,-8.618504436,-0.184353036,17.651803203,17.467450167,6337
5083,"Logan","Arkansas","US","2020-05-24 02:32:43",35.21413234,-93.71951016,4,0,0,4,"Logan, Arkansas, US",21466,-207,235,296,-61,10,-156,-146,0,579,13.723081203,-2.82806741,0.4636176082,-7.232434688,-6.76881708,6797
8075,"Logan","Colorado","US","2020-05-24 02:32:43",40.7249637,-103.110817,493,3,0,490,"Logan, Colorado, US",22409,141,217,195,22,6,115,121,-2,3868,8.7293238131,0.9848467892,0.2685945789,5.1480627616,5.4166573405,9908
17107,"Logan","Illinois","US","2020-05-24 02:32:43",40.12581572,-89.36638784,10,0,0,10,"Logan, Illinois, US",28618,-294,286,334,-48,13,-258,-245,-1,4139,11.611333217,-1.668694594,0.4519381192,-8.969233443,-8.517295324,9609
21141,"Logan","Kentucky","US","2020-05-24 02:32:43",36.85949479,-86.877635,115,3,0,112,"Logan, Kentucky, US",27102,119,360,307,53,-3,70,67,-1,277,11.352500693,1.9598779699,-0.110936489,2.5885180734,2.4775815845,8634
31113,"Logan","Nebraska","US","2020-05-24 02:32:43",41.56650314,-100.4817851,0,0,0,0,"Logan, Nebraska, US",748,-7,6,8,-2,2,-6,-4,-1,0,10.645375915,-2.661343979,2.6613439787,-7.984031936,-5.322687957,355
39091,"Logan","Ohio","US","2020-05-24 02:32:43",40.38996525,-83.76784341,38,0,0,38,"Logan, Ohio, US",45672,340,547,496,51,-2,294,292,-3,450,10.900619753,1.1208298536,-0.043954112,6.4612544504,6.4173003384,19255
40083,"Logan","Oklahoma","US","2020-05-24 02:32:43",35.91899576,-97.44352845,18,1,0,17,"Logan, Oklahoma, US",48011,763,494,371,123,1,639,640,0,2162,7.7892902508,2.5824331559,0.0209953915,13.416055176,13.437050567,9109
54045,"Logan","West Virginia","US","2020-05-24 02:32:43",37.8299889,-81.93528571,16,1,0,15,"Logan, West Virginia, US",32019,-590,349,487,-138,-1,-452,-453,1,682,15.070867116,-4.270594789,-0.030946339,-13.98774525,-14.01869159,12360
13183,"Long","Georgia","US","2020-05-24 02:32:43",31.75218791,-81.74952375,12,1,0,11,"Long, Georgia, US",19559,468,270,113,157,1,310,311,0,329,5.8473479948,8.1241914618,0.0517464424,16.041397154,16.093143596,1565
5085,"Lonoke","Arkansas","US","2020-05-24 02:32:43",34.75392199,-91.88742357,46,0,0,46,"Lonoke, Arkansas, US",73309,-82,858,690,168,-12,-242,-254,4,573,9.4069529652,2.2903885481,-0.163599182,-3.29925017,-3.462849352,16567
39093,"Lorain","Ohio","US","2020-05-24 02:32:43",41.29553751,-82.15083537,637,59,0,578,"Lorain, Ohio, US",309833,781,3175,3093,82,108,612,720,-21,8379,9.9953949441,0.2649926885,0.3490147604,1.977750309,2.3267650694,105425
35028,"Los Alamos","New Mexico","US","2020-05-24 02:32:43",35.86631386,-106.3134985,6,0,0,6,"Los Alamos, New Mexico, US",19369,381,173,111,62,62,256,318,1,94,5.787731053,3.2327867143,3.2327867143,13.348280627,16.581067341,16406
6037,"Los Angeles","California","US","2020-05-24 02:32:43",34.30828379,-118.2282411,44121,2092,0,42029,"Los Angeles, California, US",10039107,-34799,112963,68164,44799,21050,-100808,-79758,160,179406,6.778099333,4.4547278918,2.0931722164,-10.024157,-7.930984781,4665782
47105,"Loudon","Tennessee","US","2020-05-24 02:32:43",35.73939663,-84.31145275,131,0,0,131,"Loudon, Tennessee, US",54068,986,483,612,-129,30,1082,1112,3,552,11.423238451,-2.407839477,0.5599626692,20.195986934,20.755949603,15484
51107,"Loudoun","Virginia","US","2020-05-24 02:32:43",39.08990083,-77.63481877,1831,52,0,1779,"Loudoun, Virginia, US",413538,8016,5016,1602,3414,1039,3566,4605,-3,1696,3.9118013332,8.3363856128,2.5370546724,8.707542793,11.244597465,155439
19115,"Louisa","Iowa","US","2020-05-24 02:32:43",41.21842119,-91.26102611,334,7,0,327,"Louisa, Iowa, US",11035,-118,128,113,15,17,-151,-134,1,120,10.185685956,1.3520822066,1.5323598341,-13.61096088,-12.07860105,3980
51109,"Louisa","Virginia","US","2020-05-24 02:32:43",37.97850256,-77.96274807,67,1,0,66,"Louisa, Virginia, US",37591,807,388,383,5,0,799,799,3,211,10.299159664,0.1344537815,0,21.485714286,21.485714286,9587
40085,"Love","Oklahoma","US","2020-05-24 02:32:43",33.95273467,-97.23906784,14,0,0,14,"Love, Oklahoma, US",10253,97,113,112,1,6,90,96,0,88,10.975550002,0.0979959822,0.587975893,8.8196383948,9.4076142878,5471
1085,"Lowndes","Alabama","US","2020-05-24 02:32:43",32.1597283,-86.65158371,182,10,0,172,"Lowndes, Alabama, US",9726,-248,116,141,-25,-1,-223,-224,1,96,14.314720812,-2.538071066,-0.101522843,-22.63959391,-22.74111675,2379
13185,"Lowndes","Georgia","US","2020-05-24 02:32:43",30.83568832,-83.27056716,233,4,0,229,"Lowndes, Georgia, US",117406,1097,1643,993,650,112,336,448,-1,6029,8.4975290418,5.5623301885,0.9584322786,2.8752968359,3.8337291145,54979
28087,"Lowndes","Mississippi","US","2020-05-24 02:32:43",33.47386518,-88.4419153,158,7,0,151,"Lowndes, Mississippi, US",58595,-165,774,610,164,89,-417,-328,-1,1279,10.395807592,2.7949384347,1.51676537,-7.106642239,-5.589876869,27333
48303,"Lubbock","Texas","US","2020-05-24 02:32:43",33.61008596,-101.8204789,656,50,0,606,"Lubbock, Texas, US",310569,2942,3936,2609,1327,250,1366,1616,-1,12345,8.4406887136,4.2931368045,0.8088049745,4.4193103805,5.228115355,140390
19117,"Lucas","Iowa","US","2020-05-24 02:32:43",41.02958964,-93.32780803,4,0,0,4,"Lucas, Iowa, US",8600,-17,118,91,27,-2,-42,-44,0,65,10.57094732,3.136434919,-0.232328513,-4.878898763,-5.111227275,3758
39095,"Lucas","Ohio","US","2020-05-24 02:32:43",41.62101218,-83.65468618,2087,228,0,1859,"Lucas, Ohio, US",428348,-1264,5298,4561,737,182,-2187,-2005,4,9255,10.632197305,1.7180288125,0.4242622034,-5.098139773,-4.67387757,208039
26095,"Luce","Michigan","US","2020-05-24 02:32:43",46.47227431,-85.54471223,3,0,0,3,"Luce, Michigan, US",6229,-98,60,83,-23,1,-74,-73,-2,1210,13.220770946,-3.66358713,0.1592863969,-11.78719337,-11.62790698,2416
13187,"Lumpkin","Georgia","US","2020-05-24 02:32:43",34.57286511,-84.00425681,88,1,0,87,"Lumpkin, Georgia, US",33610,711,279,300,-21,-13,738,725,7,3052,9.0213354584,-0.631493482,-0.390924537,22.192485228,21.801560691,9421
35029,"Luna","New Mexico","US","2020-05-24 02:32:43",32.18179341,-107.7508826,8,1,0,7,"Luna, New Mexico, US",23709,-168,346,281,65,16,-247,-231,-2,548,11.810196276,2.7318959358,0.6724666919,-10.38120456,-9.708737864,8237
51111,"Lunenburg","Virginia","US","2020-05-24 02:32:43",36.94618528,-78.24133319,7,0,0,7,"Lunenburg, Virginia, US",12196,-19,117,159,-42,8,17,25,-2,1000,13.026914096,-3.441071648,0.6554422187,1.3928147147,2.0482569333,2636
42079,"Luzerne","Pennsylvania","US","2020-05-24 02:32:43",41.17823008,-75.98447579,2631,135,0,2496,"Luzerne, Pennsylvania, US",317417,-442,3241,3953,-712,732,-447,285,-15,11870,12.444984542,-2.241545407,2.3045101657,-1.407262355,0.8972478104,145456
42081,"Lycoming","Pennsylvania","US","2020-05-24 02:32:43",41.34310539,-77.06629984,158,13,0,145,"Lycoming, Pennsylvania, US",113299,-567,1133,1320,-187,65,-444,-379,-1,5329,11.621508595,-1.646380384,0.5722712566,-3.909052891,-3.336781634,56224
46085,"Lyman","South Dakota","US","2020-05-24 02:32:43",43.89522709,-99.85201878,11,0,0,11,"Lyman, South Dakota, US",3781,-23,65,25,40,0,-62,-62,-1,37,6.5919578115,10.547132498,0,-16.34805537,-16.34805537,1629
51680,"Lynchburg","Virginia","US","2020-05-24 02:32:43",37.40021399,-79.19888138,77,1,0,76,"Lynchburg, Virginia, US",82168,859,1197,792,405,205,248,453,1,11043,9.6894364345,4.9548254495,2.507998067,3.0340659542,5.5420640212,56516
48305,"Lynn","Texas","US","2020-05-24 02:32:43",33.17657705,-101.8162849,5,1,0,4,"Lynn, Texas, US",5951,103,71,43,28,1,75,76,-1,42,7.2887532842,4.7461649292,0.1695058903,12.712941775,12.882447665,1558
19119,"Lyon","Iowa","US","2020-05-24 02:32:43",43.38107862,-96.20926845,19,0,0,19,"Lyon, Iowa, US",11755,-60,171,115,56,5,-120,-115,-1,166,9.7581671616,4.7518031396,0.4242681375,-10.1824353,-9.758167162,4702
20111,"Lyon","Kansas","US","2020-05-24 02:32:43",38.45576156,-96.15275715,328,3,0,325,"Lyon, Kansas, US",33195,-105,389,276,113,47,-265,-218,0,1451,8.3013760433,3.3987517858,1.4136401233,-7.9705241,-6.556883976,15935
21143,"Lyon","Kentucky","US","2020-05-24 02:32:43",37.02080035,-88.07886257,14,3,0,11,"Lyon, Kentucky, US",8210,39,45,122,-77,-3,120,117,-1,1179,14.895305537,-9.401135462,-0.366278005,14.6511202,14.284842195,1974
27083,"Lyon","Minnesota","US","2020-05-24 02:32:43",44.41327865,-95.83806103,31,0,0,31,"Lyon, Minnesota, US",25474,-109,343,228,115,94,-319,-225,1,901,8.9311945473,4.5047691795,3.6821591555,-12.49583798,-8.81367883,15455
32019,"Lyon","Nevada","US","2020-05-24 02:32:43",39.01777974,-119.1870479,51,0,0,51,"Lyon, Nevada, US",57510,1697,664,619,45,-46,1691,1645,7,360,10.924525471,0.7941900585,-0.811838726,29.843897532,29.032058805,12474
26097,"Mackinac","Michigan","US","2020-05-24 02:32:43",46.07028979,-85.04980537,6,0,0,6,"Mackinac, Michigan, US",10799,18,88,138,-50,27,41,68,0,95,12.789620019,-4.633920297,2.5023169601,3.7998146432,6.3021316033,4509
26099,"Macomb","Michigan","US","2020-05-24 02:32:43",42.69158356,-82.92752801,6482,778,0,5704,"Macomb, Michigan, US",873972,1177,9132,8548,584,1281,-653,628,-35,7531,9.7872240545,0.6686638802,1.4667096413,-0.747666976,0.7190426657,329202
1087,"Macon","Alabama","US","2020-05-24 02:32:43",32.38759944,-85.69267724,58,2,0,56,"Macon, Alabama, US",18068,-253,172,264,-92,1,-162,-161,0,1597,14.509879359,-5.05647311,0.0549616642,-8.903789607,-8.848827943,6090
13193,"Macon","Georgia","US","2020-05-24 02:32:43",32.35207048,-84.04234127,95,6,0,89,"Macon, Georgia, US",12947,-213,124,160,-36,4,-182,-178,1,1894,12.257249014,-2.757881028,0.3064312253,-13.94262075,-13.63618953,3616
17115,"Macon","Illinois","US","2020-05-24 02:32:43",39.86064913,-88.96342505,187,18,0,169,"Macon, Illinois, US",104009,-495,1258,1223,35,34,-564,-530,0,4011,11.730683459,0.3357104833,0.3261187552,-5.409734645,-5.08361589,53752
29121,"Macon","Missouri","US","2020-05-24 02:32:43",39.83049768,-92.56453089,2,0,0,2,"Macon, Missouri, US",15117,-50,182,193,-11,6,-44,-38,-1,286,12.746004491,-0.726456215,0.3962488443,-2.905824858,-2.509576014,5422
37113,"Macon","North Carolina","US","2020-05-24 02:32:43",35.14867843,-83.41696617,8,1,0,7,"Macon, North Carolina, US",35858,584,333,417,-84,44,622,666,2,316,11.724680875,-2.361806219,1.2371365911,17.48861272,18.725749311,12607
47111,"Macon","Tennessee","US","2020-05-24 02:32:43",36.53157855,-86.00778595,97,3,0,94,"Macon, Tennessee, US",24602,313,341,281,60,4,247,251,2,365,11.494958172,2.4544394674,0.1636292978,10.104109141,10.267738439,6043
17117,"Macoupin","Illinois","US","2020-05-24 02:32:43",39.26119767,-89.92424028,41,1,0,40,"Macoupin, Illinois, US",44926,-392,447,561,-114,3,-282,-279,1,863,12.432959532,-2.526483755,0.0664864146,-6.249722973,-6.183236559,11722
6039,"Madera","California","US","2020-05-24 02:32:43",37.21513971,-119.7665589,82,2,0,80,"Madera, California, US",157327,445,2108,1060,1048,-139,-464,-603,0,7445,6.7471014516,6.670719171,-0.884761417,-2.953448183,-3.838209599,44353
1089,"Madison","Alabama","US","2020-05-24 02:32:43",34.76327133,-86.55069633,292,4,0,288,"Madison, Alabama, US",372909,5905,4242,3305,937,230,4721,4951,17,8940,8.9334827203,2.5327301994,0.6216947128,12.760959734,13.382654447,195636
5087,"Madison","Arkansas","US","2020-05-24 02:32:43",36.01038185,-93.72524943,3,0,0,3,"Madison, Arkansas, US",16576,214,207,141,66,-5,152,147,1,79,8.5615398628,4.0075292975,-0.303600704,9.2294614124,8.925860708,4019
12079,"Madison","Florida","US","2020-05-24 02:32:43",30.44396917,-83.47398594,67,3,0,64,"Madison, Florida, US",18493,-47,177,239,-62,15,1,16,-1,2021,12.907406907,-3.348364972,0.8100882996,0.0540058866,0.8640941863,4637
13195,"Madison","Georgia","US","2020-05-24 02:32:43",34.12920917,-83.21218732,37,1,0,36,"Madison, Georgia, US",29880,238,317,308,9,19,212,231,-2,248,10.349114613,0.3024091932,0.638419408,7.1234165519,7.7618359598,4483
16065,"Madison","Idaho","US","2020-05-24 02:32:43",43.78141028,-111.6538474,20,0,0,20,"Madison, Idaho, US",39907,646,1108,141,967,-12,-305,-317,-4,625,3.5620452708,24.429062247,-0.303152789,-7.705133387,-8.008286176,16780
17119,"Madison","Illinois","US","2020-05-24 02:32:43",38.83042506,-89.90422563,523,52,0,471,"Madison, Illinois, US",262966,-1060,2804,2944,-140,1,-920,-919,-1,3950,11.172845129,-0.531317363,0.003795124,-3.491514103,-3.487718979,105508
18095,"Madison","Indiana","US","2020-05-24 02:32:43",40.16143691,-85.71964711,576,58,0,518,"Madison, Indiana, US",129569,-4,1369,1445,-76,64,16,80,-8,6212,11.152186832,-0.586551003,0.4939376867,0.1234844217,0.6174221083,43335
19121,"Madison","Iowa","US","2020-05-24 02:32:43",41.33081904,-94.01554631,22,1,0,21,"Madison, Iowa, US",16338,132,158,154,4,3,126,129,-1,174,9.4641101278,0.2458210423,0.1843657817,7.7433628319,7.9277286136,4008
21151,"Madison","Kentucky","US","2020-05-24 02:32:43",37.71659336,-84.27220275,45,1,0,44,"Madison, Kentucky, US",92987,880,984,767,217,2,661,663,0,6469,8.2876808541,2.3447545571,0.0216106411,7.1423168768,7.1639275179,36394
22065,"Madison","Louisiana","US","2020-05-24 02:32:43",32.36918118,-91.23973355,54,0,0,54,"Madison, Louisiana, US",10951,-245,151,150,1,0,-247,-247,1,1599,13.545852711,0.0903056847,0,-22.30550413,-22.30550413,3422
28089,"Madison","Mississippi","US","2020-05-24 02:32:43",32.63389156,-90.03513564,639,21,0,618,"Madison, Mississippi, US",106272,624,1267,1107,160,121,344,465,-1,1761,10.447338618,1.510003775,1.1419403549,3.2465081163,4.3884484711,53225
29123,"Madison","Missouri","US","2020-05-24 02:32:43",37.47865134,-90.3467143,3,0,0,3,"Madison, Missouri, US",12088,-100,135,177,-42,-2,-55,-57,-1,165,14.58230351,-3.460207612,-0.164771791,-4.531224254,-4.695996045,3732
30057,"Madison","Montana","US","2020-05-24 02:32:43",45.30080065,-111.9173017,8,1,0,7,"Madison, Montana, US",8600,70,53,78,-25,0,95,95,0,163,9.1068301226,-2.918855809,0,11.091652072,11.091652072,3587
31119,"Madison","Nebraska","US","2020-05-24 02:32:43",41.91676024,-97.6005481,296,3,0,293,"Madison, Nebraska, US",35099,-90,497,369,128,71,-291,-220,2,1215,10.499658548,3.6421579786,2.0202595038,-8.280218529,-6.259959026,21463
36053,"Madison","New York","US","2020-05-24 02:32:43",42.91653905,-75.67266639,301,10,0,291,"Madison, New York, US",70941,-176,668,628,40,28,-242,-214,-2,4722,8.8414591223,0.5631502626,0.3942051838,-3.407059089,-3.012853905,24062
37115,"Madison","North Carolina","US","2020-05-24 02:32:43",35.85402722,-82.71346418,4,0,0,4,"Madison, North Carolina, US",21755,90,198,240,-42,19,112,131,1,1062,11.05481345,-1.934592354,0.8751727315,5.1589129433,6.0340856748,5845
39097,"Madison","Ohio","US","2020-05-24 02:32:43",39.89381073,-83.40178317,132,7,0,125,"Madison, Ohio, US",44731,342,441,394,47,12,283,295,0,4885,8.842010772,1.0547576302,0.2692998205,6.3509874327,6.6202872531,16585
47113,"Madison","Tennessee","US","2020-05-24 02:32:43",35.61181957,-88.84076036,164,2,0,162,"Madison, Tennessee, US",97984,381,1193,985,208,74,103,177,-4,4520,10.072244065,2.1269307265,0.7566965085,1.0532397347,1.8099362432,57490
48313,"Madison","Texas","US","2020-05-24 02:32:43",30.96694679,-95.93003775,8,0,0,8,"Madison, Texas, US",14284,-79,170,138,32,10,-121,-111,0,2582,9.6345167033,2.2340908298,0.6981533843,-8.44765595,-7.749502566,4869
51113,"Madison","Virginia","US","2020-05-24 02:32:43",38.41531222,-78.28220331,27,1,0,26,"Madison, Virginia, US",13261,13,129,128,1,11,2,13,-1,193,9.6570975895,0.0754460749,0.8299068241,0.1508921498,0.9807989739,3490
21153,"Magoffin","Kentucky","US","2020-05-24 02:32:43",37.70820545,-83.0657714,2,0,0,2,"Magoffin, Kentucky, US",12161,-162,127,172,-45,1,-121,-120,3,127,14.049991831,-3.675869956,0.081685999,-9.884005881,-9.802319882,2338
19123,"Mahaska","Iowa","US","2020-05-24 02:32:43",41.33521503,-92.64083907,51,5,0,46,"Mahaska, Iowa, US",22095,77,266,217,49,15,15,30,-2,698,9.8383696416,2.2215673384,0.6800716342,0.6800716342,1.3601432684,8618
27087,"Mahnomen","Minnesota","US","2020-05-24 02:32:43",47.32557075,-95.80921485,5,1,0,4,"Mahnomen, Minnesota, US",5527,30,90,60,30,0,2,2,-2,79,10.885341074,5.442670537,0,0.3628447025,0.3628447025,2576
39099,"Mahoning","Ohio","US","2020-05-24 02:32:43",41.01631101,-80.77287029,1317,169,0,1148,"Mahoning, Ohio, US",228683,-533,2355,2934,-579,22,38,60,-14,10217,12.815053101,-2.528941972,0.0960910594,0.1659754662,0.2620665256,101859
40093,"Major","Oklahoma","US","2020-05-24 02:32:43",36.31149996,-98.53467076,6,1,0,5,"Major, Oklahoma, US",7629,2,102,90,12,11,-21,-10,0,77,11.798636602,1.5731515469,1.4420555847,-2.753015207,-1.310959622,3170
41045,"Malheur","Oregon","US","2020-05-24 02:32:43",43.1937027,-117.6227395,28,0,0,28,"Malheur, Oregon, US",30571,18,396,260,136,-14,-103,-117,-1,3302,8.5072966429,4.4499705517,-0.458085204,-3.370198285,-3.828283489,13899
51683,"Manassas","Virginia","US","2020-05-24 02:32:43",38.7464321,-77.48509905,792,7,0,785,"Manassas, Virginia, US",41085,39,750,207,543,98,-601,-503,-1,46,5.0407276181,13.222778245,2.3864314327,-14.63515603,-12.2487246,23362
51685,"Manassas Park","Virginia","US","2020-05-24 02:32:43",38.77058531,-77.44399307,230,4,0,226,"Manassas Park, Virginia, US",17478,-240,14,37,-23,98,-314,-216,-1,6,2.1025116491,-1.306966701,5.568814638,-17.8429367,-12.27412206,3179
12081,"Manatee","Florida","US","2020-05-24 02:32:43",27.47196942,-82.31831044,958,91,0,867,"Manatee, Florida, US",403253,8866,3482,4334,-852,710,8954,9664,54,4813,10.867057821,-2.136302091,1.7802517426,22.451231132,24.231482874,116609
26101,"Manistee","Michigan","US","2020-05-24 02:32:43",44.33352407,-86.05626916,11,0,0,11,"Manistee, Michigan, US",24558,103,216,308,-92,12,184,196,-1,1364,12.568094179,-3.754106053,0.489666007,7.508212107,7.997878114,8447
55071,"Manitowoc","Wisconsin","US","2020-05-24 02:32:43",44.11946801,-87.80928853,28,1,0,27,"Manitowoc, Wisconsin, US",78981,-34,757,816,-59,67,-36,31,-6,985,10.329375427,-0.746854351,0.8481227373,-0.455707739,0.3924149978,36782
55073,"Marathon","Wisconsin","US","2020-05-24 02:32:43",44.89792533,-89.75863384,38,1,0,37,"Marathon, Wisconsin, US",135692,271,1480,1116,364,66,-154,-88,-5,1548,8.2327295261,2.6852271931,0.4868818537,-1.136057659,-0.649175805,71066
1091,"Marengo","Alabama","US","2020-05-24 02:32:43",32.24767634,-87.78796182,132,6,0,126,"Marengo, Alabama, US",18863,-193,209,276,-67,3,-129,-126,0,254,14.557345922,-3.533848466,0.1582320209,-6.803976898,-6.645744877,6373
4013,"Maricopa","Arizona","US","2020-05-24 02:32:43",33.34835867,-112.4918154,8177,383,0,7794,"Maricopa, Arizona, US",4485414,83011,52722,33023,19699,5520,57477,62997,315,67191,7.4310710943,4.4328095414,1.2421497877,12.933884665,14.176034453,1832427
29125,"Maries","Missouri","US","2020-05-24 02:32:43",38.16193985,-91.92249662,2,0,0,2,"Maries, Missouri, US",8697,-73,76,91,-15,4,-61,-57,-1,67,10.41964848,-1.717524475,0.4580065266,-6.984599531,-6.526593004,1404
6041,"Marin","California","US","2020-05-24 02:32:43",38.07122463,-122.7210631,369,14,0,355,"Marin, California, US",258826,-836,2149,1998,151,432,-1416,-984,-3,8307,7.707025042,0.5824628535,1.6663837929,-5.462035766,-3.795651973,128242
55075,"Marinette","Wisconsin","US","2020-05-24 02:32:43",45.38553432,-88.033246,31,2,0,29,"Marinette, Wisconsin, US",40350,-52,375,487,-112,3,60,63,-3,608,12.061620765,-2.773925104,0.0743015653,1.4860313057,1.560332871,20097
1093,"Marion","Alabama","US","2020-05-24 02:32:43",34.13697363,-87.88704173,109,10,0,99,"Marion, Alabama, US",29709,-41,302,405,-103,3,62,65,-3,735,13.62283254,-3.464572226,0.1009098707,2.0854706605,2.1863805311,10606
5089,"Marion","Arkansas","US","2020-05-24 02:32:43",36.26844485,-92.68451899,1,0,0,1,"Marion, Arkansas, US",16694,29,141,278,-137,-4,172,168,-2,141,16.667166282,-8.21367547,-0.239815342,10.312059714,10.072244372,4527
12083,"Marion","Florida","US","2020-05-24 02:32:43",29.21227113,-82.05803627,233,5,0,228,"Marion, Florida, US",365579,6517,3495,5162,-1667,15,8136,8151,33,9215,14.247054748,-4.600898928,0.0413998104,22.455257155,22.496656965,104886
13197,"Marion","Georgia","US","2020-05-24 02:32:43",32.3483402,-84.52733571,49,2,0,47,"Marion, Georgia, US",8359,-14,86,90,-4,-3,-8,-11,1,76,10.757829309,-0.478125747,-0.35859431,-0.956251494,-1.314845804,2195
17121,"Marion","Illinois","US","2020-05-24 02:32:43",38.64963204,-88.91899208,50,0,0,50,"Marion, Illinois, US",37205,-176,451,461,-10,10,-176,-166,0,759,12.361569195,-0.268146837,0.2681468372,-4.719384335,-4.451237498,15683
18097,"Marion","Indiana","US","2020-05-24 02:32:43",39.78163624,-86.13826325,9040,531,0,8509,"Marion, Indiana, US",964582,5882,14203,8190,6013,4759,-4866,-107,-24,18368,8.51669178,6.2528531957,4.9488322565,-5.060100391,-0.111268134,554531
19125,"Marion","Iowa","US","2020-05-24 02:32:43",41.33445101,-93.09934783,29,0,0,29,"Marion, Iowa, US",33253,-6,340,327,13,4,-23,-19,0,1286,9.8328121241,0.390906904,0.1202790474,-0.691604522,-0.571325475,17721
20115,"Marion","Kansas","US","2020-05-24 02:32:43",38.35855394,-97.0985251,5,1,0,4,"Marion, Kansas, US",11884,-39,107,142,-35,5,-10,-5,1,727,11.929264502,-2.940311673,0.4200445247,-0.840089049,-0.420044525,4321
21155,"Marion","Kentucky","US","2020-05-24 02:32:43",37.55218078,-85.26898542,18,0,0,18,"Marion, Kentucky, US",19273,-53,236,197,39,-4,-88,-92,0,504,10.207518329,2.0207777404,-0.207259255,-4.559703619,-4.766962875,8396
28091,"Marion","Mississippi","US","2020-05-24 02:32:43",31.23132643,-89.8209217,104,8,0,96,"Marion, Mississippi, US",24573,-179,278,307,-29,5,-154,-149,-1,720,12.448048657,-1.175874303,0.2027369488,-6.244298023,-6.041561075,8994
29127,"Marion","Missouri","US","2020-05-24 02:32:43",39.80601912,-91.62203062,5,0,0,5,"Marion, Missouri, US",28530,-10,346,310,36,12,-56,-44,-2,1371,10.863851411,1.2616085509,0.4205361836,-1.96250219,-1.541966007,15085
39101,"Marion","Ohio","US","2020-05-24 02:32:43",40.58610662,-83.15736305,2608,21,0,2587,"Marion, Ohio, US",65093,-334,734,731,3,28,-364,-336,-1,5826,11.201348452,0.0459699663,0.4290530187,-5.577689243,-5.148636224,25304
41047,"Marion","Oregon","US","2020-05-24 02:32:43",44.90287942,-122.5815117,898,25,0,873,"Marion, Oregon, US",347818,2406,4410,2893,1517,17,875,892,-3,10456,8.3464362477,4.3766138223,0.0490457712,2.5244146964,2.5734604677,140894
45067,"Marion","South Carolina","US","2020-05-24 02:32:43",34.07859748,-79.36400756,63,5,0,58,"Marion, South Carolina, US",30657,-399,341,444,-103,6,-302,-296,0,202,14.389188664,-3.338032505,0.1944484955,-9.787240938,-9.592792442,7715
47115,"Marion","Tennessee","US","2020-05-24 02:32:43",35.12997174,-85.62265895,36,1,0,35,"Marion, Tennessee, US",28907,309,325,358,-33,1,340,341,1,317,12.451091209,-1.147726285,0.0347795844,11.825058691,11.859838275,8439
48315,"Marion","Texas","US","2020-05-24 02:32:43",32.79868409,-94.3566123,15,0,0,15,"Marion, Texas, US",9854,-61,70,138,-68,0,9,9,-2,145,13.961252466,-6.879457737,0,0.9105164652,0.9105164652,2204
54049,"Marion","West Virginia","US","2020-05-24 02:32:43",39.50984542,-80.24244659,48,2,0,46,"Marion, West Virginia, US",56072,-19,594,673,-79,-17,79,62,-2,1401,12.000392286,-1.408664176,-0.303130266,1.4086641762,1.1055339105,20493
6043,"Mariposa","California","US","2020-05-24 02:32:43",37.57978556,-119.9073334,15,1,0,14,"Mariposa, California, US",17203,-202,149,180,-31,9,-179,-170,-1,725,10.40221914,-1.791493296,0.520110957,-10.34442903,-9.824318077,5959
45069,"Marlboro","South Carolina","US","2020-05-24 02:32:43",34.59905577,-79.67561152,109,0,0,109,"Marlboro, South Carolina, US",26118,-274,270,310,-40,1,-234,-233,-1,2716,11.807274805,-1.52351933,0.0380879832,-8.912588078,-8.874500095,7827
26103,"Marquette","Michigan","US","2020-05-24 02:32:43",46.4338914,-87.64043701,53,10,0,43,"Marquette, Michigan, US",66699,318,570,679,-109,30,397,427,0,4484,10.204388338,-1.638112414,0.4508566276,5.9663360385,6.4171926661,29433
55077,"Marquette","Wisconsin","US","2020-05-24 02:32:43",43.81911946,-89.40073763,3,1,0,2,"Marquette, Wisconsin, US",15574,156,135,169,-34,1,187,188,2,141,10.906040268,-2.19411461,0.0645327827,12.067630356,12.132163139,4281
1095,"Marshall","Alabama","US","2020-05-24 02:32:43",34.36975964,-86.30486727,644,9,0,635,"Marshall, Alabama, US",96774,604,1395,1155,240,65,303,368,-4,1045,11.97238577,2.4877684717,0.6737706277,3.1408076955,3.8145783232,37505
17123,"Marshall","Illinois","US","2020-05-24 02:32:43",41.0327901,-89.34510444,5,0,0,5,"Marshall, Illinois, US",11438,-45,117,151,-34,1,-11,-10,-1,255,13.175690415,-2.966711749,0.0872562279,-0.959818507,-0.872562279,3969
18099,"Marshall","Indiana","US","2020-05-24 02:32:43",41.32467367,-86.26185087,61,1,0,60,"Marshall, Indiana, US",46258,-38,582,477,105,56,-199,-143,0,671,10.307496164,2.2689456966,1.2101043715,-4.30019232,-3.090087949,19452
19127,"Marshall","Iowa","US","2020-05-24 02:32:43",42.03586837,-92.9990819,859,10,0,849,"Marshall, Iowa, US",39369,-519,514,478,36,35,-591,-556,1,1264,12.062026067,0.9084371097,0.8832027455,-14.91350922,-14.03030647,18919
21157,"Marshall","Kentucky","US","2020-05-24 02:32:43",36.8800707,-88.32803576,37,2,0,35,"Marshall, Kentucky, US",31100,-102,296,435,-139,1,37,38,-1,464,13.964238708,-4.462136047,0.0321016982,1.1877628327,1.2198645308,11541
27089,"Marshall","Minnesota","US","2020-05-24 02:32:43",48.35825983,-96.37017407,8,0,0,8,"Marshall, Minnesota, US",9336,-47,106,86,20,2,-69,-67,0,76,9.188525028,2.1368662856,0.2136866286,-7.372188685,-7.158502057,3034
28093,"Marshall","Mississippi","US","2020-05-24 02:32:43",34.76216286,-89.50299462,69,3,0,66,"Marshall, Mississippi, US",35294,-142,393,446,-53,-5,-81,-86,-3,1808,12.611338894,-1.498656864,-0.141382723,-2.290400113,-2.431782836,7935
40095,"Marshall","Oklahoma","US","2020-05-24 02:32:43",34.02311222,-96.76855464,7,0,0,7,"Marshall, Oklahoma, US",16931,204,200,170,30,5,168,173,1,329,10.101610316,1.7826371145,0.2971061858,9.9827678412,10.279874027,5017
46091,"Marshall","South Dakota","US","2020-05-24 02:32:43",45.75870838,-97.59855639,4,0,0,4,"Marshall, South Dakota, US",4935,14,73,41,32,2,-20,-18,0,373,8.3198051948,6.4935064935,0.4058441558,-4.058441558,-3.652597403,2082
47117,"Marshall","Tennessee","US","2020-05-24 02:32:43",35.45798777,-86.76420988,28,1,0,27,"Marshall, Tennessee, US",34375,569,411,344,67,15,485,500,2,402,10.090787756,1.9653569176,0.4400052801,14.226837389,14.666842669,10165
54051,"Marshall","West Virginia","US","2020-05-24 02:32:43",39.86064362,-80.66591062,27,0,0,27,"Marshall, West Virginia, US",30531,-290,276,388,-112,0,-177,-177,-1,553,12.648324423,-3.65106272,0,-5.769983049,-5.769983049,11498
12085,"Martin","Florida","US","2020-05-24 02:32:43",27.0772071,-80.43109784,483,9,0,474,"Martin, Florida, US",161000,258,1258,2026,-768,71,962,1033,-7,4213,12.59394173,-4.774011475,0.441347415,5.9799466653,6.4212940804,61873
18101,"Martin","Indiana","US","2020-05-24 02:32:43",38.7099921,-86.80373186,10,0,0,10,"Martin, Indiana, US",10255,36,111,102,9,-1,30,29,-2,133,9.9638565986,0.8791638175,-0.097684869,2.9305460584,2.8328611898,8073
21159,"Martin","Kentucky","US","2020-05-24 02:32:43",37.79990579,-82.51247478,3,0,0,3,"Martin, Kentucky, US",11195,-130,99,148,-49,-1,-81,-82,1,1420,13.143872114,-4.351687389,-0.088809947,-7.193605684,-7.282415631,2606
27091,"Martin","Minnesota","US","2020-05-24 02:32:43",43.67429718,-94.55099908,124,5,0,119,"Martin, Minnesota, US",19683,-89,234,224,10,1,-98,-97,-2,348,11.354707895,0.5069066025,0.0506906602,-4.967684704,-4.916994044,9692
37117,"Martin","North Carolina","US","2020-05-24 02:32:43",35.84326734,-77.10860251,52,4,0,48,"Martin, North Carolina, US",22440,-220,246,313,-67,-1,-152,-153,0,143,13.880266075,-2.971175166,-0.044345898,-6.740576497,-6.784922395,7656
48317,"Martin","Texas","US","2020-05-24 02:32:43",32.30600051,-101.9513518,3,1,0,2,"Martin, Texas, US",5771,90,86,50,36,0,57,57,-3,40,8.7320991966,6.2871114216,0,9.9545930842,9.9545930842,2427
51690,"Martinsville","Virginia","US","2020-05-24 02:32:43",36.68212094,-79.86352771,24,1,0,23,"Martinsville, Virginia, US",12554,-73,183,239,-56,10,-27,-17,0,377,18.982566221,-4.447797943,0.7942496327,-2.144474008,-1.350224376,8380
17125,"Mason","Illinois","US","2020-05-24 02:32:43",40.23917274,-89.91824452,17,0,0,17,"Mason, Illinois, US",13359,-174,127,175,-48,0,-128,-128,2,206,13.015023055,-3.569834895,0,-9.51955972,-9.51955972,4605
21161,"Mason","Kentucky","US","2020-05-24 02:32:43",38.59471935,-83.82151043,8,0,0,8,"Mason, Kentucky, US",17070,-10,208,190,18,11,-37,-26,-2,298,11.127379209,1.0541727672,0.6442166911,-2.166910688,-1.522693997,8841
26105,"Mason","Michigan","US","2020-05-24 02:32:43",43.99509218,-86.24988902,31,0,0,31,"Mason, Michigan, US",29144,60,285,306,-21,4,79,83,-2,442,10.510407364,-0.721302466,0.1373909459,2.7134711822,2.8508621282,11707
48319,"Mason","Texas","US","2020-05-24 02:32:43",30.71780434,-99.22629416,31,0,0,31,"Mason, Texas, US",4274,15,34,41,-7,7,15,22,0,3,9.6097503809,-1.640689089,1.6406890894,3.5157623345,5.1564514239,1849
53045,"Mason","Washington","US","2020-05-24 02:32:43",47.35007586,-123.1863685,34,1,0,33,"Mason, Washington, US",66768,1388,666,669,-3,130,1258,1388,3,2616,10.125011351,-0.045403638,1.9674909949,19.039259013,21.006750008,16593
54053,"Mason","West Virginia","US","2020-05-24 02:32:43",38.77071799,-82.02524219,15,0,0,15,"Mason, West Virginia, US",26516,-236,262,367,-105,-3,-126,-129,-2,684,13.77937974,-3.942329353,-0.112637982,-4.730795224,-4.843433206,6848
17127,"Massac","Illinois","US","2020-05-24 02:32:43",37.22078441,-88.71036614,7,0,0,7,"Massac, Illinois, US",13772,-251,138,178,-40,-3,-207,-210,-1,292,12.808059003,-2.878215506,-0.215866163,-14.89476525,-15.11063141,4042
48321,"Matagorda","Texas","US","2020-05-24 02:32:43",28.81955746,-96.01230294,67,5,0,62,"Matagorda, Texas, US",36643,77,520,371,149,7,-79,-72,0,380,10.13536587,4.0705377754,0.1912333183,-2.158204592,-1.966971274,14467
2170,"Matanuska-Susitna","Alaska","US","2020-05-24 02:32:43",62.31305045,-149.5741743,24,1,0,23,"Matanuska-Susitna, Alaska, US",108317,1202,1368,646,722,16,466,482,-2,2023,5.9972520331,6.7028110958,0.14853875,4.3261910951,4.4747298451,26553
51115,"Mathews","Virginia","US","2020-05-24 02:32:43",37.44164146,-76.34098896,5,0,0,5,"Mathews, Virginia, US",8834,42,67,126,-59,1,103,104,-3,86,14.29706116,-6.694655622,0.1134687394,11.687280154,11.800748894,2122
15009,"Maui","Hawaii","US","2020-05-24 02:32:43",20.86399628,-156.5689097,118,6,0,112,"Maui, Hawaii, US",167417,445,1834,1446,388,582,-517,65,-8,2862,8.6486098526,2.3206504999,3.4809757498,-3.09220698,0.3887687693,79181
47119,"Maury","Tennessee","US","2020-05-24 02:32:43",35.6187413,-87.07462444,78,0,0,78,"Maury, Tennessee, US",96387,2114,1244,937,307,19,1778,1797,10,1013,9.8290150005,3.2203923214,0.1993076681,18.651001783,18.850309451,33077
48323,"Maverick","Texas","US","2020-05-24 02:32:43",28.7429195,-100.3157686,94,1,0,93,"Maverick, Texas, US",58722,446,1042,393,649,79,-283,-204,1,1069,6.7180635566,11.094206739,1.3504504351,-4.837689533,-3.487239098,16895
40097,"Mayes","Oklahoma","US","2020-05-24 02:32:43",36.30179091,-95.23175116,29,4,0,25,"Mayes, Oklahoma, US",41100,-110,459,534,-75,11,-45,-34,-1,565,12.97533714,-1.822378812,0.2672822257,-1.093427287,-0.826145061,14920
40087,"McClain","Oklahoma","US","2020-05-24 02:32:43",35.01123903,-97.44572302,97,2,0,95,"McClain, Oklahoma, US",40474,587,414,386,28,9,551,560,-1,194,9.6066499919,0.6968554398,0.2239892485,13.713119548,13.937108797,10397
46087,"McCook","South Dakota","US","2020-05-24 02:32:43",43.6742571,-97.36863144,5,1,0,4,"McCook, South Dakota, US",5586,-15,90,65,25,4,-44,-40,0,312,11.62063109,4.469473496,0.7151157594,-7.866273353,-7.151157594,1910
45065,"McCormick","South Carolina","US","2020-05-24 02:32:43",33.90161443,-82.30794338,8,1,0,7,"McCormick, South Carolina, US",9463,55,53,153,-100,-1,157,156,-1,981,16.215356897,-10.59827248,-0.105982725,16.639287796,16.533305071,2102
21145,"McCracken","Kentucky","US","2020-05-24 02:32:43",37.05350953,-88.70445755,87,2,0,85,"McCracken, Kentucky, US",65418,111,734,823,-89,-9,213,204,-4,1190,12.591317652,-1.361637024,-0.137693632,3.2587492828,3.1210556512,40001
21147,"McCreary","Kentucky","US","2020-05-24 02:32:43",36.73874143,-84.48102924,13,0,0,13,"McCreary, Kentucky, US",17231,-59,191,192,-1,-4,-54,-58,0,2003,11.123663857,-0.057935749,-0.231742997,-3.12853046,-3.360273457,2914
48307,"McCulloch","Texas","US","2020-05-24 02:32:43",31.1925468,-99.34682807,3,0,0,3,"McCulloch, Texas, US",7984,2,86,108,-22,3,22,25,-1,96,13.528748591,-2.755856194,0.375798572,2.7558561944,3.1316547664,3787
40089,"McCurtain","Oklahoma","US","2020-05-24 02:32:43",34.11664328,-94.77222373,23,0,0,23,"McCurtain, Oklahoma, US",32832,-135,444,429,15,89,-238,-149,-1,454,13.03971185,0.4559339808,2.7052082858,-7.234152495,-4.528944209,11695
29119,"McDonald","Missouri","US","2020-05-24 02:32:43",36.62869595,-94.34867205,15,0,0,15,"McDonald, Missouri, US",22837,-126,364,220,144,24,-293,-269,-1,157,9.6069868996,6.288209607,1.0480349345,-12.79475983,-11.74672489,6941
17109,"McDonough","Illinois","US","2020-05-24 02:32:43",40.45674722,-90.67775541,79,4,0,75,"McDonough, Illinois, US",29682,-302,258,296,-38,77,-344,-267,3,3327,9.9218985687,-1.273757249,2.581034425,-11.53085509,-8.949820668,15176
37111,"McDowell","North Carolina","US","2020-05-24 02:32:43",35.67736232,-82.0482425,38,1,0,37,"McDowell, North Carolina, US",45756,291,437,513,-76,39,329,368,-1,1515,11.247410136,-1.666282983,0.8550662676,7.2132513347,8.0683176023,15694
54047,"McDowell","West Virginia","US","2020-05-24 02:32:43",37.38002939,-81.65083669,6,0,0,6,"McDowell, West Virginia, US",17624,-597,174,328,-154,-1,-442,-443,0,139,18.301018273,-8.592551262,-0.055795787,-24.66173804,-24.71753383,5077
13189,"McDuffie","Georgia","US","2020-05-24 02:32:43",33.47851918,-82.48252774,62,5,0,57,"McDuffie, Georgia, US",21312,-220,261,251,10,-11,-220,-231,1,266,11.716926524,0.4668098217,-0.513490804,-10.26981608,-10.78330688,7462
17111,"McHenry","Illinois","US","2020-05-24 02:32:43",42.32451172,-88.45248227,1360,67,0,1293,"McHenry, Illinois, US",307774,-477,3090,2198,892,7,-1381,-1374,5,1648,7.136074023,2.8959863642,0.0227263504,-4.48358427,-4.46085792,106479
38049,"McHenry","North Dakota","US","2020-05-24 02:32:43",48.23104458,-100.6324822,2,1,0,1,"McHenry, North Dakota, US",5745,-63,64,60,4,0,-67,-67,0,45,10.38691249,0.6924608327,0,-11.59871895,-11.59871895,1718
13191,"McIntosh","Georgia","US","2020-05-24 02:32:43",31.49683595,-81.40163426,11,0,0,11,"McIntosh, Georgia, US",14378,56,111,141,-30,-1,86,85,1,71,9.8257839721,-2.090592334,-0.069686411,5.9930313589,5.9233449477,3036
38051,"McIntosh","North Dakota","US","2020-05-24 02:32:43",46.11182017,-99.44145858,1,0,0,1,"McIntosh, North Dakota, US",2497,-69,26,46,-20,0,-49,-49,0,92,18.171044835,-7.900454276,0,-19.35611298,-19.35611298,1423
40091,"McIntosh","Oklahoma","US","2020-05-24 02:32:43",35.37235506,-95.66599306,11,1,0,10,"McIntosh, Oklahoma, US",19596,-149,183,318,-135,1,-13,-12,-2,345,16.166340459,-6.863069063,0.0508375486,-0.660888132,-0.610050583,5207
42083,"McKean","Pennsylvania","US","2020-05-24 02:32:43",41.80938602,-78.56478358,11,1,0,10,"McKean, Pennsylvania, US",40625,-325,367,507,-140,1,-185,-184,-1,3015,12.430278884,-3.43242415,0.0245173154,-4.53570334,-4.511186025,17032
38053,"McKenzie","North Dakota","US","2020-05-24 02:32:43",47.7413337,-103.395905,16,0,0,16,"McKenzie, North Dakota, US",15024,1430,264,64,200,-6,1232,1226,4,148,4.4727094835,13.977217136,-0.419316514,86.099657558,85.680341044,7664
35031,"McKinley","New Mexico","US","2020-05-24 02:32:43",35.5800772,-108.262245,2086,87,0,1999,"McKinley, New Mexico, US",71367,-544,817,642,175,17,-738,-721,2,774,8.961599129,2.4428035009,0.2373009115,-10.30165134,-10.06435042,22773
17113,"McLean","Illinois","US","2020-05-24 02:32:43",40.48996987,-88.84621113,202,9,0,193,"McLean, Illinois, US",171517,-893,1877,1246,631,567,-2102,-1535,11,10508,7.2457236565,3.6693833284,3.2972113268,-12.22352418,-8.926312851,94408
21149,"McLean","Kentucky","US","2020-05-24 02:32:43",37.5301951,-87.26803443,19,1,0,18,"McLean, Kentucky, US",9207,-51,108,113,-5,0,-44,-44,-2,82,12.239371784,-0.541565123,0,-4.765773084,-4.765773084,2363
38055,"McLean","North Dakota","US","2020-05-24 02:32:43",47.60766714,-101.3182418,7,0,0,7,"McLean, North Dakota, US",9450,-79,111,98,13,1,-93,-92,0,147,10.327203752,1.3699351915,0.1053796301,-9.800305601,-9.694925971,4537
48309,"McLennan","Texas","US","2020-05-24 02:32:43",31.55255453,-97.20217694,102,4,0,98,"McLennan, Texas, US",256623,2427,3460,2231,1229,164,1033,1197,1,8342,8.734992238,4.8118805291,0.642106108,4.0444854244,4.6865915324,111938
27085,"McLeod","Minnesota","US","2020-05-24 02:32:43",44.82367677,-94.27287017,26,0,0,26,"McLeod, Minnesota, US",35893,66,372,325,47,5,17,22,-3,476,9.0630228667,1.3106525376,0.139431121,0.4740658115,0.6134969325,17414
47107,"McMinn","Tennessee","US","2020-05-24 02:32:43",35.42812616,-84.61520715,133,13,0,120,"McMinn, Tennessee, US",53794,458,591,656,-65,73,453,526,-3,1052,12.24680295,-1.213478951,1.3628302063,8.4570148418,9.8198450481,19614
47109,"McNairy","Tennessee","US","2020-05-24 02:32:43",35.17468549,-88.5647812,12,0,0,12,"McNairy, Tennessee, US",25694,-136,263,366,-103,2,-33,-31,-2,330,14.206971508,-3.998136791,0.0776337241,-1.280956447,-1.203322723,6736
20113,"McPherson","Kansas","US","2020-05-24 02:32:43",38.39184858,-97.64769869,27,0,0,27,"McPherson, Kansas, US",28542,14,305,336,-31,0,47,47,-2,928,11.775013142,-1.086385141,0,1.6471000526,1.6471000526,16387
31117,"McPherson","Nebraska","US","2020-05-24 02:32:43",41.56797682,-101.0599362,0,0,0,0,"McPherson, Nebraska, US",494,4,3,2,1,0,2,2,1,0,4.0650406504,2.0325203252,0,4.0650406504,4.0650406504,130
46089,"McPherson","South Dakota","US","2020-05-24 02:32:43",45.76626028,-99.22118798,1,0,0,1,"McPherson, South Dakota, US",2379,-22,19,20,-1,-1,-19,-20,-1,347,8.3682008368,-0.418410042,-0.418410042,-7.949790795,-8.368200837,962
20119,"Meade","Kansas","US","2020-05-24 02:32:43",37.23859987,-100.364831,24,0,0,24,"Meade, Kansas, US",4033,-65,38,34,4,7,-78,-71,2,119,8.3630549748,0.9838888206,1.721805436,-19.185832,-17.46402656,1953
21163,"Meade","Kentucky","US","2020-05-24 02:32:43",37.96163597,-86.21028219,21,2,0,19,"Meade, Kentucky, US",28572,-51,271,253,18,-14,-54,-68,-1,212,8.8469271789,0.6294256491,-0.489553283,-1.888276947,-2.37783023,5206
46093,"Meade","South Dakota","US","2020-05-24 02:32:43",44.56676791,-102.7162741,7,0,0,7,"Meade, South Dakota, US",28332,128,257,207,50,-9,87,78,0,791,7.322767794,1.7687844913,-0.318381208,3.0776850149,2.7593038064,8428
30059,"Meagher","Montana","US","2020-05-24 02:32:43",46.59907074,-110.8898557,1,0,0,1,"Meagher, Montana, US",1862,5,12,17,-5,1,9,10,0,174,9.1422425383,-2.688894864,0.5377789728,4.8400107556,5.3777897284,864
37119,"Mecklenburg","North Carolina","US","2020-05-24 02:32:43",35.24469268,-80.8317671,3142,73,0,3069,"Mecklenburg, North Carolina, US",1110356,16606,14736,6883,7853,4335,4382,8717,36,17805,6.2456161364,7.1257915908,3.9335676233,3.9762153,7.9097829233,623716
51117,"Mecklenburg","Virginia","US","2020-05-24 02:32:43",36.67882005,-78.36131056,193,20,0,173,"Mecklenburg, Virginia, US",30587,-37,312,482,-170,-2,136,134,-1,925,15.74880332,-5.554557187,-0.065347732,4.4436457499,4.3782980183,13208
26107,"Mecosta","Michigan","US","2020-05-24 02:32:43",43.64064262,-85.32463223,19,2,0,17,"Mecosta, Michigan, US",43453,53,396,357,39,19,-4,15,-1,3344,8.2207868467,0.8980691513,0.4375208686,-0.092109657,0.345411212,16187
39103,"Medina","Ohio","US","2020-05-24 02:32:43",41.11770589,-81.8998621,274,19,0,255,"Medina, Ohio, US",179746,768,1674,1541,133,12,635,647,-12,1199,8.5915634304,0.7415171553,0.0669038035,3.5403262675,3.607230071,61360
48325,"Medina","Texas","US","2020-05-24 02:32:43",29.3557301,-99.11030298,64,2,0,62,"Medina, Texas, US",51584,722,595,454,141,4,578,582,-1,2387,8.8632059817,2.7526696992,0.0780899205,11.283993519,11.362083439,11698
27093,"Meeker","Minnesota","US","2020-05-24 02:32:43",45.12328869,-94.52839455,43,0,0,43,"Meeker, Minnesota, US",23222,77,268,216,52,15,11,26,-1,354,9.3169711217,2.2429745293,0.6470118835,0.4744753812,1.1214872646,8348
39105,"Meigs","Ohio","US","2020-05-24 02:32:43",39.09224872,-82.0305041,6,0,0,6,"Meigs, Ohio, US",22907,-157,243,307,-64,-3,-89,-92,-1,212,13.356246329,-2.784364056,-0.130517065,-3.872006265,-4.00252333,4083
47121,"Meigs","Tennessee","US","2020-05-24 02:32:43",35.51558739,-84.81482914,25,0,0,25,"Meigs, Tennessee, US",12422,125,133,154,-21,-2,148,146,0,150,12.460050973,-1.69909786,-0.161818844,11.974594442,11.812775598,1931
17129,"Menard","Illinois","US","2020-05-24 02:32:43",40.02742725,-89.80246001,17,0,0,17,"Menard, Illinois, US",12196,-93,122,127,-5,-4,-85,-89,1,154,10.373698183,-0.408413314,-0.326730651,-6.943026343,-7.269756994,2394
6045,"Mendocino","California","US","2020-05-24 02:32:43",39.4381191,-123.3911313,21,0,0,21,"Mendocino, California, US",86749,-652,933,860,73,-60,-660,-720,-5,1981,9.8765432099,0.8383577376,-0.689061154,-7.579672696,-8.26873385,36195
21165,"Menifee","Kentucky","US","2020-05-24 02:32:43",37.94090733,-83.59985712,8,0,0,8,"Menifee, Kentucky, US",6489,52,61,91,-30,0,82,82,0,271,14.080148538,-4.64180721,0,12.687606375,12.687606375,1223
26109,"Menominee","Michigan","US","2020-05-24 02:32:43",45.58038692,-87.55370409,8,0,0,8,"Menominee, Michigan, US",22780,-147,166,233,-67,-2,-75,-77,-3,382,10.195374888,-2.931717242,-0.087513948,-3.281773033,-3.36928698,7598
55078,"Menominee","Wisconsin","US","2020-05-24 02:32:43",45.00422544,-88.70950714,2,0,0,2,"Menominee, Wisconsin, US",4556,-39,84,69,15,0,-53,-53,-1,56,15.080319091,3.2783302371,0,-11.5834335,-11.5834335,2432
6047,"Merced","California","US","2020-05-24 02:32:43",37.18922369,-120.7209035,251,6,0,245,"Merced, California, US",277680,3529,4086,1787,2299,-144,1381,1237,-7,7006,6.4766205596,8.3322611452,-0.521898915,5.0051555639,4.4832566492,79326
17131,"Mercer","Illinois","US","2020-05-24 02:32:43",41.20596782,-90.74290052,14,0,0,14,"Mercer, Illinois, US",15437,-114,140,194,-54,0,-60,-60,0,185,12.520975862,-3.485220085,0,-3.872466761,-3.872466761,3569
21167,"Mercer","Kentucky","US","2020-05-24 02:32:43",37.81474237,-84.87488475,12,0,0,12,"Mercer, Kentucky, US",21933,231,248,298,-50,6,276,282,-1,128,13.65876017,-2.291738283,0.275008594,12.650395325,12.925403919,7378
34021,"Mercer","New Jersey","US","2020-05-24 02:32:43",40.28047017,-74.70479631,6351,447,0,5904,"Mercer, New Jersey, US",367430,-758,4021,2987,1034,1182,-2997,-1815,23,19839,8.1210628342,2.8112417043,3.2136244627,-8.148250858,-4.934626396,226360
38057,"Mercer","North Dakota","US","2020-05-24 02:32:43",47.31213126,-101.8318399,5,0,0,5,"Mercer, North Dakota, US",8187,-79,88,81,7,-4,-82,-86,0,125,9.8462286513,0.8509086489,-0.486233514,-9.96778703,-10.45402054,4924
39107,"Mercer","Ohio","US","2020-05-24 02:32:43",40.54043046,-84.62912742,178,3,0,175,"Mercer, Ohio, US",41172,220,644,385,259,7,-44,-37,-2,439,9.376065462,6.3075349472,0.1704739175,-1.071550339,-0.901076421,17791
42085,"Mercer","Pennsylvania","US","2020-05-24 02:32:43",41.30248872,-80.25816981,103,4,0,99,"Mercer, Pennsylvania, US",109424,-1047,1056,1431,-375,20,-691,-671,-1,6291,13.015302758,-3.410718752,0.1819050001,-6.284817754,-6.102912754,51041
54055,"Mercer","West Virginia","US","2020-05-24 02:32:43",37.40481169,-81.11023142,13,0,0,13,"Mercer, West Virginia, US",58758,-444,661,891,-230,-9,-202,-211,-3,1113,15.10681587,-3.899626992,-0.1525941,-3.424889793,-3.577483893,22435
13199,"Meriwether","Georgia","US","2020-05-24 02:32:43",33.04163534,-84.68859732,78,2,0,76,"Meriwether, Georgia, US",21167,73,239,268,-29,0,102,102,0,246,12.683088427,-1.372423748,0,4.8271455952,4.8271455952,5661
31121,"Merrick","Nebraska","US","2020-05-24 02:32:43",41.16624273,-98.0374887,32,0,0,32,"Merrick, Nebraska, US",7755,22,86,81,5,0,19,19,-2,195,10.459710744,0.645661157,0,2.4535123967,2.4535123967,3186
33013,"Merrimack","New Hampshire","US","2020-05-24 02:32:43",43.29662971,-71.6811573,312,13,0,299,"Merrimack, New Hampshire, US",151391,741,1305,1388,-83,279,551,830,-6,6656,9.1908052218,-0.54959426,1.847431309,3.6485112948,5.4959426038,78884
8077,"Mesa","Colorado","US","2020-05-24 02:32:43",39.01787888,-108.469799,54,0,0,54,"Mesa, Colorado, US",154210,1259,1631,1515,116,-13,1150,1137,6,4437,9.8645335834,0.7553042216,-0.084646163,7.4879297828,7.40328362,64374
21169,"Metcalfe","Kentucky","US","2020-05-24 02:32:43",36.99459295,-85.63123699,4,0,0,4,"Metcalfe, Kentucky, US",10071,1,113,128,-15,-1,17,16,0,121,12.710391738,-1.489499032,-0.099299935,1.6880989027,1.5887989673,2864
18103,"Miami","Indiana","US","2020-05-24 02:32:43",40.76940965,-86.04525048,135,1,0,134,"Miami, Indiana, US",35516,-130,382,364,18,26,-175,-149,1,3342,10.230179028,0.5058879739,0.7307270734,-4.918355302,-4.187628229,9939
20121,"Miami","Kansas","US","2020-05-24 02:32:43",38.56383358,-94.83832189,6,0,0,6,"Miami, Kansas, US",34237,500,390,294,96,12,392,404,0,645,8.6503663165,2.8246094095,0.3530761762,11.533821755,11.886897932,8704
39109,"Miami","Ohio","US","2020-05-24 02:32:43",40.0543329,-84.22871271,346,30,0,316,"Miami, Ohio, US",106987,945,1153,1050,103,43,807,850,-8,1056,9.8578127861,0.9670044923,0.4037009046,7.5764332556,7.9801341601,41725
12086,"Miami-Dade","Florida","US","2020-05-24 02:32:43",25.6112362,-80.55170587,16694,629,0,16065,"Miami-Dade, Florida, US",2716940,2086,30789,21689,9100,38016,-45174,-7158,144,42224,7.9859435023,3.3506425317,13.997585328,-16.63317865,-2.635593323,1254642
9007,"Middlesex","Connecticut","US","2020-05-24 02:32:43",41.45949668,-72.53714864,999,136,0,863,"Middlesex, Connecticut, US",162436,-434,1248,1552,-304,237,-359,-122,-8,4961,9.5417852729,-1.869009486,1.4570896325,-2.20715265,-0.750063018,71611
25017,"Middlesex","Massachusetts","US","2020-05-24 02:32:43",42.48607732,-71.39049229,20232,1512,0,18720,"Middlesex, Massachusetts, US",1611699,3229,16755,11911,4844,8965,-10597,-1632,17,55821,7.397748379,3.0085377507,5.5680307462,-6.581642144,-1.013611397,886409
34023,"Middlesex","New Jersey","US","2020-05-24 02:32:43",40.43629879,-74.41426991,15215,942,0,14273,"Middlesex, New Jersey, US",825062,-1110,8907,6284,2623,3354,-7130,-3776,43,23395,7.6112773841,3.1770179151,4.0624163504,-8.635965587,-4.573549237,377619
51119,"Middlesex","Virginia","US","2020-05-24 02:32:43",37.63191998,-76.55064617,12,0,0,12,"Middlesex, Virginia, US",10582,-151,88,147,-59,1,-92,-91,-1,377,13.793103448,-5.536007506,0.0938306357,-8.632418485,-8.538587849,3280
26111,"Midland","Michigan","US","2020-05-24 02:32:43",43.64330771,-84.38804374,79,8,0,71,"Midland, Michigan, US",83156,-67,855,743,112,64,-241,-177,-2,1274,8.9314156234,1.3463237548,0.7693278599,-2.897000222,-2.127672362,39726
48329,"Midland","Texas","US","2020-05-24 02:32:43",31.86904128,-102.0315682,123,12,0,111,"Midland, Texas, US",176832,4327,2998,1140,1858,328,2124,2452,17,1639,6.5266490523,10.637292929,1.8778428852,12.160177708,14.038020593,88933
42087,"Mifflin","Pennsylvania","US","2020-05-24 02:32:43",40.61116939,-77.61070738,57,1,0,56,"Mifflin, Pennsylvania, US",46138,-73,574,527,47,11,-128,-117,-3,560,11.413225915,1.017877833,0.2382267269,-2.772092822,-2.533866095,17087
48331,"Milam","Texas","US","2020-05-24 02:32:43",30.7858183,-96.97718698,27,1,0,26,"Milam, Texas, US",24823,-222,268,285,-17,5,-208,-203,-2,401,11.430175664,-0.681799952,0.2005293976,-8.342022941,-8.141493543,7136
27095,"Mille Lacs","Minnesota","US","2020-05-24 02:32:43",45.93705297,-93.63236823,15,1,0,14,"Mille Lacs, Minnesota, US",26277,177,319,268,51,7,119,126,0,524,10.233499437,1.9474196689,0.2672928957,4.5439792275,4.8112721233,10273
5091,"Miller","Arkansas","US","2020-05-24 02:32:43",33.31403423,-93.89285258,42,1,0,41,"Miller, Arkansas, US",43257,-105,520,471,49,-28,-123,-151,-3,1452,10.875212136,1.1313914961,-0.646509426,-2.840023551,-3.486532978,13690
13201,"Miller","Georgia","US","2020-05-24 02:32:43",31.16568912,-84.73151117,38,0,0,38,"Miller, Georgia, US",5718,34,69,85,-16,0,49,49,1,127,14.909664971,-2.806525171,0,8.5949833363,8.5949833363,1700
29131,"Miller","Missouri","US","2020-05-24 02:32:43",38.21450288,-92.42610898,4,0,0,4,"Miller, Missouri, US",25619,304,301,276,25,-4,285,281,-2,271,10.837554482,0.9816625437,-0.157066007,11.190952998,11.033886991,7294
19129,"Mills","Iowa","US","2020-05-24 02:32:43",41.03299766,-95.61920963,14,0,0,14,"Mills, Iowa, US",15109,41,137,134,3,3,34,37,1,564,8.880935812,0.1988269212,0.1988269212,2.2533717732,2.4521986944,4308
48333,"Mills","Texas","US","2020-05-24 02:32:43",31.49557106,-98.59272068,1,0,0,1,"Mills, Texas, US",4873,-10,30,71,-41,-1,33,32,-1,135,14.555145551,-8.405084051,-0.20500205,6.7650676507,6.5600656007,1657
55079,"Milwaukee","Wisconsin","US","2020-05-24 02:32:43",43.00486062,-87.96733172,5987,276,0,5711,"Milwaukee, Wisconsin, US",945726,-1243,12941,8226,4715,1072,-7014,-5942,-16,22658,8.692367233,4.9823135793,1.1327762793,-7.411653753,-6.278877474,471816
46097,"Miner","South Dakota","US","2020-05-24 02:32:43",44.02197882,-97.60992207,1,0,0,1,"Miner, South Dakota, US",2216,12,27,21,6,-1,8,7,-1,80,9.5022624434,2.7149321267,-0.452488688,3.6199095023,3.1674208145,1033
8079,"Mineral","Colorado","US","2020-05-24 02:32:43",37.66954283,-106.9281698,2,0,0,2,"Mineral, Colorado, US",769,-3,8,5,3,0,-6,-6,0,0,6.4892926671,3.8935756003,0,-7.787151201,-7.787151201,276
32021,"Mineral","Nevada","US","2020-05-24 02:32:43",38.53841696,-118.4344506,4,0,0,4,"Mineral, Nevada, US",4505,-39,57,100,-43,0,5,5,-1,52,22.101889712,-9.503812576,0,1.1050944856,1.1050944856,1926
54057,"Mineral","West Virginia","US","2020-05-24 02:32:43",39.41561583,-78.94104895,36,0,0,36,"Mineral, West Virginia, US",26868,-85,249,343,-94,-4,15,11,-2,519,12.745954181,-3.49306033,-0.148640865,0.5574032441,0.408762379,7610
54059,"Mingo","West Virginia","US","2020-05-24 02:32:43",37.73048351,-82.13338365,3,1,0,2,"Mingo, West Virginia, US",23424,-427,306,372,-66,-2,-359,-361,0,85,15.737704918,-2.792173453,-0.084611317,-15.18773136,-15.27234268,6381
16067,"Minidoka","Idaho","US","2020-05-24 02:32:43",42.85518524,-113.6357257,26,0,0,26,"Minidoka, Idaho, US",21039,320,308,179,129,3,188,191,0,82,8.5732075291,6.1784568226,0.1436850424,9.0042626563,9.1479476986,8035
46099,"Minnehaha","South Dakota","US","2020-05-24 02:32:43",43.67441641,-96.7910885,3248,43,0,3205,"Minnehaha, South Dakota, US",193134,2142,2873,1415,1458,272,414,686,-2,6268,7.367374247,7.5912591181,1.4162019754,2.1555427125,3.5717446879,114303
26113,"Missaukee","Michigan","US","2020-05-24 02:32:43",44.33772443,-85.09256478,16,1,0,15,"Missaukee, Michigan, US",15118,17,189,160,29,5,-18,-13,1,194,10.589364307,1.9193222807,0.3309176346,-1.191303485,-0.86038585,4336
5093,"Mississippi","Arkansas","US","2020-05-24 02:32:43",35.76271485,-90.0519437,70,1,0,69,"Mississippi, Arkansas, US",40651,-585,580,498,82,-19,-652,-671,4,788,12.163102812,2.0027599008,-0.464054123,-15.9243836,-16.38843773,20267
29133,"Mississippi","Missouri","US","2020-05-24 02:32:43",36.82516239,-89.29505753,54,0,0,54,"Mississippi, Missouri, US",13180,-214,141,190,-49,0,-164,-164,-1,1845,14.299691428,-3.687815158,0,-12.34289155,-12.34289155,4358
30063,"Missoula","Montana","US","2020-05-24 02:32:43",47.03728583,-113.9213508,39,1,0,38,"Missoula, Montana, US",119600,960,1131,887,244,112,603,715,1,3645,7.4462726662,2.0483546004,0.9402283412,5.0621222297,6.0023505709,60956
13205,"Mitchell","Georgia","US","2020-05-24 02:32:43",31.22483255,-84.19381821,399,32,0,367,"Mitchell, Georgia, US",21863,-272,245,236,9,8,-289,-281,0,2109,10.727760353,0.409109505,0.3636528933,-13.13696077,-12.77330788,8608
19131,"Mitchell","Iowa","US","2020-05-24 02:32:43",43.35638371,-92.78887719,4,0,0,4,"Mitchell, Iowa, US",10586,15,129,123,6,1,10,11,-2,202,11.627357376,0.5671881647,0.0945313608,0.9453136078,1.0398449686,4807
20123,"Mitchell","Kansas","US","2020-05-24 02:32:43",39.39331582,-98.20906732,3,0,0,3,"Mitchell, Kansas, US",5979,-131,72,102,-30,2,-103,-101,0,246,16.8748449,-4.963189677,0.3308793118,-17.04028456,-16.70940524,3870
37121,"Mitchell","North Carolina","US","2020-05-24 02:32:43",36.01059309,-82.1582442,9,0,0,9,"Mitchell, North Carolina, US",14964,-32,139,221,-82,19,31,50,0,188,14.753004005,-5.473965287,1.2683578104,2.0694259012,3.3377837116,5809
48335,"Mitchell","Texas","US","2020-05-24 02:32:43",32.30623474,-100.9212058,1,0,0,1,"Mitchell, Texas, US",8545,20,100,64,36,-1,-14,-15,-1,1845,7.4985354423,4.2179261863,-0.117164616,-1.640304628,-1.757469244,2566
1097,"Mobile","Alabama","US","2020-05-24 02:32:43",30.78472347,-88.20842409,1973,109,0,1864,"Mobile, Alabama, US",413210,-698,5443,4576,867,266,-1821,-1555,-10,7390,11.064926649,2.0964360587,0.6431972222,-4.403241134,-3.760043912,179461
8081,"Moffat","Colorado","US","2020-05-24 02:32:43",40.61810999,-108.2070876,6,0,0,6,"Moffat, Colorado, US",13283,100,170,81,89,19,-8,11,0,102,6.1210609839,6.7256102169,1.4358044283,-0.604549233,0.8312551953,5465
4015,"Mohave","Arizona","US","2020-05-24 02:32:43",35.70471703,-113.7577902,303,34,0,269,"Mohave, Arizona, US",212181,2889,1752,3375,-1623,-246,4724,4478,34,4762,16.015260764,-7.701560954,-1.167334562,22.416619807,21.249285245,55389
29135,"Moniteau","Missouri","US","2020-05-24 02:32:43",38.63571781,-92.57976951,45,0,0,45,"Moniteau, Missouri, US",16132,-54,205,165,40,17,-110,-93,-1,1376,10.21102791,2.4754007055,1.0520452998,-6.80735194,-5.75530664,4460
34025,"Monmouth","New Jersey","US","2020-05-24 02:32:43",40.26549699,-74.22240686,7720,551,0,7169,"Monmouth, New Jersey, US",618795,-1664,5644,5867,-223,191,-1619,-1428,-13,6726,9.4685996575,-0.359893936,0.3082499633,-2.612862254,-2.304612291,264940
6051,"Mono","California","US","2020-05-24 02:32:43",37.93899289,-118.8872409,34,1,0,33,"Mono, California, US",14444,41,126,30,96,64,-120,-56,1,338,2.0799389885,6.6558047631,4.4372031754,-8.319755954,-3.882552778,7688
19133,"Monona","Iowa","US","2020-05-24 02:32:43",42.05220391,-95.95743843,21,0,0,21,"Monona, Iowa, US",8615,-44,86,137,-51,0,7,7,0,200,15.861989117,-5.904828065,0,0.8104665972,0.8104665972,3160
54061,"Monongalia","West Virginia","US","2020-05-24 02:32:43",39.63218457,-80.04766838,119,5,0,114,"Monongalia, West Virginia, US",105612,-39,1071,731,340,-15,-362,-377,-2,6379,6.9202841955,3.2187368351,-0.142003096,-3.427008042,-3.569011138,59468
1099,"Monroe","Alabama","US","2020-05-24 02:32:43",31.56729412,-87.36995001,26,2,0,24,"Monroe, Alabama, US",20733,-329,199,278,-79,-2,-249,-251,1,230,13.303026678,-3.780356502,-0.095705228,-11.91530087,-12.0110061,6500
5095,"Monroe","Arkansas","US","2020-05-24 02:32:43",34.6815935,-91.20540287,5,0,0,5,"Monroe, Arkansas, US",6701,-179,67,114,-47,0,-133,-133,1,84,16.788159929,-6.921434357,0,-19.58618658,-19.58618658,2740
12087,"Monroe","Florida","US","2020-05-24 02:32:43",25.20904673,-81.07812416,107,3,0,104,"Monroe, Florida, US",74228,-529,685,736,-51,273,-750,-477,-1,1995,9.8801892808,-0.684632681,3.6647984696,-10.06812766,-6.403329194,42089
13207,"Monroe","Georgia","US","2020-05-24 02:32:43",33.014289,-83.92097166,117,8,0,109,"Monroe, Georgia, US",27578,75,241,342,-101,-8,187,179,-3,1154,12.418075198,-3.667326301,-0.290481291,6.7900001816,6.4995188904,7722
17133,"Monroe","Illinois","US","2020-05-24 02:32:43",38.27594376,-90.17761038,91,11,0,80,"Monroe, Illinois, US",34637,264,359,319,40,0,227,227,-3,344,9.2450369512,1.1592522823,0,6.5787567019,6.5787567019,8856
18105,"Monroe","Indiana","US","2020-05-24 02:32:43",39.16130004,-86.52414358,158,10,0,148,"Monroe, Indiana, US",148431,1201,1205,941,264,1218,-282,936,1,15008,6.3653982094,1.7858290407,8.2391658014,-1.907590112,6.3315756897,76387
19135,"Monroe","Iowa","US","2020-05-24 02:32:43",41.02988815,-92.8690667,32,3,0,29,"Monroe, Iowa, US",7707,-61,78,79,-1,4,-63,-59,-1,111,10.210016155,-0.129240711,0.5169628433,-8.142164782,-7.625201939,3489
21171,"Monroe","Kentucky","US","2020-05-24 02:32:43",36.71225341,-85.71596443,14,0,0,14,"Monroe, Kentucky, US",10650,-82,144,142,2,-2,-82,-84,0,143,13.282199981,0.1870732392,-0.187073239,-7.670002806,-7.857076045,3207
26115,"Monroe","Michigan","US","2020-05-24 02:32:43",41.92734151,-83.53749864,461,19,0,442,"Monroe, Michigan, US",150500,326,1459,1481,-22,-10,369,359,-11,1463,9.8512009685,-0.146337894,-0.066517225,2.454485589,2.3879683644,44493
28095,"Monroe","Mississippi","US","2020-05-24 02:32:43",33.89236763,-88.4808438,241,24,0,217,"Monroe, Mississippi, US",35252,-291,387,413,-26,-1,-265,-266,1,399,11.667490642,-0.734515149,-0.028250583,-7.486404407,-7.51465499,10907
36055,"Monroe","New York","US","2020-05-24 02:32:43",43.14638895,-77.69322942,2661,188,0,2473,"Monroe, New York, US",741770,-1094,7762,6693,1069,760,-2918,-2158,-5,26410,9.016363629,1.4400855699,1.0238213593,-3.930935167,-2.907113807,385098
39111,"Monroe","Ohio","US","2020-05-24 02:32:43",39.72984936,-81.08464734,71,9,0,62,"Monroe, Ohio, US",13654,-133,116,196,-80,-2,-50,-52,-1,165,14.285193688,-5.830691301,-0.145767283,-3.644182063,-3.789949346,4928
42089,"Monroe","Pennsylvania","US","2020-05-24 02:32:43",41.05934058,-75.34031025,1302,99,0,1203,"Monroe, Pennsylvania, US",170271,977,1545,1618,-73,153,911,1064,-14,4505,9.5298396478,-0.429961863,0.9011529457,5.3656884543,6.2668414,62588
47123,"Monroe","Tennessee","US","2020-05-24 02:32:43",35.44550387,-84.24902965,57,2,0,55,"Monroe, Tennessee, US",46545,276,484,575,-91,-30,397,367,0,513,12.390372142,-1.960911069,-0.646454199,8.5547438964,7.9082896977,13909
54063,"Monroe","West Virginia","US","2020-05-24 02:32:43",37.56274716,-80.54577965,6,0,0,6,"Monroe, West Virginia, US",13275,-14,111,167,-56,-1,43,42,0,57,12.573407619,-4.216232495,-0.075289866,3.2374642373,3.1621743713,2653
55081,"Monroe","Wisconsin","US","2020-05-24 02:32:43",43.94641218,-90.618819,16,1,0,15,"Monroe, Wisconsin, US",46253,112,559,435,124,10,-21,-11,-1,826,9.4161958569,2.6841569799,0.2164642726,-0.454574972,-0.2381107,22396
48337,"Montague","Texas","US","2020-05-24 02:32:43",33.67521893,-97.72500958,9,1,0,8,"Montague, Texas, US",19818,234,204,258,-54,-6,294,288,0,216,13.09578194,-2.740977615,-0.304553068,14.92310035,14.618547282,6644
26117,"Montcalm","Michigan","US","2020-05-24 02:32:43",43.31082541,-85.15252824,66,1,0,65,"Montcalm, Michigan, US",63888,-48,728,613,115,-2,-158,-160,-3,3039,9.5913130555,1.799349105,-0.031293028,-2.472149205,-2.503442233,17810
6053,"Monterey","California","US","2020-05-24 02:32:43",36.21862405,-121.2413397,371,8,0,363,"Monterey, California, US",434061,111,5797,2742,3055,-90,-2850,-2940,-4,18075,6.3178922848,7.039081302,-0.207370644,-6.566737057,-6.774107701,177185
8083,"Montezuma","Colorado","US","2020-05-24 02:32:43",37.33859579,-108.5958857,35,3,0,32,"Montezuma, Colorado, US",26183,31,263,279,-16,-17,66,49,-2,243,10.662080825,-0.611445495,-0.649660839,2.5222126684,1.8725518296,10027
1101,"Montgomery","Alabama","US","2020-05-24 02:32:43",32.2206831,-86.20969272,1141,30,0,1111,"Montgomery, Alabama, US",226486,-18,3058,2164,894,321,-1235,-914,2,9302,9.5542947968,3.9471070002,1.4172498289,-5.452658999,-4.03540917,134666
5097,"Montgomery","Arkansas","US","2020-05-24 02:32:43",34.53704874,-93.65824478,1,0,0,1,"Montgomery, Arkansas, US",8986,76,88,148,-60,4,133,137,-1,121,16.540008941,-6.70540903,0.4470272687,14.863656683,15.310683952,2201
13209,"Montgomery","Georgia","US","2020-05-24 02:32:43",32.17201038,-82.53527476,9,0,0,9,"Montgomery, Georgia, US",9172,4,102,86,16,3,-14,-11,-1,806,9.3784078517,1.7448200654,0.3271537623,-1.526717557,-1.199563795,1544
17135,"Montgomery","Illinois","US","2020-05-24 02:32:43",39.23198845,-89.47809254,38,1,0,37,"Montgomery, Illinois, US",28414,-277,301,365,-64,0,-213,-213,0,2453,12.783469048,-2.241484984,0,-7.459942212,-7.459942212,9242
18107,"Montgomery","Indiana","US","2020-05-24 02:32:43",40.04034823,-86.89335024,211,14,0,197,"Montgomery, Indiana, US",38338,64,426,389,37,44,-15,29,-2,1175,10.155067091,0.9659061244,1.1486451209,-0.391583564,0.7570615569,16271
19137,"Montgomery","Iowa","US","2020-05-24 02:32:43",41.03018714,-95.15642896,5,0,0,5,"Montgomery, Iowa, US",9917,-44,107,135,-28,1,-17,-16,0,192,13.582855418,-2.817184827,0.1006137438,-1.710433645,-1.609819901,4620
20125,"Montgomery","Kansas","US","2020-05-24 02:32:43",37.19236568,-95.74329258,20,2,0,18,"Montgomery, Kansas, US",31829,-262,322,356,-34,61,-290,-229,1,1114,11.138923655,-1.063829787,1.9086357947,-9.073842303,-7.165206508,16200
21173,"Montgomery","Kentucky","US","2020-05-24 02:32:43",38.03253032,-83.9145241,21,0,0,21,"Montgomery, Kentucky, US",28157,48,350,291,59,-10,1,-9,-2,355,10.343724452,2.0971812462,-0.355454449,0.0355454449,-0.319909004,11386
24031,"Montgomery","Maryland","US","2020-05-24 02:32:43",39.13676329,-77.20358245,9699,550,0,9149,"Montgomery, Maryland, US",1050688,2210,12240,6344,5896,5699,-9423,-3724,38,9053,6.0443052145,5.6174690329,5.4297754442,-8.977851204,-3.54807576,498189
28097,"Montgomery","Mississippi","US","2020-05-24 02:32:43",33.49419589,-89.61729103,78,1,0,77,"Montgomery, Mississippi, US",9775,-219,120,151,-31,2,-189,-187,-1,97,15.276442916,-3.13622338,0.2023369923,-19.12084577,-18.91850878,2933
29139,"Montgomery","Missouri","US","2020-05-24 02:32:43",38.94022054,-91.47000721,8,0,0,8,"Montgomery, Missouri, US",11551,63,127,140,-13,2,72,74,2,394,12.153305265,-1.128521203,0.1736186466,6.2502712791,6.4238899258,3281
36057,"Montgomery","New York","US","2020-05-24 02:32:43",42.90123494,-74.44011632,77,4,0,73,"Montgomery, New York, US",49221,-173,613,533,80,14,-267,-253,0,911,10.809714546,1.6224712265,0.2839324646,-5.414997718,-5.131065254,19360
37123,"Montgomery","North Carolina","US","2020-05-24 02:32:43",35.33155144,-79.90416657,84,3,0,81,"Montgomery, North Carolina, US",27173,96,268,269,-1,-4,102,98,-1,938,9.9170506912,-0.036866359,-0.147465438,3.7603686636,3.6129032258,9963
39113,"Montgomery","Ohio","US","2020-05-24 02:32:43",39.75394919,-84.29050975,578,14,0,564,"Montgomery, Ohio, US",531687,87,6522,5966,556,533,-973,-440,-29,15511,11.22180559,1.045813595,1.0025515218,-1.830173791,-0.827622269,254416
42091,"Montgomery","Pennsylvania","US","2020-05-24 02:32:43",40.21053671,-75.36652296,6464,633,0,5831,"Montgomery, Pennsylvania, US",830915,3991,8602,7831,771,1584,1698,3282,-62,20727,9.4472382421,0.9301265081,1.9109213862,2.0484498193,3.9593712055,475085
47125,"Montgomery","Tennessee","US","2020-05-24 02:32:43",36.49609412,-87.38550661,234,3,0,231,"Montgomery, Tennessee, US",208993,3681,3490,1415,2075,15,1576,1591,15,3573,6.8307165011,10.016775081,0.0724104223,7.6079217002,7.6803321225,61383
48339,"Montgomery","Texas","US","2020-05-24 02:32:43",30.30079133,-95.50572772,888,23,0,865,"Montgomery, Texas, US",607391,17621,7387,4165,3222,942,13423,14365,34,3213,6.9581284389,5.3827346531,1.5737231667,22.424719816,23.998442983,178249
51121,"Montgomery","Virginia","US","2020-05-24 02:32:43",37.17746986,-80.37868691,69,1,0,68,"Montgomery, Virginia, US",98535,3,804,669,135,276,-412,-136,4,9832,6.7895690298,1.3700924051,2.801077806,-4.181319044,-1.380241238,50294
26119,"Montmorency","Michigan","US","2020-05-24 02:32:43",45.0275929,-84.12696227,5,0,0,5,"Montmorency, Michigan, US",9328,53,62,166,-104,2,153,155,2,156,17.846583884,-11.18099231,0.2150190829,16.448959845,16.663978928,2594
42093,"Montour","Pennsylvania","US","2020-05-24 02:32:43",41.03023987,-76.66345939,50,0,0,50,"Montour, Pennsylvania, US",18230,-10,211,221,-10,12,-11,1,-1,844,12.119550315,-0.548395942,0.6580751302,-0.603235536,0.0548395942,15428
8085,"Montrose","Colorado","US","2020-05-24 02:32:43",38.40214114,-108.2639022,159,12,0,147,"Montrose, Colorado, US",42758,552,428,434,-6,15,543,558,0,542,10.216091521,-0.141236288,0.3530907208,12.781884092,13.134974813,15328
46101,"Moody","South Dakota","US","2020-05-24 02:32:43",44.02266214,-96.67081159,18,0,0,18,"Moody, South Dakota, US",6576,74,82,55,27,-3,51,48,-1,164,8.4110720294,4.1290717235,-0.458785747,7.7993577,7.3405719529,2653
37125,"Moore","North Carolina","US","2020-05-24 02:32:43",35.30885257,-79.48474178,198,10,0,188,"Moore, North Carolina, US",100880,2075,1139,1169,-30,78,2023,2101,4,784,11.708440794,-0.300473245,0.7812304379,20.261912512,21.04314295,36145
47127,"Moore","Tennessee","US","2020-05-24 02:32:43",35.27724699,-86.36230578,3,0,0,3,"Moore, Tennessee, US",6488,31,59,50,9,16,6,22,0,104,7.7249903438,1.3904982619,2.47199691,0.9269988413,3.3989957513,1827
48341,"Moore","Texas","US","2020-05-24 02:32:43",35.83769242,-101.8930281,579,13,0,566,"Moore, Texas, US",20940,-143,369,130,239,29,-415,-386,4,142,6.1870880232,11.374723366,1.380196559,-19.75108869,-18.37089213,11320
22067,"Morehouse","Louisiana","US","2020-05-24 02:32:43",32.81686191,-91.80421614,110,5,0,105,"Morehouse, Louisiana, US",24874,-450,330,346,-16,-1,-434,-435,1,768,13.785409777,-0.637475597,-0.039842225,-17.29152556,-17.33136778,6893
1103,"Morgan","Alabama","US","2020-05-24 02:32:43",34.45500589,-86.85475946,157,1,0,156,"Morgan, Alabama, US",119679,476,1402,1316,86,113,285,398,-8,2002,11.017992147,0.7200207634,0.9460737938,2.3861153205,3.3321891143,49723
8087,"Morgan","Colorado","US","2020-05-24 02:32:43",40.2627981,-103.8093302,603,41,0,562,"Morgan, Colorado, US",29068,299,438,240,198,171,-70,101,0,563,8.2991856424,6.846828155,5.9131697702,-2.420595812,3.4925739578,12952
13211,"Morgan","Georgia","US","2020-05-24 02:32:43",33.59232073,-83.49129491,36,0,0,36,"Morgan, Georgia, US",19276,445,215,172,43,1,399,400,2,163,9.027212848,2.256803212,0.0524837956,20.941034456,20.993518251,9055
17137,"Morgan","Illinois","US","2020-05-24 02:32:43",39.71654544,-90.20255104,34,1,0,33,"Morgan, Illinois, US",33658,-369,355,391,-36,44,-377,-333,0,3324,11.553519982,-1.0637512,1.3001403561,-11.13983896,-9.839698604,16307
18109,"Morgan","Indiana","US","2020-05-24 02:32:43",39.47899078,-86.44573375,257,24,0,233,"Morgan, Indiana, US",70489,352,780,675,105,45,208,253,-6,590,9.5999317338,1.4933227141,0.6399954489,2.9582011861,3.598196635,17377
21175,"Morgan","Kentucky","US","2020-05-24 02:32:43",37.92465657,-83.25558245,1,0,0,1,"Morgan, Kentucky, US",13309,-63,105,158,-53,1,-10,-9,-1,1948,11.843634047,-3.972864585,0.0749597092,-0.749597092,-0.674637382,2989
29141,"Morgan","Missouri","US","2020-05-24 02:32:43",38.4181765,-92.88791859,8,0,0,8,"Morgan, Missouri, US",20627,213,271,289,-18,-6,235,229,2,302,14.083477498,-0.877171609,-0.292390536,11.451962671,11.159572135,5555
39115,"Morgan","Ohio","US","2020-05-24 02:32:43",39.62081738,-81.85308173,5,0,0,5,"Morgan, Ohio, US",14508,-73,135,160,-25,0,-47,-47,-1,188,11.000721922,-1.7188628,0,-3.231462065,-3.231462065,3349
47129,"Morgan","Tennessee","US","2020-05-24 02:32:43",36.13248031,-84.64880098,17,0,0,17,"Morgan, Tennessee, US",21403,-131,199,229,-30,1,-102,-101,0,2264,10.66679088,-1.397396185,0.0465798728,-4.751147029,-4.704567157,3212
54065,"Morgan","West Virginia","US","2020-05-24 02:32:43",39.55439028,-78.26311676,17,0,0,17,"Morgan, West Virginia, US",17884,54,153,219,-66,-8,129,121,-1,123,12.264098113,-3.696029568,-0.448003584,7.2240577925,6.7760542084,3675
31123,"Morrill","Nebraska","US","2020-05-24 02:32:43",41.71711774,-103.0061405,10,0,0,10,"Morrill, Nebraska, US",4642,-32,45,42,3,3,-39,-36,1,80,9.0167453843,0.6440532417,0.6440532417,-8.372692143,-7.728638901,2113
20127,"Morris","Kansas","US","2020-05-24 02:32:43",38.68827511,-96.65128437,4,0,0,4,"Morris, Kansas, US",5620,63,75,70,5,8,50,58,0,66,12.525722466,0.8946944618,1.4315111389,8.9469446184,10.378455757,2230
34027,"Morris","New Jersey","US","2020-05-24 02:32:43",40.86095313,-74.5455371,6192,590,0,5602,"Morris, New Jersey, US",491845,-1225,4568,3857,711,628,-2572,-1944,8,8340,7.8321479519,1.4437794124,1.2752369494,-5.222785723,-3.947548773,289087
48343,"Morris","Texas","US","2020-05-24 02:32:43",33.11304005,-94.73255695,15,0,0,15,"Morris, Texas, US",12388,85,141,153,-12,-2,101,99,-2,132,12.393179701,-0.972014094,-0.162002349,8.1811186262,8.0191162772,4291
27097,"Morrison","Minnesota","US","2020-05-24 02:32:43",46.01265363,-94.27341528,36,0,0,36,"Morrison, Minnesota, US",33386,228,345,367,-22,3,251,254,-4,529,11.030295744,-0.661216639,0.0901659053,7.5438807406,7.6340466458,13356
39117,"Morrow","Ohio","US","2020-05-24 02:32:43",40.5236356,-82.7892599,104,1,0,103,"Morrow, Ohio, US",35328,215,381,316,65,-6,157,151,-1,366,8.9720475291,1.8455161057,-0.170355333,4.4576312091,4.2872758763,6956
41049,"Morrow","Oregon","US","2020-05-24 02:32:43",45.41846568,-119.584546,12,0,0,12,"Morrow, Oregon, US",11603,243,166,87,79,12,152,164,0,23,7.5774071332,6.8806340635,1.0451596046,13.238688325,14.283847929,5292
20129,"Morton","Kansas","US","2020-05-24 02:32:43",37.19141121,-101.7992519,4,0,0,4,"Morton, Kansas, US",2587,-106,35,23,12,-2,-116,-118,0,83,8.7121212121,4.5454545455,-0.757575758,-43.93939394,-44.6969697,1499
38059,"Morton","North Dakota","US","2020-05-24 02:32:43",46.71681782,-101.2822377,64,2,0,62,"Morton, North Dakota, US",31364,306,434,290,144,3,159,162,0,811,9.2915959117,4.6137579699,0.0961199577,5.0943577585,5.1904777162,11320
48345,"Motley","Texas","US","2020-05-24 02:32:43",34.07408766,-100.779722,1,0,0,1,"Motley, Texas, US",1200,-32,12,15,-3,0,-28,-28,-1,0,12.335526316,-2.467105263,0,-23.02631579,-23.02631579,397
17139,"Moultrie","Illinois","US","2020-05-24 02:32:43",39.64187451,-88.62099969,9,0,0,9,"Moultrie, Illinois, US",14501,-147,174,160,14,3,-166,-163,2,395,10.97807815,0.9605818381,0.2058389653,-11.38975608,-11.18391712,5766
38061,"Mountrail","North Dakota","US","2020-05-24 02:32:43",48.20197971,-102.3555315,39,0,0,39,"Mountrail, North Dakota, US",10545,306,186,97,89,29,188,217,0,526,9.3341031563,8.5642802156,2.7906081601,18.090839107,20.881447267,7030
27099,"Mower","Minnesota","US","2020-05-24 02:32:43",43.67142874,-92.75234549,138,1,0,137,"Mower, Minnesota, US",40062,-80,535,370,165,126,-372,-246,1,633,9.2264724951,4.1145080046,3.1419879308,-9.276345319,-6.134357389,17875
21177,"Muhlenberg","Kentucky","US","2020-05-24 02:32:43",37.21425819,-87.14632053,471,7,0,464,"Muhlenberg, Kentucky, US",30622,-189,340,394,-54,-2,-133,-135,0,2082,12.826982241,-1.758012794,-0.065111585,-4.329920401,-4.395031986,9073
41051,"Multnomah","Oregon","US","2020-05-24 02:32:43",45.54747959,-122.4169351,1037,58,0,979,"Multnomah, Oregon, US",812855,3783,8338,6050,2288,1654,-153,1501,-6,19090,7.460261775,2.8213353622,2.0395492522,-0.188664471,1.8508847809,485059
13213,"Murray","Georgia","US","2020-05-24 02:32:43",34.78897608,-84.74993177,77,1,0,76,"Murray, Georgia, US",40096,153,475,416,59,21,76,97,-3,272,10.39493247,1.4742812879,0.5247441872,1.8990742013,2.4238183885,10867
27101,"Murray","Minnesota","US","2020-05-24 02:32:43",44.02216709,-95.76328482,35,0,0,35,"Murray, Minnesota, US",8194,-60,88,86,2,5,-68,-63,1,163,10.457198444,0.2431906615,0.6079766537,-8.26848249,-7.660505837,3476
40099,"Murray","Oklahoma","US","2020-05-24 02:32:43",34.48116015,-97.06826283,2,0,0,2,"Murray, Oklahoma, US",14073,105,146,187,-41,5,141,146,0,313,13.337612781,-2.924289433,0.3566206626,10.056702685,10.413323348,5259
19139,"Muscatine","Iowa","US","2020-05-24 02:32:43",41.48370744,-91.1121697,541,38,0,503,"Muscatine, Iowa, US",42664,-210,526,372,154,47,-412,-365,1,547,8.6978886577,3.6007388529,1.0989267928,-9.633145503,-8.53421871,22463
13215,"Muscogee","Georgia","US","2020-05-24 02:32:43",32.50931999,-84.87142262,536,17,0,519,"Muscogee, Georgia, US",195769,1600,2774,1922,852,204,544,748,0,6728,9.8579774221,4.3699254753,1.0463201842,2.790187158,3.8365073422,112667
26121,"Muskegon","Michigan","US","2020-05-24 02:32:43",43.29123859,-86.15176712,583,28,0,555,"Muskegon, Michigan, US",173566,-33,2071,1770,301,32,-362,-330,-4,4746,10.196880446,1.7340457707,0.1843503809,-2.085463684,-1.901113303,61083
39119,"Muskingum","Ohio","US","2020-05-24 02:32:43",39.96575964,-81.94363275,44,0,0,44,"Muskingum, Ohio, US",86215,84,1002,971,31,43,15,58,-5,1621,11.26803059,0.3597414503,0.4989962053,0.1740684437,0.673064649,36182
40101,"Muskogee","Oklahoma","US","2020-05-24 02:32:43",35.61318461,-95.37802952,35,6,0,29,"Muskogee, Oklahoma, US",67997,-327,821,906,-85,7,-250,-243,1,3500,13.292156014,-1.24705658,0.1026987772,-3.66781347,-3.565114693,29966
30065,"Musselshell","Montana","US","2020-05-24 02:32:43",46.49684637,-108.39498,1,0,0,1,"Musselshell, Montana, US",4633,1,41,70,-29,3,26,29,1,52,15.110631409,-6.260118726,0.6475984889,5.6125202375,6.2601187264,1875
48347,"Nacogdoches","Texas","US","2020-05-24 02:32:43",31.62017125,-94.61803994,244,17,0,227,"Nacogdoches, Texas, US",65204,43,770,604,166,2,-125,-123,0,4817,9.2662907989,2.5466958156,0.0306830821,-1.917692632,-1.88700955,25898
31125,"Nance","Nebraska","US","2020-05-24 02:32:43",41.39750195,-97.99327291,5,0,0,5,"Nance, Nebraska, US",3519,13,37,28,9,1,3,4,0,141,7.9715302491,2.5622775801,0.2846975089,0.8540925267,1.1387900356,1334
6055,"Napa","California","US","2020-05-24 02:32:43",38.50735751,-122.332839,101,3,0,98,"Napa, California, US",137744,-1045,1235,1279,-44,-13,-985,-998,-3,5061,9.2502522303,-0.318226035,-0.094021328,-7.123923727,-7.217945055,74473
37127,"Nash","North Carolina","US","2020-05-24 02:32:43",35.96575634,-77.98422508,174,4,0,170,"Nash, North Carolina, US",94298,204,1061,1041,20,31,159,190,-6,2206,11.051424689,0.2123232409,0.3291010234,1.6879697652,2.0170707886,42054
12089,"Nassau","Florida","US","2020-05-24 02:32:43",30.61037141,-81.80297522,69,1,0,68,"Nassau, Florida, US",88625,2689,858,979,-121,-15,2813,2798,12,543,11.216709345,-1.386334863,-0.171859694,32.229421234,32.05756154,20029
36059,"Nassau","New York","US","2020-05-24 02:32:43",40.74066522,-73.58941873,39726,2087,0,37639,"Nassau, New York, US",1356924,-610,14001,11312,2689,1650,-4941,-3291,-8,20287,8.3346288651,1.9812426643,1.2157123079,-3.640505766,-2.424793458,570791
22069,"Natchitoches","Louisiana","US","2020-05-24 02:32:43",31.72321584,-93.09816516,145,13,0,132,"Natchitoches, Louisiana, US",38158,-458,468,398,70,23,-551,-528,0,2195,10.368093365,1.8235340089,0.5991611744,-14.3538177,-13.75465652,13864
56025,"Natrona","Wyoming","US","2020-05-24 02:32:43",42.96180148,-106.797885,68,0,0,68,"Natrona, Wyoming, US",79858,683,953,734,219,103,361,464,0,1670,9.2307885785,2.7541453661,1.2953286425,4.5399382518,5.8352668943,41536
4017,"Navajo","Arizona","US","2020-05-24 02:32:43",35.3997715,-110.3218983,1491,56,0,1435,"Navajo, Arizona, US",110924,682,1447,1117,330,44,311,355,-3,1922,10.101010101,2.9841838257,0.3978911768,2.8123671812,3.210258358,31988
48349,"Navarro","Texas","US","2020-05-24 02:32:43",32.04620681,-96.47428766,40,2,0,38,"Navarro, Texas, US",50113,577,678,537,141,9,428,437,-1,742,10.777830184,2.8299330651,0.1806340254,8.5901514315,8.770785457,18344
21179,"Nelson","Kentucky","US","2020-05-24 02:32:43",37.80335779,-85.4657193,35,0,0,35,"Nelson, Kentucky, US",46233,420,552,419,133,-7,294,287,0,496,9.1041435804,2.8898594181,-0.152097864,6.3881102927,6.2360124286,15839
38063,"Nelson","North Dakota","US","2020-05-24 02:32:43",47.9226426,-98.19038437,2,0,0,2,"Nelson, North Dakota, US",2879,-6,23,50,-27,25,-3,22,-1,77,17.349063151,-9.368494101,8.6745315753,-1.040943789,7.6335877863,1284
51125,"Nelson","Virginia","US","2020-05-24 02:32:43",37.78790447,-78.88498513,13,0,0,13,"Nelson, Virginia, US",14930,68,147,159,-12,-1,82,81,-1,102,10.674006445,-0.805585392,-0.067132116,5.5048335124,5.4377013963,4490
20131,"Nemaha","Kansas","US","2020-05-24 02:32:43",39.78345387,-96.01392079,9,0,0,9,"Nemaha, Kansas, US",10231,106,152,84,68,5,36,41,-3,259,8.2530949106,6.6810768324,0.4912556494,3.537040676,4.0282963254,5631
31127,"Nemaha","Nebraska","US","2020-05-24 02:32:43",40.38514847,-95.85433992,3,0,0,3,"Nemaha, Nebraska, US",6972,15,101,67,34,3,-22,-19,0,464,9.6202168138,4.8819010697,0.4307559767,-3.158877163,-2.728121186,3739
20133,"Neosho","Kansas","US","2020-05-24 02:32:43",37.55862897,-95.30670046,2,0,0,2,"Neosho, Kansas, US",16007,-18,182,171,11,38,-67,-29,0,450,10.676823177,0.6868131868,2.3726273726,-4.183316683,-1.810689311,7223
28099,"Neshoba","Mississippi","US","2020-05-24 02:32:43",32.75339664,-89.11726492,511,30,0,481,"Neshoba, Mississippi, US",29118,-33,435,377,58,-3,-87,-90,-1,366,12.939985241,1.9907669601,-0.102970705,-2.98615044,-3.089121145,11980
20135,"Ness","Kansas","US","2020-05-24 02:32:43",38.47974157,-99.91547333,1,0,0,1,"Ness, Kansas, US",2750,-46,14,36,-22,7,-30,-23,-1,70,12.982329607,-7.933645871,2.524341868,-10.81860801,-8.294266138,1692
5099,"Nevada","Arkansas","US","2020-05-24 02:32:43",33.66340119,-93.30632432,4,0,0,4,"Nevada, Arkansas, US",8252,-56,102,104,-2,-3,-51,-54,0,157,12.560386473,-0.241545894,-0.362318841,-6.15942029,-6.52173913,2493
6057,"Nevada","California","US","2020-05-24 02:32:43",39.30394768,-120.7627281,41,1,0,40,"Nevada, California, US",99755,247,778,986,-208,-3,465,462,-7,1178,9.8964684864,-2.087693149,-0.030110959,4.6671986269,4.6370876681,36613
10003,"New Castle","Delaware","US","2020-05-24 02:32:43",39.57992638,-75.64054974,3132,146,0,2986,"New Castle, Delaware, US",558753,1203,6268,4916,1352,69,-201,-132,-17,17471,8.8076445195,2.4222814057,0.1236223498,-0.36011728,-0.23649493,278925
37129,"New Hanover","North Carolina","US","2020-05-24 02:32:43",34.25758282,-77.87075626,152,4,0,148,"New Hanover, North Carolina, US",234473,2217,2197,2034,163,126,1915,2041,13,8468,8.7159786514,0.6984781318,0.5399278811,8.2060467638,8.7459746448,119274
9009,"New Haven","Connecticut","US","2020-05-24 02:32:43",41.4080325,-72.93620426,10847,897,0,9950,"New Haven, Connecticut, US",854757,-2214,8512,7887,625,2740,-5598,-2858,19,28536,9.2152491517,0.7302562089,3.20144322,-6.540758812,-3.339315592,388447
51127,"New Kent","Virginia","US","2020-05-24 02:32:43",37.50694406,-76.99828634,27,1,0,26,"New Kent, Virginia, US",23091,774,233,165,68,0,702,702,4,552,7.2674418605,2.9950669486,0,30.919661734,30.919661734,4375
9011,"New London","Connecticut","US","2020-05-24 02:32:43",41.48896435,-72.10430976,970,72,0,898,"New London, Connecticut, US",265206,-1079,2502,2521,-19,326,-1385,-1059,-1,10997,9.4865199975,-0.071496977,1.2267376117,-5.21175335,-3.985015739,138465
29143,"New Madrid","Missouri","US","2020-05-24 02:32:43",36.59666326,-89.66070007,17,0,0,17,"New Madrid, Missouri, US",17076,-196,204,242,-38,0,-160,-160,2,332,14.091067893,-2.212647025,0,-9.316408525,-9.316408525,7645
36061,"New York City","New York","US","2020-05-24 02:32:43",40.7672726,-73.97152637,197266,21138,0,176128,"New York City, New York, US",1628706,-349,16968,12171,4797,6727,-11730,-5003,-143,68626,7.4720030107,2.9449674178,4.129830273,-7.201264918,-3.071434645,2436836
26123,"Newaygo","Michigan","US","2020-05-24 02:32:43",43.554374,-85.80070107,79,0,0,79,"Newaygo, Michigan, US",48980,141,539,532,7,11,126,137,-3,557,10.87723244,0.1431214795,0.224905182,2.5761866304,2.8010918124,14124
45071,"Newberry","South Carolina","US","2020-05-24 02:32:43",34.28629098,-81.59935761,44,1,0,43,"Newberry, South Carolina, US",38440,-3,395,454,-59,-1,58,57,-1,1291,11.81015309,-1.534799631,-0.026013553,1.5087860775,1.4827725245,15090
44005,"Newport","Rhode Island","US","2020-05-24 02:32:43",41.5642026,-71.26569799,226,0,0,226,"Newport, Rhode Island, US",82082,-465,695,817,-122,152,-492,-340,-3,3783,9.925347296,-1.482120404,1.8465762411,-5.977075728,-4.130499487,44215
51700,"Newport News","Virginia","US","2020-05-24 02:32:43",37.08166899,-76.51754109,234,10,0,224,"Newport News, Virginia, US",179225,702,2633,1538,1095,192,-575,-383,-10,7964,8.5982311571,6.1216275143,1.0733812628,-3.214553261,-2.141171998,111118
5101,"Newton","Arkansas","US","2020-05-24 02:32:43",35.91947491,-93.21612969,3,0,0,3,"Newton, Arkansas, US",7753,-47,84,108,-24,0,-22,-22,-1,51,13.887995885,-3.086221308,0,-2.829036199,-2.829036199,1936
13217,"Newton","Georgia","US","2020-05-24 02:32:43",33.55514538,-83.8454714,289,10,0,279,"Newton, Georgia, US",111744,2323,1373,906,467,37,1822,1859,-3,1649,8.1929780933,4.2230913571,0.3345918206,16.476386408,16.810978229,27472
18111,"Newton","Indiana","US","2020-05-24 02:32:43",40.95610449,-87.39635768,72,10,0,62,"Newton, Indiana, US",13984,-2,129,142,-13,25,-14,11,0,169,10.153736146,-0.929567394,1.7876296031,-1.001072578,0.7865570254,3535
28101,"Newton","Mississippi","US","2020-05-24 02:32:43",32.40021118,-89.11843336,221,3,0,218,"Newton, Mississippi, US",21018,-337,284,271,13,0,-351,-351,1,511,12.791164185,0.6135982819,0,-16.56715361,-16.56715361,5824
29145,"Newton","Missouri","US","2020-05-24 02:32:43",36.90519407,-94.3394104,16,1,0,15,"Newton, Missouri, US",58236,78,692,619,73,6,3,9,-4,882,10.636287094,1.2543601904,0.1030980978,0.0515490489,0.1546471468,24343
48351,"Newton","Texas","US","2020-05-24 02:32:43",30.78548982,-93.74408813,4,0,0,4,"Newton, Texas, US",13595,-156,112,176,-64,0,-94,-94,2,723,12.872083669,-4.680757698,0,-6.874862868,-6.874862868,2702
16069,"Nez Perce","Idaho","US","2020-05-24 02:32:43",46.32638236,-116.7500975,81,19,0,62,"Nez Perce, Idaho, US",40408,152,457,452,5,-20,170,150,-3,1048,11.206982049,0.1239710404,-0.495884161,4.2150153724,3.7191312109,21496
36063,"Niagara","New York","US","2020-05-24 02:32:43",43.19898042,-78.74777412,927,59,0,868,"Niagara, New York, US",209281,-779,2067,2382,-315,61,-519,-458,-6,3574,11.360682595,-1.50235727,0.2909326777,-2.475312455,-2.184379777,75611
21181,"Nicholas","Kentucky","US","2020-05-24 02:32:43",38.33342292,-84.01889177,1,0,0,1,"Nicholas, Kentucky, US",7269,74,84,96,-12,0,86,86,0,95,13.274336283,-1.659292035,0,11.89159292,11.89159292,1362
54067,"Nicholas","West Virginia","US","2020-05-24 02:32:43",38.29617706,-80.79759588,10,1,0,9,"Nicholas, West Virginia, US",24496,-339,245,352,-107,1,-233,-232,0,162,14.270945247,-4.338043016,0.0405424581,-9.446392735,-9.405850277,9167
27103,"Nicollet","Minnesota","US","2020-05-24 02:32:43",44.35291112,-94.24710352,64,3,0,61,"Nicollet, Minnesota, US",34274,75,353,259,94,34,-53,-19,0,2832,7.5650256305,2.7456077578,0.9930921677,-1.548055438,-0.55496327,16761
56027,"Niobrara","Wyoming","US","2020-05-24 02:32:43",43.05607708,-104.4758896,2,0,0,2,"Niobrara, Wyoming, US",2356,-44,28,14,14,0,-57,-57,-1,260,5.8873002523,5.8873002523,0,-23.96972246,-23.96972246,1161
18113,"Noble","Indiana","US","2020-05-24 02:32:43",41.39672484,-85.41966713,174,20,0,154,"Noble, Indiana, US",47744,201,632,455,177,15,12,27,-3,823,9.5500960257,3.7150923001,0.3148383305,0.2518706644,0.5667089949,19443
39121,"Noble","Ohio","US","2020-05-24 02:32:43",39.76818851,-81.45937183,5,0,0,5,"Noble, Ohio, US",14424,77,143,143,0,-2,81,79,-2,2676,9.9405651524,0,-0.139028883,5.6306697716,5.4916408884,3757
40103,"Noble","Oklahoma","US","2020-05-24 02:32:43",36.38953329,-97.22928674,7,0,0,7,"Noble, Oklahoma, US",11131,-148,121,126,-5,2,-145,-143,0,273,11.24497992,-0.446229362,0.1784917448,-12.94065149,-12.76215975,4945
27105,"Nobles","Minnesota","US","2020-05-24 02:32:43",43.67434621,-95.75329576,1444,2,0,1442,"Nobles, Minnesota, US",21629,-115,382,186,196,87,-399,-312,1,385,8.5767643465,9.0378807092,4.0117123556,-18.39854287,-14.38683052,11003
29147,"Nodaway","Missouri","US","2020-05-24 02:32:43",40.36079813,-94.88133008,8,0,0,8,"Nodaway, Missouri, US",22092,-131,195,186,9,4,-145,-141,1,3648,8.3944488322,0.406183008,0.1805257813,-6.544059574,-6.363533792,11184
48353,"Nolan","Texas","US","2020-05-24 02:32:43",32.30365282,-100.4060208,2,0,0,2,"Nolan, Texas, US",14714,-85,187,173,14,15,-115,-100,1,416,11.723647206,0.948734456,1.0165012029,-7.793175889,-6.776674686,6975
2180,"Nome","Alaska","US","2020-05-24 02:32:43",64.90320724,-164.0353804,3,0,0,3,"Nome, Alaska, US",10004,-49,197,101,96,2,-147,-145,0,179,10.071296804,9.5727177544,0.1994316199,-14.65822406,-14.45879244,3587
25021,"Norfolk","Massachusetts","US","2020-05-24 02:32:43",42.16073095,-71.20530408,7759,774,0,6985,"Norfolk, Massachusetts, US",706775,3545,7148,5883,1265,2645,-336,2309,-29,16615,8.3446512601,1.7943198783,3.7517597455,-0.476594055,3.2751656909,330451
51710,"Norfolk","Virginia","US","2020-05-24 02:32:43",36.89934014,-76.26420872,393,6,0,387,"Norfolk, Virginia, US",242742,-843,3321,2077,1244,265,-2334,-2069,-18,34141,8.5415779918,5.1158993846,1.0898017178,-9.598480035,-8.508678317,183258
27107,"Norman","Minnesota","US","2020-05-24 02:32:43",47.32628443,-96.45620947,11,0,0,11,"Norman, Minnesota, US",6375,-104,81,90,-9,8,-103,-95,0,149,14.003423059,-1.400342306,1.2447487164,-16.02613972,-14.78139101,2441
37131,"Northampton","North Carolina","US","2020-05-24 02:32:43",36.41736238,-77.39769443,137,12,0,125,"Northampton, North Carolina, US",19483,-215,173,297,-124,7,-97,-90,-1,770,15.160409382,-6.32959853,0.357316046,-4.951379495,-4.594063449,5689
42095,"Northampton","Pennsylvania","US","2020-05-24 02:32:43",40.75182733,-75.30471829,2866,197,0,2669,"Northampton, Pennsylvania, US",305285,721,2767,2986,-219,272,689,961,-21,11233,9.7925880013,-0.718210573,0.8920240912,2.259575731,3.1515998223,117296
51131,"Northampton","Virginia","US","2020-05-24 02:32:43",37.34062933,-75.87751591,210,16,0,194,"Northampton, Virginia, US",11710,-51,120,188,-68,2,16,18,-1,255,16.019769077,-5.79438456,0.1704230753,1.3633846023,1.5338076776,5131
42097,"Northumberland","Pennsylvania","US","2020-05-24 02:32:43",40.84785433,-76.70798222,164,3,0,161,"Northumberland, Pennsylvania, US",90843,-237,888,1093,-205,-8,-18,-26,-6,3729,12.016072734,-2.253700742,-0.087949297,-0.197885919,-0.285835216,30836
51133,"Northumberland","Virginia","US","2020-05-24 02:32:43",37.89202088,-76.41949732,22,1,0,21,"Northumberland, Virginia, US",12095,-73,88,181,-93,0,21,21,-1,0,14.919836789,-7.665993488,0,1.7310307876,1.7310307876,3063
2188,"Northwest Arctic","Alaska","US","2020-05-24 02:32:43",67.04919196,-159.7503946,2,0,0,2,"Northwest Arctic, Alaska, US",7621,-73,167,90,77,7,-156,-149,-1,396,11.753183154,10.055501143,0.9141364675,-20.37218413,-19.45804767,2889
20137,"Norton","Kansas","US","2020-05-24 02:32:43",39.78443827,-99.90286639,2,0,0,2,"Norton, Kansas, US",5361,-58,51,62,-11,1,-49,-48,1,817,11.502782931,-2.040816327,0.185528757,-9.090909091,-8.905380334,2691
51720,"Norton","Virginia","US","2020-05-24 02:32:43",36.93357076,-82.62750411,2,0,0,2,"Norton, Virginia, US",3981,9,39,46,-7,1,16,17,-1,68,11.567961775,-1.760342009,0.2514774299,4.0236388784,4.2751163083,1282
51135,"Nottoway","Virginia","US","2020-05-24 02:32:43",37.1435975,-78.05065922,19,0,0,19,"Nottoway, Virginia, US",15232,-168,170,224,-54,0,-114,-114,0,2253,14.625228519,-3.525724732,0,-7.443196657,-7.443196657,6722
40105,"Nowata","Oklahoma","US","2020-05-24 02:32:43",36.79843529,-95.61902331,23,0,0,23,"Nowata, Oklahoma, US",10076,-202,126,135,-9,2,-195,-193,0,157,13.265205856,-0.884347057,0.1965215682,-19.1608529,-18.96433134,2398
28103,"Noxubee","Mississippi","US","2020-05-24 02:32:43",33.11009499,-88.56949061,157,6,0,151,"Noxubee, Mississippi, US",10417,-133,161,128,33,6,-173,-167,1,157,12.209662803,3.1478036915,0.5723279439,-16.50212238,-15.92979444,3357
31129,"Nuckolls","Nebraska","US","2020-05-24 02:32:43",40.17637905,-98.04743961,1,0,0,1,"Nuckolls, Nebraska, US",4148,-59,43,61,-18,4,-46,-42,1,42,14.60203471,-4.308797127,0.9575104728,-11.01137044,-10.05385996,1864
48355,"Nueces","Texas","US","2020-05-24 02:32:43",27.736286,-97.5433285,260,3,0,257,"Nueces, Texas, US",362294,268,4467,2976,1491,346,-1571,-1225,2,6783,8.2173624917,4.1169648774,0.9553788381,-4.337861719,-3.38248288,170651
32023,"Nye","Nevada","US","2020-05-24 02:32:43",38.04264256,-116.4722702,59,1,0,58,"Nye, Nevada, US",46523,1337,379,735,-356,-63,1747,1684,9,1165,16.028961171,-7.763687315,-1.373910957,38.098768932,36.724857975,13138
19141,"O'Brien","Iowa","US","2020-05-24 02:32:43",43.08310673,-95.62474482,24,0,0,24,"O'Brien, Iowa, US",13753,-45,170,182,-12,1,-33,-32,-1,395,13.211861638,-0.871111756,0.0725926464,-2.39555733,-2.322964684,6712
26125,"Oakland","Michigan","US","2020-05-24 02:32:43",42.66090111,-83.38595416,8192,954,0,7238,"Oakland, Michigan, US",1257584,890,13042,10978,2064,3617,-4781,-1164,-10,13741,8.732526793,1.6418232192,2.8771679186,-3.80307985,-0.925911932,672137
47131,"Obion","Tennessee","US","2020-05-24 02:32:43",36.35732446,-89.14921589,24,1,0,23,"Obion, Tennessee, US",30069,-205,328,417,-89,5,-121,-116,0,461,13.820990007,-2.949803623,0.1657193046,-4.010407172,-3.844687868,12024
34029,"Ocean","New Jersey","US","2020-05-24 02:32:43",39.8895449,-74.28089251,8316,686,0,7630,"Ocean, New Jersey, US",607186,5708,8555,7091,1464,42,4224,4266,-22,7240,11.733616621,2.4225094815,0.0694982228,6.9895355533,7.0590337761,171764
26127,"Oceana","Michigan","US","2020-05-24 02:32:43",43.64124435,-86.26726673,74,2,0,72,"Oceana, Michigan, US",26467,-88,256,267,-11,42,-118,-76,-1,303,10.071291162,-0.414922108,1.584248048,-4.450982611,-2.866734563,7907
48357,"Ochiltree","Texas","US","2020-05-24 02:32:43",36.27829105,-100.8158184,41,3,0,38,"Ochiltree, Texas, US",9836,-30,139,64,75,-6,-100,-106,1,27,6.4968023551,7.6134402599,-0.609075221,-10.15125368,-10.7603289,6001
13219,"Oconee","Georgia","US","2020-05-24 02:32:43",33.83749973,-83.43679568,103,5,0,98,"Oconee, Georgia, US",40280,802,359,249,110,4,693,697,-5,146,6.2438877605,2.7583439906,0.1003034178,17.377567141,17.477870558,12271
45073,"Oconee","South Carolina","US","2020-05-24 02:32:43",34.75225169,-83.06742317,43,0,0,43,"Oconee, South Carolina, US",79546,1239,701,958,-257,150,1343,1493,3,791,12.137875112,-3.256194054,1.9005023661,17.015831185,18.916333551,26895
55083,"Oconto","Wisconsin","US","2020-05-24 02:32:43",45.02715345,-88.26807503,34,0,0,34,"Oconto, Wisconsin, US",37930,106,369,391,-22,12,117,129,-1,275,10.32288724,-0.580827415,0.3168149537,3.0889457982,3.4057607519,9943
26129,"Ogemaw","Michigan","US","2020-05-24 02:32:43",44.33481032,-84.12725175,20,0,0,20,"Ogemaw, Michigan, US",20997,115,192,281,-89,5,199,204,0,244,13.419613649,-4.250340266,0.238783161,9.5035698083,9.7423529693,7504
46102,"Oglala Lakota","South Dakota","US","2020-05-24 02:32:43",43.33749164,-102.5555498,17,0,0,17,"Oglala Lakota, South Dakota, US",14177,-154,284,172,112,-5,-261,-266,0,92,12.06678827,7.8574435246,-0.350778729,-18.31064964,-18.66142837,3902
17141,"Ogle","Illinois","US","2020-05-24 02:32:43",42.04165196,-89.32184679,185,2,0,183,"Ogle, Illinois, US",50643,-138,525,495,30,5,-172,-167,-1,526,9.7610033128,0.5915759584,0.0985959931,-3.391702161,-3.293106168,17950
13221,"Oglethorpe","Georgia","US","2020-05-24 02:32:43",33.8786296,-83.08278123,58,5,0,53,"Oglethorpe, Georgia, US",15259,179,163,154,9,3,166,169,1,217,10.151949636,0.5932957579,0.1977652526,10.943010646,11.140775899,2464
18115,"Ohio","Indiana","US","2020-05-24 02:32:43",38.955305,-84.96515993,13,0,0,13,"Ohio, Indiana, US",5875,-4,71,76,-5,0,1,1,0,52,12.931767909,-0.850774205,0,0.1701548409,0.1701548409,1634
21183,"Ohio","Kentucky","US","2020-05-24 02:32:43",37.47751843,-86.85368087,120,0,0,120,"Ohio, Kentucky, US",23994,-70,279,271,8,-7,-69,-76,-2,307,11.278039036,0.3329310417,-0.291314661,-2.871530234,-3.162844896,8289
54069,"Ohio","West Virginia","US","2020-05-24 02:32:43",40.0955451,-80.62203992,38,1,0,37,"Ohio, West Virginia, US",41411,-294,401,586,-185,-15,-92,-107,-2,2389,14.100774821,-4.451609798,-0.360941335,-2.213773521,-2.574714856,30255
12091,"Okaloosa","Florida","US","2020-05-24 02:32:43",30.69143028,-86.59267105,192,6,0,186,"Okaloosa, Florida, US",210738,3804,2692,1940,752,76,2961,3037,15,4831,9.2895860867,3.6009117202,0.3639219292,14.178589898,14.542511827,100049
53047,"Okanogan","Washington","US","2020-05-24 02:32:43",48.54855019,-119.7387224,42,1,0,41,"Okanogan, Washington, US",42243,126,493,481,12,58,57,115,-1,640,11.403508772,0.2844950213,1.3750592698,1.3513513514,2.7264106211,16744
12093,"Okeechobee","Florida","US","2020-05-24 02:32:43",27.3863362,-80.88944347,57,0,0,57,"Okeechobee, Florida, US",42168,514,542,447,95,61,358,419,0,3027,10.665457756,2.2667080241,1.4554651523,8.5419102384,9.9973753907,12189
40107,"Okfuskee","Oklahoma","US","2020-05-24 02:32:43",35.46485198,-96.32639984,3,0,0,3,"Okfuskee, Oklahoma, US",11993,-88,151,179,-28,5,-67,-62,2,1226,14.870814987,-2.326161004,0.4153858935,-5.566170973,-5.150785079,2822
40109,"Oklahoma","Oklahoma","US","2020-05-24 02:32:43",35.55140095,-97.40716948,1189,56,0,1133,"Oklahoma, Oklahoma, US",797434,6841,11183,7172,4011,1315,1522,2837,-7,15001,9.0325920151,5.0515513905,1.656143126,1.9168439831,3.5729871092,458587
40111,"Okmulgee","Oklahoma","US","2020-05-24 02:32:43",35.64661916,-95.96432828,22,0,0,22,"Okmulgee, Oklahoma, US",38465,144,420,547,-127,1,270,271,0,1376,14.247388847,-3.307894668,0.0260464147,7.032531972,7.0585783867,11570
28105,"Oktibbeha","Mississippi","US","2020-05-24 02:32:43",33.42491685,-88.87905132,128,10,0,118,"Oktibbeha, Mississippi, US",49587,338,548,366,182,114,42,156,0,4231,7.4062082642,3.6828685904,2.3068517544,0.8498927516,3.1567445061,20179
21185,"Oldham","Kentucky","US","2020-05-24 02:32:43",38.39791089,-85.448222,60,3,0,57,"Oldham, Kentucky, US",66799,287,606,414,192,-1,100,99,-4,4458,6.2110403493,2.8804824808,-0.015002513,1.5002512921,1.4852487792,16129
48359,"Oldham","Texas","US","2020-05-24 02:32:43",35.40425596,-102.6027606,3,1,0,2,"Oldham, Texas, US",2112,-6,24,12,12,0,-19,-19,1,277,5.6737588652,5.6737588652,0,-8.983451537,-8.983451537,970
38065,"Oliver","North Dakota","US","2020-05-24 02:32:43",47.11530482,-101.3406158,1,0,0,1,"Oliver, North Dakota, US",1959,14,22,6,16,0,-1,-1,-1,2,3.0737704918,8.1967213115,0,-0.512295082,-0.512295082,940
27109,"Olmsted","Minnesota","US","2020-05-24 02:32:43",44.00374114,-92.40209944,542,10,0,532,"Olmsted, Minnesota, US",158293,1935,2080,1102,978,423,537,960,-3,2415,7.0045860334,6.2164111984,2.6886931871,3.4133055353,6.1019987224,94629
36065,"Oneida","New York","US","2020-05-24 02:32:43",43.24375382,-75.43710392,864,38,0,826,"Oneida, New York, US",228671,-803,2482,2490,-8,263,-1058,-795,0,12976,10.869921095,-0.034923441,1.1481081317,-4.618625108,-3.470516976,108461
55085,"Oneida","Wisconsin","US","2020-05-24 02:32:43",45.70677897,-89.51944105,7,0,0,7,"Oneida, Wisconsin, US",35595,151,319,461,-142,1,293,294,-1,594,12.9787863,-3.997804023,0.0281535495,8.2489899914,8.2771435409,16979
36067,"Onondaga","New York","US","2020-05-24 02:32:43",43.00491923,-76.19971155,1904,115,0,1789,"Onondaga, New York, US",460528,-1121,4952,4214,738,842,-2707,-1865,6,17073,9.139243334,1.600560413,1.826113642,-5.870890295,-4.044776654,246351
37133,"Onslow","North Carolina","US","2020-05-24 02:32:43",34.72607366,-77.42908179,94,2,0,92,"Onslow, North Carolina, US",197938,1023,3951,1094,2857,-2,-1813,-1815,-19,20497,5.5413027127,14.471208272,-0.010130352,-9.183164367,-9.19329472,91487
36069,"Ontario","New York","US","2020-05-24 02:32:43",42.85145728,-77.30874425,182,9,0,173,"Ontario, New York, US",109777,39,979,1079,-100,42,106,148,-9,3208,9.8307632736,-0.911099469,0.3826617771,0.9657654374,1.3484272145,52756
26131,"Ontonagon","Michigan","US","2020-05-24 02:32:43",46.6652262,-89.31390481,0,0,0,0,"Ontonagon, Michigan, US",5720,-81,28,106,-78,2,-5,-3,0,83,18.401180453,-13.54049128,0.347192084,-0.86798021,-0.520788126,1667
6059,"Orange","California","US","2020-05-24 02:32:43",33.70147516,-117.7645998,5157,130,0,5027,"Orange, California, US",3175692,-281,36406,21518,14888,6178,-21358,-15180,11,43984,6.7755462544,4.6879046675,1.9453167004,-6.725165764,-4.779849063,1560671
12095,"Orange","Florida","US","2020-05-24 02:32:43",28.51367621,-81.31799498,1768,39,0,1729,"Orange, Florida, US",1393452,11912,16922,8890,8032,7258,-3333,3925,-45,35752,6.4072256785,5.7888455174,5.2310060714,-2.402169087,2.828836984,743986
18117,"Orange","Indiana","US","2020-05-24 02:32:43",38.5411892,-86.49523093,122,22,0,100,"Orange, Indiana, US",19646,98,246,226,20,15,64,79,-1,258,11.532377405,1.0205643721,0.7654232791,3.2658059907,4.0312292698,7578
36071,"Orange","New York","US","2020-05-24 02:32:43",41.40337468,-74.30240757,10197,429,0,9768,"Orange, New York, US",384940,2814,5043,2884,2159,145,530,675,-20,11191,7.5195615501,5.6292418123,0.3780639476,1.3818889118,1.7599528593,146123
37135,"Orange","North Carolina","US","2020-05-24 02:32:43",36.06092947,-79.12167935,294,39,0,255,"Orange, North Carolina, US",148476,496,1158,855,303,499,-305,194,-1,10828,5.768140972,2.0441482041,3.3664354913,-2.057640932,1.3087945597,75919
48361,"Orange","Texas","US","2020-05-24 02:32:43",30.11879481,-93.89412775,89,2,0,87,"Orange, Texas, US",83396,-78,1014,940,74,-3,-147,-150,-2,640,11.266255169,0.8869179601,-0.035956134,-1.761850542,-1.797806676,27806
50017,"Orange","Vermont","US","2020-05-24 02:32:43",44.00470222,-72.37640104,8,0,0,8,"Orange, Vermont, US",28892,4,255,280,-25,2,31,33,-4,661,9.6919349256,-0.865351333,0.0692281066,1.0730356525,1.1422637591,9588
51137,"Orange","Virginia","US","2020-05-24 02:32:43",38.24530219,-78.015604,77,0,0,77,"Orange, Virginia, US",37051,453,467,362,105,15,331,346,2,601,9.8304118182,2.851362544,0.4073375063,8.9885809719,9.3959184782,8552
45075,"Orangeburg","South Carolina","US","2020-05-24 02:32:43",33.4391073,-80.79886287,135,2,0,133,"Orangeburg, South Carolina, US",86175,-838,950,1154,-204,24,-655,-631,-3,3030,13.326558422,-2.355821419,0.2771554611,-7.56403446,-7.286878999,32709
29149,"Oregon","Missouri","US","2020-05-24 02:32:43",36.68710164,-91.4033755,2,0,0,2,"Oregon, Missouri, US",10529,-29,111,146,-35,1,6,7,-1,121,13.847394129,-3.319580784,0.0948451653,0.5690709916,0.6639161569,3066
22071,"Orleans","Louisiana","US","2020-05-24 02:32:43",30.06971951,-89.92660315,6944,500,0,6444,"Orleans, Louisiana, US",390144,-860,4399,3640,759,441,-2041,-1600,-19,13464,9.3196167692,1.9432937164,1.1291074163,-5.22564226,-4.096534844,218690
36073,"Orleans","New York","US","2020-05-24 02:32:43",43.2516977,-78.2320066,196,23,0,173,"Orleans, New York, US",40352,-303,389,418,-29,2,-276,-274,0,2522,10.320095794,-0.715987507,0.0493784488,-6.814225931,-6.764847482,13444
50019,"Orleans","Vermont","US","2020-05-24 02:32:43",44.82964024,-72.24562697,9,0,0,9,"Orleans, Vermont, US",27037,178,247,280,-33,6,207,213,-2,777,10.390381475,-1.224580674,0.2226510316,7.6814605908,7.9041116224,11577
20139,"Osage","Kansas","US","2020-05-24 02:32:43",38.65235984,-95.72707998,7,0,0,7,"Osage, Kansas, US",15949,11,170,209,-39,3,48,51,-1,194,13.108790416,-2.446137925,0.1881644557,3.0106312917,3.1987957475,3383
29151,"Osage","Missouri","US","2020-05-24 02:32:43",38.46036182,-91.8613635,5,0,0,5,"Osage, Missouri, US",13615,-37,142,131,11,0,-48,-48,0,405,9.6086844904,0.8068361022,0,-3.520739355,-3.520739355,4653
40113,"Osage","Oklahoma","US","2020-05-24 02:32:43",36.62888819,-96.39635704,94,8,0,86,"Osage, Oklahoma, US",46963,-158,418,522,-104,6,-58,-52,-2,1497,11.096466987,-2.210790358,0.1275455976,-1.232940776,-1.105395179,10000
20141,"Osborne","Kansas","US","2020-05-24 02:32:43",39.3503437,-98.76753828,2,0,0,2,"Osborne, Kansas, US",3421,-38,41,36,5,1,-45,-44,1,100,10.465116279,1.4534883721,0.2906976744,-13.08139535,-12.79069767,1666
12097,"Osceola","Florida","US","2020-05-24 02:32:43",28.06312234,-81.14882926,648,18,0,630,"Osceola, Florida, US",375751,7295,4498,2465,2033,1208,4041,5249,13,3286,6.6245009789,5.4635336674,3.2464085933,10.859881726,14.10629032,94576
19143,"Osceola","Iowa","US","2020-05-24 02:32:43",43.37824276,-95.62422844,30,0,0,30,"Osceola, Iowa, US",5958,-70,59,67,-8,2,-62,-60,-2,97,11.179709661,-1.334890706,0.3337226765,-10.34540297,-10.01168029,2550
26133,"Osceola","Michigan","US","2020-05-24 02:32:43",43.98992088,-85.32566756,10,0,0,10,"Osceola, Michigan, US",23460,83,265,251,14,8,64,72,-3,452,10.718022077,0.5978179644,0.3416102654,2.7328821231,3.0744923885,7610
26135,"Oscoda","Michigan","US","2020-05-24 02:32:43",44.68192279,-84.12939244,5,1,0,4,"Oscoda, Michigan, US",8241,17,71,114,-43,1,58,59,1,65,13.847555421,-5.223200729,0.1214697844,7.0452474947,7.1667172791,2249
36075,"Oswego","New York","US","2020-05-24 02:32:43",43.42778894,-76.14635194,99,3,0,96,"Oswego, New York, US",117124,-391,1207,1090,117,15,-524,-509,1,4534,9.2908680995,0.9972766676,0.127855983,-4.466435674,-4.338579691,37635
8089,"Otero","Colorado","US","2020-05-24 02:32:43",37.9014485,-103.7173385,14,1,0,13,"Otero, Colorado, US",18278,-60,216,235,-19,7,-49,-42,1,488,12.835918724,-1.037797684,0.3823465152,-2.676425606,-2.294079091,7014
35035,"Otero","New Mexico","US","2020-05-24 02:32:43",32.61348406,-105.7417604,12,1,0,11,"Otero, New Mexico, US",67490,831,934,615,319,263,250,513,-1,2317,9.168909198,4.7559057466,3.9210132017,3.727198861,7.6482120627,23710
31131,"Otoe","Nebraska","US","2020-05-24 02:32:43",40.64843556,-96.13374142,6,0,0,6,"Otoe, Nebraska, US",16012,29,192,154,38,31,-39,-8,-1,257,9.6265041413,2.3753711517,1.9378027817,-2.437880919,-0.500078137,6910
26137,"Otsego","Michigan","US","2020-05-24 02:32:43",45.02085831,-84.59898295,100,10,0,90,"Otsego, Michigan, US",24668,27,253,286,-33,-1,62,61,-1,347,11.600316372,-1.338498043,-0.040560547,2.5147538989,2.4741933521,11892
36077,"Otsego","New York","US","2020-05-24 02:32:43",42.63492579,-75.03151402,68,5,0,63,"Otsego, New York, US",59493,-317,485,648,-163,25,-174,-149,-5,5342,10.863096485,-2.732538159,0.4191009447,-2.916942575,-2.49784163,28941
20143,"Ottawa","Kansas","US","2020-05-24 02:32:43",39.13237408,-97.65020313,4,0,0,4,"Ottawa, Kansas, US",5704,-48,39,57,-18,1,-32,-31,1,98,9.9511173184,-3.142458101,0.1745810056,-5.586592179,-5.412011173,1632
26139,"Ottawa","Michigan","US","2020-05-24 02:32:43",42.95996803,-85.9969107,673,26,0,647,"Ottawa, Michigan, US",291830,2022,3267,1968,1299,295,438,733,-10,8705,6.7670956849,4.4666957798,1.0143766398,1.5060914177,2.5204680575,119330
39123,"Ottawa","Ohio","US","2020-05-24 02:32:43",41.53781826,-83.0940185,87,7,0,80,"Ottawa, Ohio, US",40525,-244,324,519,-195,-5,-39,-44,-5,495,12.768469998,-4.797402022,-0.123010308,-0.959480404,-1.082490713,14968
40115,"Ottawa","Oklahoma","US","2020-05-24 02:32:43",36.83532655,-94.81011909,35,2,0,33,"Ottawa, Oklahoma, US",31127,-192,409,470,-61,15,-146,-131,0,970,15.053005797,-1.953687986,0.4804150786,-4.676040099,-4.19562502,12665
27111,"Otter Tail","Minnesota","US","2020-05-24 02:32:43",46.40846929,-95.70835255,53,0,0,53,"Otter Tail, Minnesota, US",58746,76,648,684,-36,31,87,118,-6,1186,11.650882333,-0.613204333,0.5280370648,1.4819104722,2.009947537,24394
5103,"Ouachita","Arkansas","US","2020-05-24 02:32:43",33.58839816,-92.87795984,10,0,0,10,"Ouachita, Arkansas, US",23382,-238,249,338,-89,0,-147,-147,-2,352,14.382366708,-3.787072891,0,-6.255052976,-6.255052976,9094
22073,"Ouachita","Louisiana","US","2020-05-24 02:32:43",32.47645559,-92.15704172,1041,34,0,1007,"Ouachita, Louisiana, US",153279,-1292,2046,1648,398,40,-1731,-1691,1,5544,10.706512912,2.5856748416,0.2598668183,-11.24573656,-10.98586974,69292
8091,"Ouray","Colorado","US","2020-05-24 02:32:43",38.14717457,-107.7675136,8,1,0,7,"Ouray, Colorado, US",4952,130,20,34,-14,1,141,142,2,0,6.9572334766,-2.864743196,0.204624514,28.852056476,29.05668099,2222
55087,"Outagamie","Wisconsin","US","2020-05-24 02:32:43",44.41578887,-88.46565023,181,6,0,175,"Outagamie, Wisconsin, US",187885,1006,2181,1320,861,104,48,152,-7,2913,7.0444332967,4.5948917185,0.5550159567,0.2561612108,0.8111771675,100039
47133,"Overton","Tennessee","US","2020-05-24 02:32:43",36.34117832,-85.28989535,20,0,0,20,"Overton, Tennessee, US",22241,173,233,314,-81,2,254,256,-2,275,14.173192805,-3.656142093,0.0902751134,11.464939403,11.555214516,5473
18119,"Owen","Indiana","US","2020-05-24 02:32:43",39.31145587,-86.83900724,30,1,0,29,"Owen, Indiana, US",20799,-63,201,262,-61,5,-4,1,-3,197,12.577710569,-2.928398262,0.2400326444,-0.192026116,0.0480065289,5530
21187,"Owen","Kentucky","US","2020-05-24 02:32:43",38.51679143,-84.82404619,1,0,0,1,"Owen, Kentucky, US",10901,20,109,109,0,0,20,20,0,0,10.008263704,0,0,1.8363786613,1.8363786613,2549
21189,"Owsley","Kentucky","US","2020-05-24 02:32:43",37.42823949,-83.68811419,2,0,0,2,"Owsley, Kentucky, US",4415,-59,60,65,-5,0,-55,-55,1,90,14.62481719,-1.124985938,0,-12.37484531,-12.37484531,853
16073,"Owyhee","Idaho","US","2020-05-24 02:32:43",42.58016894,-116.1693871,8,0,0,8,"Owyhee, Idaho, US",11823,154,141,94,47,-5,110,105,2,166,8.0027243317,4.0013621658,-0.425676826,9.3648901754,8.9392133492,3321
23017,"Oxford","Maine","US","2020-05-24 02:32:43",44.49952995,-70.75682123,19,0,0,19,"Oxford, Maine, US",57975,221,461,697,-236,19,439,458,-1,990,12.045381884,-4.078493722,0.3283533082,7.5866895938,7.915042902,18832
55089,"Ozaukee","Wisconsin","US","2020-05-24 02:32:43",43.38352225,-87.94625009,134,11,0,123,"Ozaukee, Wisconsin, US",89221,162,850,836,14,32,121,153,-5,1892,9.3785057213,0.1570563159,0.3589858649,1.3574153018,1.7164011667,40641
53049,"Pacific","Washington","US","2020-05-24 02:32:43",46.55418369,-123.7285716,9,1,0,8,"Pacific, Washington, US",22471,397,178,340,-162,32,523,555,4,264,15.265461892,-7.273543608,1.4367493546,23.481872264,24.918621619,6631
19145,"Page","Iowa","US","2020-05-24 02:32:43",40.7393172,-95.1497813,10,0,0,10,"Page, Iowa, US",15107,-122,140,194,-54,1,-68,-67,-1,1519,12.790084388,-3.560126582,0.06592827,-4.483122363,-4.417194093,7627
51139,"Page","Virginia","US","2020-05-24 02:32:43",38.61807452,-78.48797204,186,21,0,165,"Page, Virginia, US",23902,-70,244,299,-55,1,-14,-13,-2,194,12.49112253,-2.297698124,0.0417763295,-0.584868613,-0.543092284,6280
12099,"Palm Beach","Florida","US","2020-05-24 02:32:43",26.64676272,-80.46536002,5140,315,0,4825,"Palm Beach, Florida, US",1496770,13894,14947,15460,-513,7748,6712,14460,-53,21855,10.377071639,-0.344336206,5.2006177915,4.505233172,9.7058509635,624890
19147,"Palo Alto","Iowa","US","2020-05-24 02:32:43",43.08193849,-94.67824621,3,0,0,3,"Palo Alto, Iowa, US",8886,-17,106,108,-2,12,-27,-15,0,259,12.142335151,-0.224858058,1.3491483501,-3.035583788,-1.686435438,4111
48363,"Palo Pinto","Texas","US","2020-05-24 02:32:43",32.75310985,-98.31319001,10,2,0,8,"Palo Pinto, Texas, US",29189,315,352,343,9,2,304,306,0,273,11.814752941,0.3100080947,0.0688906877,10.471384531,10.540275218,9387
37137,"Pamlico","North Carolina","US","2020-05-24 02:32:43",35.15253315,-76.66559823,10,0,0,10,"Pamlico, North Carolina, US",12726,93,79,157,-78,2,169,171,0,707,12.382191727,-6.151662132,0.1577349265,13.328601286,13.486336212,3512
28107,"Panola","Mississippi","US","2020-05-24 02:32:43",34.36398677,-89.95064249,61,2,0,59,"Panola, Mississippi, US",34192,36,487,411,76,24,-62,-38,-2,316,12.026686955,2.2239129163,0.7022882893,-1.814244747,-1.111956458,11323
48365,"Panola","Texas","US","2020-05-24 02:32:43",32.1639596,-94.30552481,188,21,0,167,"Panola, Texas, US",23194,52,254,267,-13,15,53,68,-3,376,11.524516575,-0.561118785,0.6474447514,2.2876381215,2.9350828729,9751
8093,"Park","Colorado","US","2020-05-24 02:32:43",39.120926,-105.7182065,23,0,0,23,"Park, Colorado, US",18845,320,134,117,17,-7,307,300,3,92,6.2617072518,0.9098207118,-0.374632058,16.430291678,16.05565962,3944
30067,"Park","Montana","US","2020-05-24 02:32:43",45.48965095,-110.5264394,8,0,0,8,"Park, Montana, US",16606,-42,154,166,-12,-4,-24,-28,-2,108,9.983761352,-0.721717688,-0.240572563,-1.443435376,-1.684007939,6878
56029,"Park","Wyoming","US","2020-05-24 02:32:43",44.52157546,-109.5852825,2,0,0,2,"Park, Wyoming, US",29194,-16,283,271,12,-10,-16,-26,-2,649,9.2801862886,0.4109307582,-0.342442298,-0.547907678,-0.890349976,15308
18121,"Parke","Indiana","US","2020-05-24 02:32:43",39.77202286,-87.20375833,17,0,0,17,"Parke, Indiana, US",16937,-41,203,175,28,5,-73,-68,-1,1601,10.319917441,1.6511867905,0.294854784,-4.304879847,-4.010025063,3987
48367,"Parker","Texas","US","2020-05-24 02:32:43",32.77757172,-97.80500621,67,1,0,66,"Parker, Texas, US",142878,4808,1548,1152,396,35,4369,4404,8,1243,8.2008058431,2.8190270086,0.2491564275,31.10184091,31.350997338,34891
48369,"Parmer","Texas","US","2020-05-24 02:32:43",34.52993409,-102.7844668,39,0,0,39,"Parmer, Texas, US",9605,-114,137,52,85,19,-219,-200,1,68,5.3819085076,8.797350445,1.9664665701,-22.66611468,-20.69964811,5550
12101,"Pasco","Florida","US","2020-05-24 02:32:43",28.30810945,-82.40227529,341,12,0,329,"Pasco, Florida, US",553947,14857,5186,6466,-1280,519,15563,16082,55,5794,11.831255484,-2.342098209,0.9496476332,28.476620645,29.426268278,125829
37139,"Pasquotank","North Carolina","US","2020-05-24 02:32:43",36.26723798,-76.25134778,95,9,0,86,"Pasquotank, North Carolina, US",39824,241,463,370,93,34,112,146,2,1955,9.3190776632,2.342362764,0.8563476772,2.8209099953,3.6772576725,17661
34031,"Passaic","New Jersey","US","2020-05-24 02:32:43",41.03238628,-74.29954144,15610,888,0,14722,"Passaic, New Jersey, US",501826,-1357,6602,3769,2833,1837,-6045,-4208,18,10168,7.5004303444,5.6377604579,3.6556886555,-12.02974302,-8.374054362,184222
51141,"Patrick","Virginia","US","2020-05-24 02:32:43",36.6801638,-80.2865648,13,0,0,13,"Patrick, Virginia, US",17608,-55,153,240,-87,-4,37,33,-1,295,13.608913839,-4.933231266,-0.226815231,2.0980408834,1.8712256528,5062
13223,"Paulding","Georgia","US","2020-05-24 02:32:43",33.91969522,-84.86848792,275,11,0,264,"Paulding, Georgia, US",168667,4614,1860,1079,781,5,3820,3825,8,530,6.4859341188,4.6946381342,0.0300553018,22.962250541,22.992305843,27806
39125,"Paulding","Ohio","US","2020-05-24 02:32:43",41.11676341,-84.5801017,13,0,0,13,"Paulding, Ohio, US",18672,-70,218,203,15,3,-89,-86,1,85,10.851552895,0.8018388838,0.1603677768,-4.757577377,-4.597209601,5167
40117,"Pawnee","Oklahoma","US","2020-05-24 02:32:43",36.31743373,-96.7033176,29,2,0,27,"Pawnee, Oklahoma, US",16376,20,192,200,-8,4,23,27,1,194,12.220457045,-0.488818282,0.2444091409,1.4053525602,1.6497617011,4259
16075,"Payette","Idaho","US","2020-05-24 02:32:43",44.00545243,-116.7647695,23,2,0,21,"Payette, Idaho, US",23951,444,306,214,92,-34,386,352,0,125,9.0185005689,3.8771123941,-1.432845885,16.267015045,14.83416916,6469
40119,"Payne","Oklahoma","US","2020-05-24 02:32:43",36.07695283,-96.97584944,45,1,0,44,"Payne, Oklahoma, US",81784,-388,815,592,223,396,-1014,-618,7,7786,7.2214496572,2.7202420162,4.8305642977,-12.36917222,-7.538607919,37716
13225,"Peach","Georgia","US","2020-05-24 02:32:43",32.56934316,-83.82937,70,3,0,67,"Peach, Georgia, US",27546,183,339,283,56,11,119,130,-3,1438,10.307964086,2.0397384764,0.400662915,4.3344442623,4.7351071773,9276
28109,"Pearl River","Mississippi","US","2020-05-24 02:32:43",30.77090935,-89.58677275,203,27,0,176,"Pearl River, Mississippi, US",55535,212,610,681,-71,-30,315,285,-2,1339,12.285987479,-1.280917931,-0.541232929,5.6829457504,5.1417128218,12049
48371,"Pecos","Texas","US","2020-05-24 02:32:43",30.78097267,-102.7241261,24,0,0,24,"Pecos, Texas, US",15823,114,189,99,90,-1,25,24,0,2083,6.2793352784,5.7084866168,-0.063427629,1.5856907269,1.5222630978,7030
38067,"Pembina","North Dakota","US","2020-05-24 02:32:43",48.76623521,-97.5523809,6,0,0,6,"Pembina, North Dakota, US",6801,-94,70,84,-14,14,-94,-80,0,148,12.26635514,-2.044392523,2.0443925234,-13.72663551,-11.68224299,4100
29155,"Pemiscot","Missouri","US","2020-05-24 02:32:43",36.2130572,-89.78742322,72,4,0,68,"Pemiscot, Missouri, US",15805,-451,224,236,-12,-8,-433,-441,2,202,14.721936309,-0.748573033,-0.499048688,-27.01101026,-27.51005895,5818
53051,"Pend Oreille","Washington","US","2020-05-24 02:32:43",48.53234021,-117.2741804,2,0,0,2,"Pend Oreille, Washington, US",13724,138,119,161,-42,6,175,181,-1,98,11.790552911,-3.075796412,0.4393994874,12.815818382,13.255217869,3508
37141,"Pender","North Carolina","US","2020-05-24 02:32:43",34.52265624,-77.90352133,65,1,0,64,"Pender, North Carolina, US",63060,1043,647,556,91,-2,957,955,-3,1064,8.8905234376,1.4551036561,-0.0319803,15.302573615,15.270593315,12837
21191,"Pendleton","Kentucky","US","2020-05-24 02:32:43",38.69607718,-84.35599463,7,0,0,7,"Pendleton, Kentucky, US",14590,2,179,164,15,3,-15,-12,-1,215,11.24134622,1.0281719103,0.2056343821,-1.02817191,-0.822537528,3127
54071,"Pendleton","West Virginia","US","2020-05-24 02:32:43",38.68314479,-79.35084086,6,0,0,6,"Pendleton, West Virginia, US",6969,-15,62,62,0,-1,-13,-14,-1,117,8.8869777109,0,-0.14333835,-1.863398552,-2.006736902,2168
27113,"Pennington","Minnesota","US","2020-05-24 02:32:43",48.06642577,-96.0370814,7,0,0,7,"Pennington, Minnesota, US",14119,-54,164,129,35,9,-98,-89,0,327,9.1191856355,2.474197653,0.6362222536,-6.927753429,-6.291531175,10058
46103,"Pennington","South Dakota","US","2020-05-24 02:32:43",44.0025835,-102.8240777,138,3,0,135,"Pennington, South Dakota, US",113775,1825,1495,920,575,-13,1253,1240,10,2567,8.1515117953,5.0946948721,-0.115184406,11.102004652,10.986820246,59367
23019,"Penobscot","Maine","US","2020-05-24 02:32:43",45.40194593,-68.65020455,98,1,0,97,"Penobscot, Maine, US",152148,331,1378,1594,-216,62,491,553,-6,7645,10.488049611,-1.421216258,0.4079417038,3.230635106,3.6385768098,73447
17143,"Peoria","Illinois","US","2020-05-24 02:32:43",40.78702156,-89.76078901,176,7,0,169,"Peoria, Illinois, US",179179,-1441,2445,1826,619,258,-2321,-2063,3,4811,10.15011159,3.4408100078,1.4341340582,-12.90164786,-11.46751381,107061
55091,"Pepin","Wisconsin","US","2020-05-24 02:32:43",44.58307413,-91.99949611,1,0,0,1,"Pepin, Wisconsin, US",7287,-17,78,93,-15,6,-8,-2,0,106,12.747584127,-2.056061956,0.8224247824,-1.096566377,-0.274141594,2810
37143,"Perquimans","North Carolina","US","2020-05-24 02:32:43",36.17847453,-76.40603143,23,2,0,21,"Perquimans, North Carolina, US",13463,82,116,146,-30,-8,122,114,-2,72,10.877663537,-2.235136343,-0.596036358,9.0895544628,8.4935181046,2681
1105,"Perry","Alabama","US","2020-05-24 02:32:43",32.64048341,-87.29770589,29,0,0,29,"Perry, Alabama, US",8923,-147,95,121,-26,2,-124,-122,1,709,13.449674874,-2.890012783,0.2223086756,-13.78313789,-13.56082921,2125
5105,"Perry","Arkansas","US","2020-05-24 02:32:43",34.9459153,-92.94372564,12,0,0,12,"Perry, Arkansas, US",10455,75,117,138,-21,1,96,97,-1,152,13.246940245,-2.015838733,0.0959923206,9.215262779,9.3112550996,1764
17145,"Perry","Illinois","US","2020-05-24 02:32:43",38.08510853,-89.36856219,40,0,0,40,"Perry, Illinois, US",20916,-228,188,228,-40,4,-193,-189,1,2471,10.841654779,-1.902044698,0.1902044698,-9.177365668,-8.987161198,6327
18123,"Perry","Indiana","US","2020-05-24 02:32:43",38.07809328,-86.63741946,23,0,0,23,"Perry, Indiana, US",19169,92,205,184,21,-1,74,73,-2,1583,9.6219212467,1.0981540553,-0.05229305,3.8696857188,3.8173926685,7513
21193,"Perry","Kentucky","US","2020-05-24 02:32:43",37.25023553,-83.22922731,19,0,0,19,"Perry, Kentucky, US",25758,-450,321,409,-88,5,-368,-363,1,611,15.741061463,-3.38682985,0.1924335142,-14.16310665,-13.97067313,11792
28111,"Perry","Mississippi","US","2020-05-24 02:32:43",31.17161885,-88.99281835,43,2,0,41,"Perry, Mississippi, US",11973,55,128,115,13,-3,44,41,1,102,9.6270562136,1.0882759198,-0.251140597,3.6833954209,3.432254824,2606
29157,"Perry","Missouri","US","2020-05-24 02:32:43",37.70660776,-89.82741088,49,0,0,49,"Perry, Missouri, US",19136,-138,222,222,0,10,-150,-140,2,286,11.559489716,0,0.520697735,-7.810466024,-7.28976829,9605
39127,"Perry","Ohio","US","2020-05-24 02:32:43",39.73508655,-82.23804971,17,1,0,16,"Perry, Ohio, US",36134,95,420,369,51,6,40,46,-2,307,10.225430563,1.4132708908,0.1662671636,1.1084477575,1.2747149211,7361
42099,"Perry","Pennsylvania","US","2020-05-24 02:32:43",40.40206612,-77.26297447,45,1,0,44,"Perry, Pennsylvania, US",46272,118,493,459,34,5,83,88,-4,660,9.9322701404,0.7357237141,0.1081946638,1.7960314197,1.9042260836,10178
47135,"Perry","Tennessee","US","2020-05-24 02:32:43",35.63708728,-87.86139634,13,0,0,13,"Perry, Tennessee, US",8076,26,102,104,-2,7,21,28,0,123,12.898424904,-0.248046633,0.8681632147,2.6044896441,3.4726528587,2302
32027,"Pershing","Nevada","US","2020-05-24 02:32:43",40.44003782,-118.4005641,0,0,0,0,"Pershing, Nevada, US",6725,40,53,43,10,0,29,29,1,1803,6.4131245339,1.4914243102,0,4.3251304996,4.3251304996,2105
37145,"Person","North Carolina","US","2020-05-24 02:32:43",36.38989032,-78.97217358,37,1,0,36,"Person, North Carolina, US",39490,54,417,448,-31,-8,94,86,-1,448,11.352406051,-0.785545954,-0.202721537,2.3819780554,2.1792565188,11586
2195,"Petersburg","Alaska","US","2020-05-24 02:32:43",57.13978948,-132.9540995,4,1,0,3,"Petersburg, Alaska, US",3266,22,30,29,1,2,19,21,0,43,8.9093701997,0.3072196621,0.6144393241,5.8371735791,6.4516129032,1587
51730,"Petersburg","Virginia","US","2020-05-24 02:32:43",37.20530399,-77.39368102,87,2,0,85,"Petersburg, Virginia, US",31346,290,686,495,191,15,85,100,-1,884,15.864876126,6.1215986667,0.480753822,2.724271658,3.20502548,15263
29159,"Pettis","Missouri","US","2020-05-24 02:32:43",38.72798918,-93.28471706,70,1,0,69,"Pettis, Missouri, US",42339,-102,577,424,153,15,-270,-255,0,851,10.002359047,3.6093418259,0.3538570418,-6.369426752,-6.01556971,20042
29161,"Phelps","Missouri","US","2020-05-24 02:32:43",37.87736118,-91.79351727,4,0,0,4,"Phelps, Missouri, US",44573,22,461,421,40,173,-191,-18,0,3017,9.4475113325,0.8976257798,3.8822314977,-4.286163099,-0.403931601,20468
31137,"Phelps","Nebraska","US","2020-05-24 02:32:43",40.51156033,-99.41461667,18,0,0,18,"Phelps, Nebraska, US",9034,28,116,92,24,5,-1,4,0,246,10.199556541,2.6607538803,0.5543237251,-0.110864745,0.44345898,4949
42101,"Philadelphia","Pennsylvania","US","2020-05-24 02:32:43",40.00338507,-75.1379271,21234,1233,0,20001,"Philadelphia, Pennsylvania, US",1584064,472,20924,15561,5363,5649,-10446,-4797,-94,56387,9.8249304849,3.3861000058,3.5666751693,-6.595413138,-3.028737969,730958
5107,"Phillips","Arkansas","US","2020-05-24 02:32:43",34.43268455,-90.84800154,7,1,0,6,"Phillips, Arkansas, US",17782,-272,267,255,12,-4,-281,-285,1,246,14.231499051,0.6697176024,-0.223239201,-15.68255386,-15.90579306,6273
8095,"Phillips","Colorado","US","2020-05-24 02:32:43",40.59414277,-102.3577703,12,0,0,12,"Phillips, Colorado, US",4265,-20,42,57,-15,23,-28,-5,0,60,13.333333333,-3.50877193,5.3801169591,-6.549707602,-1.169590643,2183
20147,"Phillips","Kansas","US","2020-05-24 02:32:43",39.78465501,-99.34668865,2,0,0,2,"Phillips, Kansas, US",5234,-42,49,64,-15,0,-27,-27,0,68,12.17887726,-2.854424358,0,-5.137963844,-5.137963844,2710
17147,"Piatt","Illinois","US","2020-05-24 02:32:43",40.01360584,-88.59319339,10,0,0,10,"Piatt, Illinois, US",16344,-22,173,159,14,-1,-35,-36,0,72,9.7217976154,0.8560073372,-0.061143381,-2.140018343,-2.201161724,4493
39129,"Pickaway","Ohio","US","2020-05-24 02:32:43",39.64170392,-83.0243386,2038,35,0,2003,"Pickaway, Ohio, US",58457,380,604,587,17,-1,367,366,-3,4760,10.074313076,0.2917603446,-0.017162373,6.2985909692,6.2814285959,16286
1107,"Pickens","Alabama","US","2020-05-24 02:32:43",33.28094866,-88.08818103,88,4,0,84,"Pickens, Alabama, US",19930,-50,205,235,-30,14,-33,-19,-1,1878,11.776497119,-1.503382611,0.7015785517,-1.653720872,-0.95214232,4041
13227,"Pickens","Georgia","US","2020-05-24 02:32:43",34.46589159,-84.46406611,43,3,0,40,"Pickens, Georgia, US",32591,577,297,349,-52,2,625,627,2,398,10.804117328,-1.609782525,0.0619147125,19.348347651,19.410262364,10621
45077,"Pickens","South Carolina","US","2020-05-24 02:32:43",34.88807695,-82.72791551,114,3,0,111,"Pickens, South Carolina, US",126884,1659,1159,1206,-47,240,1459,1699,7,8314,9.5672903387,-0.372854599,1.9039383759,11.57435871,13.478297086,40345
47137,"Pickett","Tennessee","US","2020-05-24 02:32:43",36.55606529,-85.077633,3,0,0,3,"Pickett, Tennessee, US",5048,-5,35,67,-32,-1,29,28,-1,65,13.266013266,-6.336006336,-0.198000198,5.742005742,5.544005544,1513
13229,"Pierce","Georgia","US","2020-05-24 02:32:43",31.35928155,-82.21598442,88,3,0,85,"Pierce, Georgia, US",19465,77,263,226,37,-8,47,39,1,149,11.633593288,1.9046148303,-0.411808612,2.4193755952,2.0075669832,4655
31139,"Pierce","Nebraska","US","2020-05-24 02:32:43",42.26434853,-97.60122773,2,0,0,2,"Pierce, Nebraska, US",7148,3,87,67,20,0,-18,-18,1,103,9.3752186385,2.7985727279,0,-2.518715455,-2.518715455,2355
38069,"Pierce","North Dakota","US","2020-05-24 02:32:43",48.24977025,-99.96407787,4,0,0,4,"Pierce, North Dakota, US",3975,-95,41,55,-14,0,-82,-82,1,239,13.673088875,-3.480422623,0,-20.3853325,-20.3853325,2164
53053,"Pierce","Washington","US","2020-05-24 02:32:43",47.03892768,-122.1405958,1728,69,0,1659,"Pierce, Washington, US",904980,11224,11498,7284,4214,1048,5944,6992,18,20964,8.0990206456,4.6855124932,1.1652627178,6.6090854911,7.774348209,326598
55093,"Pierce","Wisconsin","US","2020-05-24 02:32:43",44.71850291,-92.4224416,36,0,0,36,"Pierce, Wisconsin, US",42754,162,380,290,90,-2,76,74,-2,2810,6.7958662386,2.1090619361,-0.046868043,1.7809856349,1.7341175919,11324
1109,"Pike","Alabama","US","2020-05-24 02:32:43",31.80396383,-85.9408295,128,0,0,128,"Pike, Alabama, US",33114,-128,345,339,6,79,-210,-131,-3,2204,10.217614082,0.1808427271,2.3810959069,-6.329495449,-3.948399542,16189
5109,"Pike","Arkansas","US","2020-05-24 02:32:43",34.16250414,-93.65789349,4,0,0,4,"Pike, Arkansas, US",10718,52,102,130,-28,2,80,82,-2,196,12.15862327,-2.618780397,0.1870557426,7.4822297045,7.6692854471,3693
13231,"Pike","Georgia","US","2020-05-24 02:32:43",33.09310242,-84.38790389,48,2,0,46,"Pike, Georgia, US",18962,315,205,189,16,0,299,299,0,259,10.050785716,0.8508601664,0,15.900449361,15.900449361,2972
17149,"Pike","Illinois","US","2020-05-24 02:32:43",39.62265059,-90.8877017,1,0,0,1,"Pike, Illinois, US",15561,-34,194,176,18,-1,-50,-51,-1,488,11.297984337,1.1554756708,-0.064193093,-3.209654641,-3.273847734,5511
18125,"Pike","Indiana","US","2020-05-24 02:32:43",38.40112197,-87.23574907,5,0,0,5,"Pike, Indiana, US",12389,1,131,145,-14,11,4,15,0,213,11.704403277,-1.130080316,0.8879202486,0.3228800904,1.210800339,3873
21195,"Pike","Kentucky","US","2020-05-24 02:32:43",37.47088263,-82.39487445,28,2,0,26,"Pike, Kentucky, US",57876,-616,583,808,-225,-1,-390,-391,0,1443,13.886979238,-3.867042486,-0.017186855,-6.702873642,-6.720060498,23406
28113,"Pike","Mississippi","US","2020-05-24 02:32:43",31.17507789,-90.40392572,194,11,0,183,"Pike, Mississippi, US",39288,-92,540,531,9,4,-104,-100,-1,869,13.49977119,0.2288096812,0.1016931916,-2.644022983,-2.542329791,15256
29163,"Pike","Missouri","US","2020-05-24 02:32:43",39.34310674,-91.16980779,14,1,0,13,"Pike, Missouri, US",18302,-200,206,189,17,0,-217,-217,0,2372,10.270622758,0.9238126291,0,-11.7921965,-11.7921965,7129
39131,"Pike","Ohio","US","2020-05-24 02:32:43",39.07634001,-83.06769584,6,0,0,6,"Pike, Ohio, US",27772,-160,334,379,-45,-2,-114,-116,1,496,13.607640385,-1.615682895,-0.071808129,-4.093063335,-4.164871463,10253
42103,"Pike","Pennsylvania","US","2020-05-24 02:32:43",41.33155042,-75.03208106,476,18,0,458,"Pike, Pennsylvania, US",55809,29,411,527,-116,6,144,150,-5,477,9.4453754402,-2.079057972,0.1075374813,2.580899551,2.6884370323,13432
4019,"Pima","Arizona","US","2020-05-24 02:32:43",32.0971334,-111.7890033,2002,173,0,1829,"Pima, Arizona, US",1047279,10725,10891,10199,692,1204,8801,10005,28,24751,9.78869228,0.6641607077,1.1555628498,8.4469340873,9.6024969371,416900
4021,"Pinal","Arizona","US","2020-05-24 02:32:43",32.90525627,-111.3449483,751,37,0,714,"Pinal, Arizona, US",462789,15983,4568,3330,1238,487,14180,14667,78,25918,7.3219399843,2.7220906008,1.0708062379,31.178711405,32.249517642,83086
27115,"Pine","Minnesota","US","2020-05-24 02:32:43",46.12105238,-92.74070188,84,0,0,84,"Pine, Minnesota, US",29579,111,251,278,-27,3,137,140,-2,1640,9.4162277508,-0.914525717,0.1016139685,4.6403712297,4.7419851982,10178
12103,"Pinellas","Florida","US","2020-05-24 02:32:43",27.93130349,-82.72239666,1153,75,0,1078,"Pinellas, Florida, US",974996,1938,8104,12833,-4729,1336,5351,6687,-20,19925,13.175199455,-4.855101553,1.3716252219,5.4936875466,6.8653127685,428966
27117,"Pipestone","Minnesota","US","2020-05-24 02:32:43",44.02301619,-96.25841142,10,0,0,10,"Pipestone, Minnesota, US",9126,-1,132,112,20,23,-43,-20,-1,205,12.271955295,2.1914205884,2.5201336767,-4.711554265,-2.191420588,4636
23021,"Piscataquis","Maine","US","2020-05-24 02:32:43",45.83839062,-69.2860223,1,0,0,1,"Piscataquis, Maine, US",16785,39,121,226,-105,14,131,145,-1,236,13.480063225,-6.262861233,0.8350481644,7.8136649667,8.6487131311,6273
8097,"Pitkin","Colorado","US","2020-05-24 02:32:43",39.21720112,-106.9310027,57,2,0,55,"Pitkin, Colorado, US",17767,-209,130,55,75,93,-380,-287,3,72,3.0775256694,4.1966259128,5.2038161318,-21.26290462,-16.05908849,16608
37147,"Pitt","North Carolina","US","2020-05-24 02:32:43",35.59535426,-77.37353178,254,2,0,252,"Pitt, North Carolina, US",180742,1167,2053,1432,621,101,444,545,1,6324,7.9485564101,3.446964756,0.5606174563,2.4644965405,3.0251139968,81060
40121,"Pittsburg","Oklahoma","US","2020-05-24 02:32:43",34.92065823,-95.7513432,40,3,0,37,"Pittsburg, Oklahoma, US",43654,-216,508,616,-108,3,-111,-108,0,2415,14.076139116,-2.46789452,0.0685526256,-2.536447146,-2.46789452,18883
51143,"Pittsylvania","Virginia","US","2020-05-24 02:32:43",36.81980341,-79.39731264,28,1,0,27,"Pittsylvania, Virginia, US",60354,-547,491,766,-275,-1,-269,-270,-2,1071,12.634530535,-4.535895427,-0.016494165,-4.436930436,-4.453424601,15600
6061,"Placer","California","US","2020-05-24 02:32:43",39.06167234,-120.7240569,185,9,0,176,"Placer, California, US",398329,5999,3721,3480,241,79,5687,5766,-8,3947,8.8027835009,0.6096180528,0.1998333036,14.385468325,14.585301628,156221
22075,"Plaquemines","Louisiana","US","2020-05-24 02:32:43",29.42245447,-89.60322085,198,16,0,182,"Plaquemines, Louisiana, US",23197,-188,270,195,75,12,-277,-265,2,272,8.3723326607,3.2201279464,0.5152204714,-11.89300588,-11.37778541,18620
29165,"Platte","Missouri","US","2020-05-24 02:32:43",39.38154439,-94.77068479,63,0,0,63,"Platte, Missouri, US",104418,1654,1191,693,498,208,946,1154,2,868,6.6897703468,4.8073674354,2.0078964389,9.1320674576,11.139963896,45624
31141,"Platte","Nebraska","US","2020-05-24 02:32:43",41.57246836,-97.52144359,522,1,0,521,"Platte, Nebraska, US",33470,183,461,281,180,73,-69,4,-1,471,8.4185928067,5.3926929011,2.1870365655,-2.067198945,0.11983762,19242
56031,"Platte","Wyoming","US","2020-05-24 02:32:43",42.13299116,-104.966331,1,0,0,1,"Platte, Wyoming, US",8393,-123,74,109,-35,-10,-77,-87,-1,102,12.892542433,-4.139807203,-1.182802058,-9.107575847,-10.29037791,4202
54073,"Pleasants","West Virginia","US","2020-05-24 02:32:43",39.37091679,-81.16771771,3,0,0,3,"Pleasants, West Virginia, US",7460,-45,68,76,-8,-1,-37,-38,1,699,10.157033077,-1.069161377,-0.133645172,-4.944871367,-5.078516539,2862
6063,"Plumas","California","US","2020-05-24 02:32:43",40.00355989,-120.8395236,4,0,0,4,"Plumas, California, US",18807,66,157,213,-56,-3,126,123,-1,287,11.345477788,-2.98284862,-0.159795462,6.711409396,6.5516139342,7257
19149,"Plymouth","Iowa","US","2020-05-24 02:32:43",42.737633,-96.21366621,103,0,0,103,"Plymouth, Iowa, US",25177,153,276,231,45,17,95,112,-4,282,9.2030039242,1.7927929723,0.6772773451,3.7847851636,4.4620625087,11266
25023,"Plymouth","Massachusetts","US","2020-05-24 02:32:43",41.94070556,-70.80802823,7480,501,0,6979,"Plymouth, Massachusetts, US",521202,2780,5173,4757,416,1300,1105,2405,-41,11208,9.1513855009,0.8002893354,2.500904173,2.1257685471,4.6266727201,192057
19151,"Pocahontas","Iowa","US","2020-05-24 02:32:43",42.73420133,-94.67862564,4,0,0,4,"Pocahontas, Iowa, US",6619,-95,71,85,-14,0,-81,-81,0,101,12.750318758,-2.100052501,0,-12.15030376,-12.15030376,3324
54075,"Pocahontas","West Virginia","US","2020-05-24 02:32:43",38.32758728,-80.00993811,24,0,0,24,"Pocahontas, West Virginia, US",8247,-161,76,127,-51,0,-108,-108,-2,319,15.250675473,-6.124287001,0,-12.96907835,-12.96907835,3488
5111,"Poinsett","Arkansas","US","2020-05-24 02:32:43",35.57433534,-90.66268713,31,2,0,29,"Poinsett, Arkansas, US",23528,-375,310,334,-24,-4,-348,-352,1,341,14.0836162,-1.011996374,-0.168666062,-14.67394742,-14.84261348,6156
22077,"Pointe Coupee","Louisiana","US","2020-05-24 02:32:43",30.71409502,-91.60209535,182,22,0,160,"Pointe Coupee, Louisiana, US",21730,-149,236,253,-17,-5,-125,-130,-2,116,11.60310945,-0.779655576,-0.229310463,-5.732761586,-5.962072049,6003
5113,"Polk","Arkansas","US","2020-05-24 02:32:43",34.48254879,-94.22728802,9,0,0,9,"Polk, Arkansas, US",19964,-55,215,286,-71,-3,21,18,-2,155,14.306080084,-3.551509391,-0.150063777,1.0504464397,0.9003826626,7473
12105,"Polk","Florida","US","2020-05-24 02:32:43",27.95027105,-81.69732947,853,49,0,804,"Polk, Florida, US",724777,18180,8043,7237,806,673,16638,17311,63,13797,10.111962352,1.1261906392,0.9403552111,23.247592872,24.187948083,217433
13233,"Polk","Georgia","US","2020-05-24 02:32:43",34.00267074,-85.18677781,96,0,0,96,"Polk, Georgia, US",42613,267,580,489,91,-5,181,176,0,385,11.511434927,2.1422097718,-0.117703834,4.2608787768,4.1431749432,12823
19153,"Polk","Iowa","US","2020-05-24 02:32:43",41.68679484,-93.57767461,3603,106,0,3497,"Polk, Iowa, US",490161,4328,6750,3580,3170,385,777,1162,-4,9412,7.3361106728,6.4959415734,0.7889392763,1.592222903,2.3811621793,276893
27119,"Polk","Minnesota","US","2020-05-24 02:32:43",47.77372465,-96.40134647,59,2,0,57,"Polk, Minnesota, US",31364,-47,421,344,77,35,-158,-123,-1,1211,10.959776981,2.4532058941,1.1150935882,-5.033851055,-3.918757467,13166
29167,"Polk","Missouri","US","2020-05-24 02:32:43",37.6162296,-93.39828174,3,0,0,3,"Polk, Missouri, US",32149,-65,399,388,11,-13,-63,-76,0,1513,12.056616379,0.3418112891,-0.403958796,-1.957646474,-2.36160527,10313
31143,"Polk","Nebraska","US","2020-05-24 02:32:43",41.18813488,-97.56630712,9,0,0,9,"Polk, Nebraska, US",5213,-27,61,63,-2,3,-29,-26,1,105,12.053955802,-0.382665264,0.5739978953,-5.548646322,-4.974648426,1897
37149,"Polk","North Carolina","US","2020-05-24 02:32:43",35.27820615,-82.16812354,35,4,0,31,"Polk, North Carolina, US",20724,56,155,308,-153,13,195,208,1,344,14.882102822,-7.392732895,0.6281407035,9.4221105528,10.050251256,5821
41053,"Polk","Oregon","US","2020-05-24 02:32:43",44.90322804,-123.4128888,95,10,0,85,"Polk, Oregon, US",86085,1093,848,703,145,56,892,948,0,1822,8.2185214845,1.6951431227,0.6546759646,10.428052865,11.08272883,20181
47139,"Polk","Tennessee","US","2020-05-24 02:32:43",35.12245443,-84.52075859,14,0,0,14,"Polk, Tennessee, US",16832,-86,166,235,-69,2,-19,-17,0,274,13.925925926,-4.088888889,0.1185185185,-1.125925926,-1.007407407,3497
48373,"Polk","Texas","US","2020-05-24 02:32:43",30.79472531,-94.8276624,52,0,0,52,"Polk, Texas, US",51353,1398,495,641,-146,108,1423,1531,13,4336,12.654479409,-2.882299522,2.1321119754,28.092549453,30.224661429,14706
55095,"Polk","Wisconsin","US","2020-05-24 02:32:43",45.46130348,-92.44182875,15,1,0,14,"Polk, Wisconsin, US",43783,215,402,444,-42,4,255,259,-2,390,10.165882474,-0.961637531,0.0915845268,5.8385135831,5.9300981099,16206
30073,"Pondera","Montana","US","2020-05-24 02:32:43",48.22773388,-112.2252703,2,0,0,2,"Pondera, Montana, US",5911,-49,77,56,21,13,-82,-69,-1,645,9.4347569708,3.538033864,2.1902114396,-13.81517985,-11.62496841,2396
28115,"Pontotoc","Mississippi","US","2020-05-24 02:32:43",34.226046,-89.03636807,26,3,0,23,"Pontotoc, Mississippi, US",32174,293,434,282,152,24,119,143,-2,233,8.8049332605,4.7459214737,0.7493560222,3.7155569433,4.4649129654,10601
40123,"Pontotoc","Oklahoma","US","2020-05-24 02:32:43",34.72959848,-96.68337199,11,2,0,9,"Pontotoc, Oklahoma, US",38284,12,487,509,-22,42,-6,36,-2,1700,13.297455457,-0.574742672,1.0972360102,-0.156748001,0.9404880088,19060
5115,"Pope","Arkansas","US","2020-05-24 02:32:43",35.44871474,-93.03212219,107,1,0,106,"Pope, Arkansas, US",64072,478,765,593,172,11,296,307,-1,3270,9.2898657434,2.6945310419,0.1723246597,4.6370999326,4.8094245923,27966
17151,"Pope","Illinois","US","2020-05-24 02:32:43",37.41391284,-88.56152109,1,0,0,1,"Pope, Illinois, US",4177,-7,25,39,-14,0,7,7,0,272,9.3290276283,-3.348881713,0,1.6744408564,1.6744408564,1063
27121,"Pope","Minnesota","US","2020-05-24 02:32:43",45.58606667,-95.44451209,6,0,0,6,"Pope, Minnesota, US",11249,154,121,122,-1,5,151,156,-1,184,10.920157537,-0.089509488,0.44754744,13.515932689,13.963480129,4573
51735,"Poquoson","Virginia","US","2020-05-24 02:32:43",37.14259351,-76.35798148,7,0,0,7,"Poquoson, Virginia, US",12271,102,107,113,-6,-1,111,110,-2,51,9.2471358429,-0.490998363,-0.081833061,9.0834697218,9.0016366612,2309
39133,"Portage","Ohio","US","2020-05-24 02:32:43",41.16793482,-81.19735782,309,58,0,251,"Portage, Ohio, US",162466,-36,1356,1462,-106,303,-229,74,-4,7442,8.997809015,-0.652371926,1.8647989956,-1.409369538,0.4554294577,60833
55097,"Portage","Wisconsin","US","2020-05-24 02:32:43",44.47558711,-89.50152965,9,0,0,9,"Portage, Wisconsin, US",70772,-78,658,503,155,50,-283,-233,0,3125,7.1034161359,2.1889254494,0.7061049837,-3.996554208,-3.290449224,35839
18127,"Porter","Indiana","US","2020-05-24 02:32:43",41.45986947,-87.06848888,465,21,0,444,"Porter, Indiana, US",170389,901,1618,1635,-17,103,828,931,-13,3420,9.6211276432,-0.10003619,0.6061016191,4.8723508799,5.478452499,62191
51740,"Portsmouth","Virginia","US","2020-05-24 02:32:43",36.85914825,-76.35971629,253,11,0,242,"Portsmouth, Virginia, US",94398,-352,1415,1050,365,90,-796,-706,-11,3078,11.102417155,3.8594116776,0.9516357561,-8.416689576,-7.46505382,53201
18129,"Posey","Indiana","US","2020-05-24 02:32:43",38.02097333,-87.86480429,17,0,0,17,"Posey, Indiana, US",25427,-127,242,261,-19,4,-111,-107,-1,242,10.239108688,-0.745375728,0.1569212059,-4.354563465,-4.197642259,9327
20149,"Pottawatomie","Kansas","US","2020-05-24 02:32:43",39.37925655,-96.34564657,22,0,0,22,"Pottawatomie, Kansas, US",24383,174,347,195,152,6,17,23,-1,299,8.0260125123,6.2561738558,0.2469542311,0.6997036549,0.9466578861,10206
40125,"Pottawatomie","Oklahoma","US","2020-05-24 02:32:43",35.20614018,-96.94923008,56,4,0,52,"Pottawatomie, Oklahoma, US",72592,79,846,841,5,20,58,78,-4,3045,11.591606078,0.0689156128,0.2756624513,0.7994211089,1.0750835602,26074
19155,"Pottawattamie","Iowa","US","2020-05-24 02:32:43",41.33640314,-95.53907776,205,5,0,200,"Pottawattamie, Iowa, US",93206,-58,1110,941,169,-8,-216,-224,-3,2005,10.092776318,1.8126240146,-0.085804687,-2.316726551,-2.402531238,39350
42105,"Potter","Pennsylvania","US","2020-05-24 02:32:43",41.74471626,-77.89559864,4,0,0,4,"Potter, Pennsylvania, US",16526,-97,164,216,-52,2,-46,-44,-1,217,13.032067332,-3.137349543,0.1206672901,-2.775347673,-2.654680383,6568
48375,"Potter","Texas","US","2020-05-24 02:32:43",35.40133773,-101.893964,2229,24,0,2205,"Potter, Texas, US",117415,-1296,1641,1135,506,416,-2221,-1805,3,6627,9.6135114303,4.2858473866,3.5235425154,-18.81199021,-15.28844769,76903
21197,"Powell","Kentucky","US","2020-05-24 02:32:43",37.83218794,-83.82553961,1,0,0,1,"Powell, Kentucky, US",12359,-12,147,154,-7,2,-7,-5,0,188,12.454508694,-0.566114032,0.1617468662,-0.566114032,-0.404367165,2559
16077,"Power","Idaho","US","2020-05-24 02:32:43",42.69254894,-112.8395742,3,0,0,3,"Power, Idaho, US",7681,-19,115,61,54,-1,-73,-74,1,47,7.931863988,7.0216500878,-0.130030557,-9.492230674,-9.622261231,3737
19157,"Poweshiek","Iowa","US","2020-05-24 02:32:43",41.68625425,-92.53155731,88,8,0,80,"Poweshiek, Iowa, US",18504,37,166,198,-32,9,61,70,-1,1620,10.711097888,-1.731086527,0.4868680858,3.2998836926,3.7867517784,10865
51145,"Powhatan","Virginia","US","2020-05-24 02:32:43",37.55016038,-77.91267882,29,0,0,29,"Powhatan, Virginia, US",29652,442,241,236,5,-2,440,438,-1,1119,8.0187557338,0.1698888927,-0.067955557,14.950222554,14.882266997,7145
5117,"Prairie","Arkansas","US","2020-05-24 02:32:43",34.83624419,-91.55162157,2,0,0,2,"Prairie, Arkansas, US",8062,-20,80,116,-36,-2,19,17,-1,131,14.370664024,-4.459861249,-0.247770069,2.3538156591,2.1060455897,2139
20151,"Pratt","Kansas","US","2020-05-24 02:32:43",37.64780729,-98.73922153,1,0,0,1,"Pratt, Kansas, US",9164,-176,95,87,8,4,-189,-185,1,381,9.4033722438,0.8646779075,0.4323389537,-20.42801556,-19.99567661,4957
39135,"Preble","Ohio","US","2020-05-24 02:32:43",39.7420247,-84.64787018,30,1,0,29,"Preble, Ohio, US",40882,-129,441,463,-22,15,-122,-107,0,386,11.307437754,-0.537286459,0.3663316767,-2.979497637,-2.61316596,12395
28117,"Prentiss","Mississippi","US","2020-05-24 02:32:43",34.61810501,-88.51986294,37,3,0,34,"Prentiss, Mississippi, US",25126,38,289,280,9,0,32,32,-3,750,11.152268292,0.3584657665,0,1.2745449476,1.2745449476,7140
26141,"Presque Isle","Michigan","US","2020-05-24 02:32:43",45.34018577,-83.91498656,11,0,0,11,"Presque Isle, Michigan, US",12592,-106,100,181,-81,3,-27,-24,-1,230,14.313958086,-6.40569395,0.2372479241,-2.135231317,-1.897983393,3594
54077,"Preston","West Virginia","US","2020-05-24 02:32:43",39.46770987,-79.66712803,15,0,0,15,"Preston, West Virginia, US",33432,-121,309,364,-55,-11,-52,-63,-3,1823,10.8681048,-1.642158692,-0.328431738,-1.5525864,-1.881018138,8593
55099,"Price","Wisconsin","US","2020-05-24 02:32:43",45.68051754,-90.3609888,2,0,0,2,"Price, Wisconsin, US",13351,-6,119,142,-23,3,16,19,-2,176,10.633518047,-1.722330388,0.2246517897,1.1981428785,1.4227946683,6834
51147,"Prince Edward","Virginia","US","2020-05-24 02:32:43",37.22554789,-78.43597949,108,2,0,106,"Prince Edward, Virginia, US",22802,-104,210,236,-26,19,-96,-77,-1,4055,10.326419883,-1.137656428,0.8313643126,-4.200577579,-3.369213267,10556
51149,"Prince George","Virginia","US","2020-05-24 02:32:43",37.18497668,-77.22922187,60,0,0,60,"Prince George, Virginia, US",38353,360,327,257,70,15,280,295,-5,4055,6.7325072695,1.8337568438,0.3929478951,7.3350273754,7.7279752705,21176
24033,"Prince George's","Maryland","US","2020-05-24 02:32:43",38.83070039,-76.8496441,13324,484,0,12840,"Prince George's, Maryland, US",909327,-292,12008,6852,5156,3991,-9430,-5439,-9,20005,7.5340334457,5.669217228,4.3882556162,-10.36864206,-5.980386444,336033
51153,"Prince William","Virginia","US","2020-05-24 02:32:43",38.70916224,-77.48713689,4408,84,0,4324,"Prince William, Virginia, US",470335,4100,6503,2152,4351,1264,-1529,-265,14,2771,4.5954920615,9.2913503529,2.6992109506,-3.265105651,-0.565894701,137413
2198,"Prince of Wales-Hyder","Alaska","US","2020-05-24 02:32:43",55.76261984,-133.0511621,2,0,0,2,"Prince of Wales-Hyder, Alaska, US",6203,-157,59,53,6,2,-166,-164,1,50,8.4374751254,0.9551858632,0.3183952877,-26.42680888,-26.1084136,2659
44007,"Providence","Rhode Island","US","2020-05-24 02:32:43",41.87064746,-71.57753536,10519,0,0,10519,"Providence, Rhode Island, US",638931,1978,7062,5548,1514,3220,-2744,476,-12,26378,8.6967153754,2.3732565029,5.0474808055,-4.301331469,0.7461493365,296336
8099,"Prowers","Colorado","US","2020-05-24 02:32:43",37.95544985,-102.3926052,12,0,0,12,"Prowers, Colorado, US",12172,93,158,115,43,17,34,51,-1,315,9.4841449837,3.5462455156,1.4020040411,2.8040080821,4.2060121232,5405
8101,"Pueblo","Colorado","US","2020-05-24 02:32:43",38.17359144,-104.5127437,260,14,0,246,"Pueblo, Colorado, US",168424,1002,1808,1834,-26,65,968,1033,-5,4457,10.921672433,-0.15483287,0.3870821746,5.7645468459,6.1516290204,62455
5119,"Pulaski","Arkansas","US","2020-05-24 02:32:43",34.77054088,-92.31355101,773,29,0,744,"Pulaski, Arkansas, US",391911,-7,5067,3795,1272,153,-1415,-1262,-17,8661,9.683234481,3.2456058656,0.3903912716,-3.610481368,-3.220090096,246603
13235,"Pulaski","Georgia","US","2020-05-24 02:32:43",32.23334561,-83.4754996,39,2,0,37,"Pulaski, Georgia, US",11137,57,92,114,-22,-2,79,77,2,1240,10.262411667,-1.980465409,-0.18004231,7.1116712427,6.9316289328,3886
17153,"Pulaski","Illinois","US","2020-05-24 02:32:43",37.22631423,-89.13085001,40,0,0,40,"Pulaski, Illinois, US",5335,-99,56,75,-19,2,-82,-80,0,21,13.928869904,-3.528647042,0.3714365308,-15.22889776,-14.85746123,2315
18131,"Pulaski","Indiana","US","2020-05-24 02:32:43",41.04166107,-86.69890683,38,0,0,38,"Pulaski, Indiana, US",12353,-139,122,135,-13,14,-141,-127,1,193,10.867377742,-1.046488227,1.1269873214,-11.35037231,-10.22338499,5122
21199,"Pulaski","Kentucky","US","2020-05-24 02:32:43",37.10466131,-84.57629079,55,2,0,53,"Pulaski, Kentucky, US",64979,395,755,791,-36,-2,434,432,-1,962,12.210276082,-0.555714209,-0.030873012,6.699443514,6.6685705024,27112
29169,"Pulaski","Missouri","US","2020-05-24 02:32:43",37.82462075,-92.20783203,33,1,0,32,"Pulaski, Missouri, US",52607,610,676,297,379,48,183,231,0,9982,5.6785591373,7.2463768116,0.9177469313,3.4989101755,4.4166571068,32279
51155,"Pulaski","Virginia","US","2020-05-24 02:32:43",37.06474963,-80.71229738,10,0,0,10,"Pulaski, Virginia, US",34027,-33,308,452,-144,-3,115,112,-1,1089,13.27713073,-4.229882356,-0.088122549,3.3780310485,3.2899084994,15104
40127,"Pushmataha","Oklahoma","US","2020-05-24 02:32:43",34.41635232,-95.37603505,2,0,0,2,"Pushmataha, Oklahoma, US",11096,-96,110,144,-34,5,-66,-61,-1,110,12.921751615,-3.050969131,0.4486719311,-5.92246949,-5.473797559,3123
12107,"Putnam","Florida","US","2020-05-24 02:32:43",29.60779729,-81.74230285,139,4,0,135,"Putnam, Florida, US",74521,478,826,1033,-207,-24,705,681,4,1422,13.906464554,-2.786677795,-0.323093078,9.4908591583,9.1677660806,19912
13237,"Putnam","Georgia","US","2020-05-24 02:32:43",33.32056115,-83.37552891,85,8,0,77,"Putnam, Georgia, US",22119,299,212,276,-64,3,357,360,3,157,12.562871253,-2.913129566,0.1365529484,16.24980086,16.386353809,6757
17155,"Putnam","Illinois","US","2020-05-24 02:32:43",41.2013541,-89.2869272,1,0,0,1,"Putnam, Illinois, US",5739,3,47,55,-8,0,12,12,-1,2,9.5860566449,-1.394335512,0,2.091503268,2.091503268,1892
18133,"Putnam","Indiana","US","2020-05-24 02:32:43",39.66437981,-86.84517605,129,7,0,122,"Putnam, Indiana, US",37576,90,356,344,12,40,38,78,0,4824,9.1657563081,0.3197356852,1.0657856172,1.0124963364,2.0782819536,13717
36079,"Putnam","New York","US","2020-05-24 02:32:43",41.42630093,-73.74965532,1200,58,0,1142,"Putnam, New York, US",98320,-494,800,784,16,67,-579,-512,2,2583,7.9539805412,0.1623261335,0.679740684,-5.874176956,-5.194436272,27666
39137,"Putnam","Ohio","US","2020-05-24 02:32:43",41.02094889,-84.1336111,85,14,0,71,"Putnam, Ohio, US",33861,59,428,317,111,7,-58,-51,-1,303,9.3699658602,3.2809659637,0.2069077635,-1.714378612,-1.507470848,11738
47141,"Putnam","Tennessee","US","2020-05-24 02:32:43",36.14005459,-85.50646123,359,5,0,354,"Putnam, Tennessee, US",80245,1614,879,781,98,207,1305,1512,4,2568,9.8315667565,1.2336665072,2.6058057856,16.42790604,19.033711826,35862
54079,"Putnam","West Virginia","US","2020-05-24 02:32:43",38.50782345,-81.9082131,31,0,0,31,"Putnam, West Virginia, US",56450,-192,504,596,-92,0,-98,-98,-2,249,10.540091253,-1.626993952,0,-1.733102253,-1.733102253,21169
35037,"Quay","New Mexico","US","2020-05-24 02:32:43",35.10403332,-103.5481727,5,1,0,4,"Quay, New Mexico, US",8253,11,90,95,-5,16,2,18,-2,22,11.518642013,-0.606244316,1.9399818127,0.2424977266,2.1824795393,2878
24035,"Queen Anne's","Maryland","US","2020-05-24 02:32:43",39.06198912,-76.03530977,146,12,0,134,"Queen Anne's, Maryland, US",50381,233,497,427,70,23,143,166,-3,436,8.4950611266,1.3926329716,0.4575794049,2.8449502134,3.3025296183,15851
13239,"Quitman","Georgia","US","2020-05-24 02:32:43",31.86728114,-85.01773177,11,1,0,10,"Quitman, Georgia, US",2299,39,16,24,-8,0,46,46,1,0,10.528624698,-3.509541566,0,20.179864005,20.179864005,386
28119,"Quitman","Mississippi","US","2020-05-24 02:32:43",34.25157572,-90.28908,23,0,0,23,"Quitman, Mississippi, US",6792,-263,80,110,-30,3,-236,-233,0,136,15.887917961,-4.333068535,0.4333068535,-34.08680581,-33.65349895,1353
13241,"Rabun","Georgia","US","2020-05-24 02:32:43",34.88389445,-83.40304637,15,1,0,14,"Rabun, Georgia, US",17137,280,144,212,-68,0,347,347,1,448,12.472789316,-4.000706007,0,20.415367418,20.415367418,6325
55101,"Racine","Wisconsin","US","2020-05-24 02:32:43",42.74753117,-88.05941254,1311,22,0,1289,"Racine, Wisconsin, US",196311,-46,2257,1664,593,-4,-633,-637,-2,4994,8.4753532246,3.0203632585,-0.020373445,-3.224097711,-3.244471156,77754
51750,"Radford","Virginia","US","2020-05-24 02:32:43",37.12222899,-80.5602732,4,0,0,4,"Radford, Virginia, US",18249,148,144,97,47,11,91,102,-1,3469,5.3370013755,2.5859697387,0.6052269601,5.0068775791,5.6121045392,6707
48379,"Rains","Texas","US","2020-05-24 02:32:43",32.87109387,-95.79232691,3,0,0,3,"Rains, Texas, US",12514,367,143,138,5,5,354,359,3,63,11.191760269,0.4054985605,0.4054985605,28.709298082,29.114796642,2481
54081,"Raleigh","West Virginia","US","2020-05-24 02:32:43",37.76936795,-81.2456041,14,0,0,14,"Raleigh, West Virginia, US",73361,-811,723,1052,-329,-5,-473,-478,-4,3660,14.261216135,-4.460019114,-0.067781446,-6.412124745,-6.47990619,31359
29173,"Ralls","Missouri","US","2020-05-24 02:32:43",39.52817427,-91.51838643,2,0,0,2,"Ralls, Missouri, US",10309,75,101,76,25,0,49,49,1,54,7.3991140534,2.4339190965,0,4.7704814292,4.7704814292,3193
27123,"Ramsey","Minnesota","US","2020-05-24 02:32:43",45.01625271,-93.09872295,2164,94,0,2070,"Ramsey, Minnesota, US",550321,1449,7591,4234,3357,1880,-3770,-1890,-18,17450,7.7038336307,6.1081175007,3.4206913618,-6.85957789,-3.438886529,323611
38071,"Ramsey","North Dakota","US","2020-05-24 02:32:43",48.26886249,-98.72223879,9,1,0,8,"Ramsey, North Dakota, US",11519,-61,174,130,44,19,-123,-104,-1,452,11.255898524,3.8096887311,1.6450928612,-10.64981168,-9.004718819,6386
48381,"Randall","Texas","US","2020-05-24 02:32:43",34.96585996,-101.8971322,645,5,0,640,"Randall, Texas, US",137713,2022,1587,1102,485,66,1474,1540,-3,2295,8.0613304853,3.5478632354,0.4828020073,10.782578163,11.26538017,38493
1111,"Randolph","Alabama","US","2020-05-24 02:32:43",33.29526734,-85.45708831,124,7,0,117,"Randolph, Alabama, US",22722,-5,254,285,-31,-6,33,27,-1,390,12.541530067,-1.364166428,-0.264032212,1.4521771656,1.1881449537,5630
5121,"Randolph","Arkansas","US","2020-05-24 02:32:43",36.3415714,-91.02455531,26,0,0,26,"Randolph, Arkansas, US",17958,-12,235,255,-20,-6,13,7,1,349,14.19505678,-1.113337787,-0.334001336,0.7236695613,0.3896682253,5314
13243,"Randolph","Georgia","US","2020-05-24 02:32:43",31.76622818,-84.75732369,170,19,0,151,"Randolph, Georgia, US",6778,-34,63,71,-8,-1,-25,-26,0,350,10.448859455,-1.177336277,-0.147167035,-3.679175865,-3.826342899,2424
17157,"Randolph","Illinois","US","2020-05-24 02:32:43",38.05095369,-89.82512254,256,3,0,253,"Randolph, Illinois, US",31782,-395,320,379,-59,8,-344,-336,0,4315,11.851342266,-1.84493191,0.2501602589,-10.75689113,-10.50673087,14138
18135,"Randolph","Indiana","US","2020-05-24 02:32:43",40.15734772,-85.01139319,37,3,0,34,"Randolph, Indiana, US",24665,-141,283,269,14,10,-165,-155,0,329,10.875058115,0.5659881547,0.4042772533,-6.67057468,-6.266297427,8146
29175,"Randolph","Missouri","US","2020-05-24 02:32:43",39.44007257,-92.4971374,8,0,0,8,"Randolph, Missouri, US",24748,16,292,239,53,5,-42,-37,0,2256,9.6604688763,2.142279709,0.2021018593,-1.697655618,-1.495553759,9572
37151,"Randolph","North Carolina","US","2020-05-24 02:32:43",35.71015088,-79.80570339,549,8,0,541,"Randolph, North Carolina, US",143667,418,1538,1573,-35,48,414,462,-9,1257,10.964881708,-0.243973846,0.3345927031,2.8858620642,3.2204547672,46842
54083,"Randolph","West Virginia","US","2020-05-24 02:32:43",38.769899,-79.87919615,28,0,0,28,"Randolph, West Virginia, US",28695,-119,319,385,-66,-2,-49,-51,-2,2298,13.389208646,-2.295292911,-0.069554331,-1.7040811,-1.773635431,12275
28121,"Rankin","Mississippi","US","2020-05-24 02:32:43",32.26469147,-89.94537876,336,6,0,330,"Rankin, Mississippi, US",155271,1021,1696,1261,435,92,498,590,-4,6250,8.1480739594,2.8107947441,0.5944669344,3.2178753623,3.8123422966,59809
38073,"Ransom","North Dakota","US","2020-05-24 02:32:43",46.45621782,-97.65742504,8,0,0,8,"Ransom, North Dakota, US",5218,-6,49,73,-24,1,17,18,0,155,13.981995786,-4.596820532,0.1915341889,3.2560812105,3.4476153993,2783
22079,"Rapides","Louisiana","US","2020-05-24 02:32:43",31.19778499,-92.52997303,600,16,0,584,"Rapides, Louisiana, US",129648,-678,1636,1433,203,16,-900,-884,3,4502,11.024179341,1.561694631,0.123089232,-6.9237693,-6.800680068,56691
51157,"Rappahannock","Virginia","US","2020-05-24 02:32:43",38.68295619,-78.15826963,12,0,0,12,"Rappahannock, Virginia, US",7370,25,52,71,-19,3,41,44,0,35,9.6500169895,-2.582398913,0.4077471967,5.5725450221,5.9802922188,2359
30081,"Ravalli","Montana","US","2020-05-24 02:32:43",46.08520862,-114.1189164,13,0,0,13,"Ravalli, Montana, US",43806,640,370,484,-114,-17,770,753,1,479,11.130018857,-2.621533367,-0.390930414,17.706848181,17.315917767,13246
29177,"Ray","Missouri","US","2020-05-24 02:32:43",39.3537468,-93.98905745,15,0,0,15,"Ray, Missouri, US",23018,73,262,279,-17,-4,93,89,1,311,12.140199726,-0.739725431,-0.174053043,4.046733242,3.8726801993,4694
27125,"Red Lake","Minnesota","US","2020-05-24 02:32:43",47.87197525,-96.09561104,3,0,0,3,"Red Lake, Minnesota, US",4055,63,42,29,13,1,48,49,1,34,7.2076550267,3.2310177706,0.2485398285,11.929911768,12.178451597,1369
22081,"Red River","Louisiana","US","2020-05-24 02:32:43",32.09530039,-93.34213308,46,6,0,40,"Red River, Louisiana, US",8442,-84,114,127,-13,9,-79,-70,-1,164,14.969354078,-1.532296087,1.0608203678,-9.31164545,-8.250825083,2617
48387,"Red River","Texas","US","2020-05-24 02:32:43",33.61886692,-95.04841765,42,4,0,38,"Red River, Texas, US",12023,-120,120,178,-58,-4,-55,-59,-3,159,14.731440867,-4.800132417,-0.331043615,-4.551849706,-4.882893321,2724
31145,"Red Willow","Nebraska","US","2020-05-24 02:32:43",40.1755688,-100.476998,5,0,0,5,"Red Willow, Nebraska, US",10724,19,135,123,12,7,1,8,-1,415,11.479770405,1.1199776004,0.6533202669,0.0933314667,0.7466517336,6095
27127,"Redwood","Minnesota","US","2020-05-24 02:32:43",44.40555844,-95.25207021,3,0,0,3,"Redwood, Minnesota, US",15170,-82,192,159,33,4,-118,-114,-1,373,10.452961672,2.1694826113,0.2629675892,-7.757543883,-7.494576293,7424
48389,"Reeves","Texas","US","2020-05-24 02:32:43",31.32323325,-103.6903896,7,0,0,7,"Reeves, Texas, US",15976,463,186,106,80,51,330,381,2,3136,6.7325097653,5.0811394455,3.2392263965,20.959700213,24.198926609,6668
48391,"Refugio","Texas","US","2020-05-24 02:32:43",28.3238976,-97.15766311,3,0,0,3,"Refugio, Texas, US",6948,-52,66,51,15,1,-67,-66,-1,129,7.312876398,2.1508459994,0.1433897333,-9.607112131,-9.463722397,2662
20155,"Reno","Kansas","US","2020-05-24 02:32:43",37.95230263,-98.08607292,43,0,0,43,"Reno, Kansas, US",61998,-333,670,699,-29,38,-340,-302,-2,3111,11.244359723,-0.466504195,0.6112813583,-5.469359522,-4.858078164,28502
36083,"Rensselaer","New York","US","2020-05-24 02:32:43",42.71348136,-73.51089874,463,28,0,435,"Rensselaer, New York, US",158714,-569,1548,1610,-62,126,-632,-506,-1,5894,10.125881691,-0.389940786,0.7924603062,-3.974880266,-3.18241996,57913
27129,"Renville","Minnesota","US","2020-05-24 02:32:43",44.72836381,-94.94553734,5,0,0,5,"Renville, Minnesota, US",14548,-61,188,167,21,8,-90,-82,0,342,11.45522516,1.4404774154,0.5487533011,-6.173474637,-5.624721336,6565
38075,"Renville","North Dakota","US","2020-05-24 02:32:43",48.71982533,-101.6603912,1,0,0,1,"Renville, North Dakota, US",2327,-31,17,26,-9,0,-22,-22,0,54,11.099252935,-3.842049093,0,-9.39167556,-9.39167556,1131
20157,"Republic","Kansas","US","2020-05-24 02:32:43",39.82799632,-97.65036709,4,0,0,4,"Republic, Kansas, US",4636,-16,59,61,-2,5,-18,-13,-1,103,13.135228252,-0.430663221,1.0766580534,-3.875968992,-2.799310939,2261
29179,"Reynolds","Missouri","US","2020-05-24 02:32:43",37.36085952,-90.97009925,2,0,0,2,"Reynolds, Missouri, US",6270,-12,64,91,-27,0,17,17,-2,101,14.499681326,-4.30210325,0,2.7087316762,2.7087316762,2837
47143,"Rhea","Tennessee","US","2020-05-24 02:32:43",35.60536161,-84.93076643,194,0,0,194,"Rhea, Tennessee, US",33167,256,388,405,-17,9,263,272,1,830,12.258240262,-0.514543418,0.2724053391,7.960289355,8.2326946941,14754
20159,"Rice","Kansas","US","2020-05-24 02:32:43",38.34616184,-98.19992118,4,0,0,4,"Rice, Kansas, US",9537,54,103,94,9,7,40,47,-2,651,9.8843322818,0.9463722397,0.7360672976,4.2060988433,4.9421661409,4340
27131,"Rice","Minnesota","US","2020-05-24 02:32:43",44.3543376,-93.29658715,352,2,0,350,"Rice, Minnesota, US",66972,406,743,490,253,181,-25,156,-3,7305,7.3387350417,3.7891836032,2.7108388623,-0.374425257,2.3364136051,29219
31147,"Richardson","Nebraska","US","2020-05-24 02:32:43",40.1247415,-95.71755036,1,0,0,1,"Richardson, Nebraska, US",7865,-73,90,118,-28,1,-46,-45,0,144,14.933873315,-3.543630956,0.1265582484,-5.821679428,-5.69512118,3044
17159,"Richland","Illinois","US","2020-05-24 02:32:43",38.71240969,-88.08475366,3,0,0,3,"Richland, Illinois, US",15513,-182,162,187,-25,1,-157,-156,-1,364,11.984106639,-1.602153294,0.0640861318,-10.06152269,-9.997436555,6985
22083,"Richland","Louisiana","US","2020-05-24 02:32:43",32.41391005,-91.76634876,114,2,0,112,"Richland, Louisiana, US",20122,-101,249,245,4,-1,-103,-104,-1,1037,12.145247243,0.1982897509,-0.049572438,-5.105961086,-5.155533523,7361
30083,"Richland","Montana","US","2020-05-24 02:32:43",47.78668011,-104.5610786,3,0,0,3,"Richland, Montana, US",10803,-52,125,81,44,-16,-78,-94,-2,34,7.4799150429,4.063163727,-1.477514083,-7.202881152,-8.680395235,6177
38077,"Richland","North Dakota","US","2020-05-24 02:32:43",46.26440649,-96.94852979,15,0,0,15,"Richland, North Dakota, US",16177,-52,190,126,64,-7,-109,-116,0,885,7.7763377152,3.9498858236,-0.432018762,-6.727149293,-7.159168055,8615
39139,"Richland","Ohio","US","2020-05-24 02:32:43",40.77180308,-82.5379961,179,3,0,176,"Richland, Ohio, US",121154,167,1319,1397,-78,11,240,251,-6,7381,11.538731565,-0.644252729,0.0908561541,1.9823160886,2.0731722426,51520
45079,"Richland","South Carolina","US","2020-05-24 02:32:43",34.01791263,-80.90267209,1349,63,0,1286,"Richland, South Carolina, US",415759,1557,4631,3232,1399,990,-833,157,1,29322,7.7883177643,3.3712427451,2.3856542657,-2.007323236,0.37833103,228526
55103,"Richland","Wisconsin","US","2020-05-24 02:32:43",43.3762778,-90.43012729,14,4,0,10,"Richland, Wisconsin, US",17252,-145,164,187,-23,15,-138,-123,1,284,10.793962308,-1.327599642,0.8658258536,-7.965597853,-7.099771999,6869
13245,"Richmond","Georgia","US","2020-05-24 02:32:43",33.35777107,-82.07026432,525,18,0,507,"Richmond, Georgia, US",202518,851,2893,2040,853,82,-76,6,-8,12933,10.094387471,4.2208394671,0.4057547905,-0.376065416,0.0296893749,121517
37153,"Richmond","North Carolina","US","2020-05-24 02:32:43",35.00417719,-79.74491009,145,2,0,143,"Richmond, North Carolina, US",44829,-59,559,556,3,3,-64,-61,-1,1103,12.394529465,0.0668769575,0.0668769575,-1.426708428,-1.35983147,14353
51159,"Richmond","Virginia","US","2020-05-24 02:32:43",37.937575,-76.72920628,276,4,0,272,"Richmond, Virginia, US",9023,53,71,105,-34,4,83,87,0,1664,11.671205469,-3.779247485,0.4446173512,9.2258100372,9.6704273884,3231
51760,"Richmond City","Virginia","US","2020-05-24 02:32:43",37.53255773,-77.47966921,979,19,0,960,"Richmond City, Virginia, US",230436,1215,3037,2046,991,374,-143,231,-7,12519,8.9022901859,4.3119108379,1.6273003566,-0.622203078,1.0050972791,170933
20161,"Riley","Kansas","US","2020-05-24 02:32:43",39.28935726,-96.73420026,61,1,0,60,"Riley, Kansas, US",74232,-480,854,360,494,416,-1398,-982,8,10660,4.8340315823,6.6333655602,5.5859920507,-18.77215598,-13.18616393,37947
19159,"Ringgold","Iowa","US","2020-05-24 02:32:43",40.73518949,-94.24368535,2,0,0,2,"Ringgold, Iowa, US",4894,-46,52,63,-11,1,-36,-35,0,175,12.812690665,-2.237136465,0.2033760423,-7.321537523,-7.118161481,1756
35039,"Rio Arriba","New Mexico","US","2020-05-24 02:32:43",36.51072137,-106.6931674,36,0,0,36,"Rio Arriba, New Mexico, US",38921,-102,417,459,-42,30,-88,-58,-2,425,11.777686544,-1.077696808,0.7697834343,-2.258031407,-1.488247973,11731
8103,"Rio Blanco","Colorado","US","2020-05-24 02:32:43",39.97913541,-108.2179009,1,0,0,1,"Rio Blanco, Colorado, US",6324,-6,62,43,19,11,-37,-26,1,263,6.7962699542,3.003003003,1.7385806859,-5.847953216,-4.10937253,3647
8105,"Rio Grande","Colorado","US","2020-05-24 02:32:43",37.5836865,-106.3847838,16,0,0,16,"Rio Grande, Colorado, US",11267,-4,115,113,2,12,-17,-5,-1,198,10.027509096,0.1774780371,1.0648682226,-1.508563315,-0.443695093,4135
18137,"Ripley","Indiana","US","2020-05-24 02:32:43",39.10235626,-85.26212744,112,6,0,106,"Ripley, Indiana, US",28324,-126,343,300,43,9,-179,-170,1,449,10.568217846,1.5147778913,0.3170465354,-6.305703315,-5.98865678,11187
29181,"Ripley","Missouri","US","2020-05-24 02:32:43",36.65460667,-90.85990261,7,0,0,7,"Ripley, Missouri, US",13288,-132,137,204,-67,-2,-65,-67,2,63,15.276321701,-5.017223304,-0.14976786,-4.867455444,-5.017223304,3429
54085,"Ritchie","West Virginia","US","2020-05-24 02:32:43",39.18094587,-81.06356878,1,0,0,1,"Ritchie, West Virginia, US",9554,-194,82,156,-74,1,-120,-119,-1,106,16.16412807,-7.667599213,0.1036162056,-12.43394467,-12.33032846,3925
6065,"Riverside","California","US","2020-05-24 02:32:43",33.74314981,-115.9933578,6464,290,0,6174,"Riverside, California, US",2470546,24757,29482,18148,11334,303,13170,13473,-50,32869,7.3827353099,4.6107517083,0.1232625523,5.3576495499,5.4809121022,727578
47145,"Roane","Tennessee","US","2020-05-24 02:32:43",35.84923189,-84.52458689,13,0,0,13,"Roane, Tennessee, US",53382,124,473,725,-252,-13,390,377,-1,810,13.597149287,-4.726181545,-0.243810953,7.3143285821,7.0705176294,15777
54087,"Roane","West Virginia","US","2020-05-24 02:32:43",38.71622686,-81.35243568,8,0,0,8,"Roane, West Virginia, US",13688,-230,119,186,-67,0,-163,-163,0,98,13.47533145,-4.854017243,0,-11.80902702,-11.80902702,3213
51161,"Roanoke","Virginia","US","2020-05-24 02:32:43",37.26865804,-80.06396753,90,5,0,85,"Roanoke, Virginia, US",94186,100,697,1059,-362,115,354,469,-7,2346,11.249681312,-3.845500127,1.2216367808,3.7605166992,4.9821534801,36113
51770,"Roanoke City","Virginia","US","2020-05-24 02:32:43",37.27791025,-79.96189766,141,9,0,132,"Roanoke City, Virginia, US",99143,134,1319,1218,101,235,-195,40,-7,2100,12.293592797,1.0194194356,2.3719165085,-1.968186039,0.4037304695,71149
46109,"Roberts","South Dakota","US","2020-05-24 02:32:43",45.62975048,-96.94672673,23,0,0,23,"Roberts, South Dakota, US",10394,18,167,111,56,2,-37,-35,-3,281,10.688493019,5.3923928743,0.1925854598,-3.562831006,-3.370245546,3994
48393,"Roberts","Texas","US","2020-05-24 02:32:43",35.83809685,-100.813175,2,0,0,2,"Roberts, Texas, US",854,-44,8,9,-1,0,-45,-45,2,0,10.273972603,-1.141552511,0,-51.36986301,-51.36986301,237
47147,"Robertson","Tennessee","US","2020-05-24 02:32:43",36.52454807,-86.87346725,360,0,0,360,"Robertson, Tennessee, US",71813,634,869,664,205,46,383,429,0,969,9.2872328522,2.8672932751,0.6433926374,5.3569430458,6.0003356831,21042
48395,"Robertson","Texas","US","2020-05-24 02:32:43",31.02539637,-96.51272246,7,0,0,7,"Robertson, Texas, US",17074,-145,211,170,41,12,-198,-186,0,182,9.9145598227,2.3911585455,0.6998512816,-11.54754615,-10.84769486,5275
37155,"Robeson","North Carolina","US","2020-05-24 02:32:43",34.64244496,-79.1025053,646,12,0,634,"Robeson, North Carolina, US",130625,-1259,1697,1378,319,58,-1636,-1578,0,4350,10.498687664,2.4303928627,0.4418896114,-12.46433456,-12.02244494,42683
27133,"Rock","Minnesota","US","2020-05-24 02:32:43",43.67482683,-96.25296832,20,0,0,20,"Rock, Minnesota, US",9315,-86,104,94,10,-5,-91,-96,0,260,10.044881385,1.0686044027,-0.534302201,-9.724300064,-10.25860227,3910
55105,"Rock","Wisconsin","US","2020-05-24 02:32:43",42.67151616,-89.071479,529,16,0,513,"Rock, Wisconsin, US",163354,480,1877,1471,406,39,42,81,-7,2695,9.0182326471,2.4890567333,0.2390965828,0.2574886276,0.4965852103,62780
17161,"Rock Island","Illinois","US","2020-05-24 02:32:43",41.46613806,-90.57042164,627,22,0,605,"Rock Island, Illinois, US",141879,-742,1661,1543,118,298,-1158,-860,0,4587,10.847100176,0.8295254833,2.0949033392,-8.14059754,-6.0456942,79219
51163,"Rockbridge","Virginia","US","2020-05-24 02:32:43",37.81204314,-79.44605905,14,0,0,14,"Rockbridge, Virginia, US",22573,-188,122,255,-133,3,-54,-51,-4,502,11.249834561,-5.867560771,0.1323509948,-2.382317907,-2.249966912,6738
21203,"Rockcastle","Kentucky","US","2020-05-24 02:32:43",37.36642393,-84.31176452,13,0,0,13,"Rockcastle, Kentucky, US",16695,-128,164,243,-79,0,-48,-48,-1,341,14.499671818,-4.713885077,0,-2.864132705,-2.864132705,4164
13247,"Rockdale","Georgia","US","2020-05-24 02:32:43",33.65145002,-84.02202167,258,9,0,249,"Rockdale, Georgia, US",90896,391,971,750,221,38,136,174,-4,766,8.2689731589,2.4365907575,0.4189613067,1.4994404661,1.9184017729,37131
33015,"Rockingham","New Hampshire","US","2020-05-24 02:32:43",42.98499744,-71.12883377,1218,62,0,1156,"Rockingham, New Hampshire, US",309769,1482,2663,2519,144,181,1173,1354,-16,2311,8.1513649249,0.465977193,0.585707444,3.7957725514,4.3814799953,147052
37157,"Rockingham","North Carolina","US","2020-05-24 02:32:43",36.39593137,-79.77504841,65,2,0,63,"Rockingham, North Carolina, US",91010,393,871,1174,-303,2,696,698,-2,1005,12.927593364,-3.336508339,0.0220231573,7.6640587578,7.6860819151,30009
51165,"Rockingham","Virginia","US","2020-05-24 02:32:43",38.51006137,-78.87260325,452,6,0,446,"Rockingham, Virginia, US",81948,687,855,772,83,38,568,606,-2,1636,9.4602626081,1.0171007726,0.4656605947,6.9604004681,7.4260610628,34351
36087,"Rockland","New York","US","2020-05-24 02:32:43",41.15027894,-74.02560498,12934,618,0,12316,"Rockland, New York, US",325789,267,5370,2457,2913,504,-3177,-2673,27,6547,7.5447827536,8.9450354746,1.5476477443,-9.755708103,-8.208060358,115103
48397,"Rockwall","Texas","US","2020-05-24 02:32:43",32.89779518,-96.40771592,147,9,0,138,"Rockwall, Texas, US",104915,4369,1067,639,428,64,3871,3935,6,725,6.2201585702,4.1662407951,0.6229892778,37.681117098,38.304106375,30066
40131,"Rogers","Oklahoma","US","2020-05-24 02:32:43",36.37004357,-95.60406759,78,5,0,73,"Rogers, Oklahoma, US",92459,658,1004,898,106,34,524,558,-6,1216,9.7470964941,1.1505481385,0.3690437425,5.6876153262,6.0566590687,29199
38079,"Rolette","North Dakota","US","2020-05-24 02:32:43",48.77245354,-99.84097493,4,0,0,4,"Rolette, North Dakota, US",14176,-173,226,187,39,0,-213,-213,1,121,13.111305872,2.7344434706,0,-14.93426819,-14.93426819,4626
20163,"Rooks","Kansas","US","2020-05-24 02:32:43",39.35022773,-99.32484567,6,0,0,6,"Rooks, Kansas, US",4920,-75,49,70,-21,0,-55,-55,1,72,14.120020171,-4.236006051,0,-11.09430156,-11.09430156,2542
30085,"Roosevelt","Montana","US","2020-05-24 02:32:43",48.29607488,-105.0079268,7,0,0,7,"Roosevelt, Montana, US",11004,-65,205,170,35,6,-107,-101,1,186,15.40343406,3.1712952476,0.5436506139,-9.695102614,-9.151452,4038
35041,"Roosevelt","New Mexico","US","2020-05-24 02:32:43",34.02097406,-103.4799493,31,0,0,31,"Roosevelt, New Mexico, US",18500,-259,253,145,108,34,-403,-369,2,1078,7.7833543573,5.7972570386,1.825062401,-21.63235728,-19.80729488,6964
26143,"Roscommon","Michigan","US","2020-05-24 02:32:43",44.33473082,-84.61067651,21,0,0,21,"Roscommon, Michigan, US",24019,207,161,376,-215,2,419,421,1,277,15.722021283,-8.989985574,0.0836277728,17.520018398,17.603646171,7242
27135,"Roseau","Minnesota","US","2020-05-24 02:32:43",48.77501878,-95.81079919,1,0,0,1,"Roseau, Minnesota, US",15165,7,168,123,45,6,-44,-38,0,191,8.1126537612,2.968044059,0.3957392079,-2.902087524,-2.506348316,8949
39141,"Ross","Ohio","US","2020-05-24 02:32:43",39.33705391,-83.06000914,62,2,0,60,"Ross, Ohio, US",76666,-218,844,849,-5,9,-220,-211,-2,5351,11.058287203,-0.065125366,0.1172256594,-2.865516119,-2.748290459,29346
8107,"Routt","Colorado","US","2020-05-24 02:32:43",40.48596505,-106.9905548,59,6,0,53,"Routt, Colorado, US",25638,131,207,133,74,43,14,57,0,323,5.2008994037,2.8937335028,1.6814937922,0.5474630951,2.2289568873,14633
21205,"Rowan","Kentucky","US","2020-05-24 02:32:43",38.19484205,-83.42088935,7,0,0,7,"Rowan, Kentucky, US",24460,-43,268,215,53,-5,-91,-96,0,3001,8.7821416171,2.1649000266,-0.204235852,-3.717092498,-3.92132835,11695
37159,"Rowan","North Carolina","US","2020-05-24 02:32:43",35.64003916,-80.52446628,603,27,0,576,"Rowan, North Carolina, US",142088,960,1575,1570,5,51,906,957,-2,4361,11.08694424,0.0353087396,0.3601491441,6.397943619,6.7580927631,49428
48399,"Runnels","Texas","US","2020-05-24 02:32:43",31.8314342,-99.97616148,2,0,0,2,"Runnels, Texas, US",10264,86,106,123,-17,8,98,106,-3,184,12.034047549,-1.663242344,0.7827022796,9.5881029253,10.370805205,3678
18139,"Rush","Indiana","US","2020-05-24 02:32:43",39.62002287,-85.4655599,45,2,0,43,"Rush, Indiana, US",16581,-54,183,184,-1,7,-59,-52,-1,178,11.078998073,-0.060211946,0.4214836224,-3.552504817,-3.131021195,5263
48401,"Rusk","Texas","US","2020-05-24 02:32:43",32.10773545,-94.76176432,42,2,0,40,"Rusk, Texas, US",54406,105,562,557,5,-13,117,104,-4,6213,10.247730137,0.0919903962,-0.23917503,2.1525752711,1.913400241,16139
55107,"Rusk","Wisconsin","US","2020-05-24 02:32:43",45.47498854,-91.1333012,4,0,0,4,"Rusk, Wisconsin, US",14178,68,139,163,-24,12,82,94,-2,173,11.524321267,-1.696832579,0.8484162896,5.7975113122,6.6459276018,6236
1113,"Russell","Alabama","US","2020-05-24 02:32:43",32.28725256,-85.18415324,125,0,0,125,"Russell, Alabama, US",57961,177,810,608,202,-49,26,-23,-2,574,10.505853385,3.4904315521,-0.846688842,0.4492634671,-0.397425375,13947
21207,"Russell","Kentucky","US","2020-05-24 02:32:43",36.99308373,-85.06070117,22,4,0,18,"Russell, Kentucky, US",17923,133,203,224,-21,7,149,156,-2,177,12.5444516,-1.176042338,0.3920141125,8.3443003948,8.7363145073,6255
51167,"Russell","Virginia","US","2020-05-24 02:32:43",36.9302832,-82.10095486,8,0,0,8,"Russell, Virginia, US",26586,-209,229,357,-128,0,-79,-79,-2,432,13.375545606,-4.795713831,0,-2.95985463,-2.95985463,7746
37161,"Rutherford","North Carolina","US","2020-05-24 02:32:43",35.40114178,-81.92112099,161,7,0,154,"Rutherford, North Carolina, US",67029,254,662,862,-200,-6,461,455,-1,1206,12.884517653,-2.989447251,-0.089683418,6.890675914,6.8009924965,20628
47149,"Rutherford","Tennessee","US","2020-05-24 02:32:43",35.84591405,-86.4107263,977,22,0,955,"Rutherford, Tennessee, US",332285,7638,4109,2071,2038,551,5039,5590,10,5131,6.3050665822,6.2045995628,1.6774947788,15.34100942,17.018504198,123980
50021,"Rutland","Vermont","US","2020-05-24 02:32:43",43.57723578,-73.03741676,51,1,0,50,"Rutland, Vermont, US",58191,-405,498,669,-171,8,-242,-234,0,2190,11.456754605,-2.928408128,0.1370015498,-4.144296882,-4.007295333,28962
22085,"Sabine","Louisiana","US","2020-05-24 02:32:43",31.56388699,-93.55433981,39,0,0,39,"Sabine, Louisiana, US",23884,-17,262,234,28,-2,-41,-43,-2,438,9.7938683687,1.1719158732,-0.083708277,-1.716019671,-1.799727948,6804
48403,"Sabine","Texas","US","2020-05-24 02:32:43",31.34318809,-93.85440451,4,0,0,4,"Sabine, Texas, US",10542,-34,100,144,-44,-4,16,12,-2,136,13.637655081,-4.167061275,-0.378823752,1.515295009,1.1364712567,2179
19161,"Sac","Iowa","US","2020-05-24 02:32:43",42.38624071,-95.10547892,13,0,0,13,"Sac, Iowa, US",9721,16,106,117,-11,0,29,29,-2,182,12.045711932,-1.132502831,0,2.9856892824,2.9856892824,3954
6067,"Sacramento","California","US","2020-05-24 02:32:43",38.45106826,-121.3425374,1289,56,0,1233,"Sacramento, California, US",1552058,13312,19192,12368,6824,3042,3456,6498,-10,22963,8.0030956347,4.4156795449,1.9684198675,2.2363113287,4.2047311962,621683
23023,"Sagadahoc","Maine","US","2020-05-24 02:32:43",43.95415864,-69.85074999,28,0,0,28,"Sagadahoc, Maine, US",35856,166,313,402,-89,2,255,257,-2,264,11.237525508,-2.487909876,0.0559080871,7.1282811059,7.184189193,16408
26145,"Saginaw","Michigan","US","2020-05-24 02:32:43",43.33433923,-84.0513121,982,105,0,877,"Saginaw, Michigan, US",190539,-252,2188,2138,50,125,-421,-296,-6,6758,11.213384732,0.2622400545,0.6556001364,-2.208061259,-1.552461123,90750
8109,"Saguache","Colorado","US","2020-05-24 02:32:43",38.08054629,-106.282466,24,0,0,24,"Saguache, Colorado, US",6824,-16,69,59,10,9,-34,-25,-1,18,8.6358313817,1.4637002342,1.3173302108,-4.976580796,-3.659250585,2160
34033,"Salem","New Jersey","US","2020-05-24 02:32:43",39.58719656,-75.3469663,535,27,0,508,"Salem, New Jersey, US",62385,-361,684,756,-72,9,-300,-291,2,1257,12.083336663,-1.150793968,0.143849246,-4.794974866,-4.65112562,24169
51775,"Salem","Virginia","US","2020-05-24 02:32:43",37.2836193,-80.06219455,32,3,0,29,"Salem, Virginia, US",25301,8,300,331,-31,11,30,41,-2,1996,13.084555481,-1.225441752,0.4348341701,1.1859113729,1.6207455429,23462
5125,"Saline","Arkansas","US","2020-05-24 02:32:43",34.64916145,-92.67583224,87,1,0,86,"Saline, Arkansas, US",122437,1363,1280,1100,180,-9,1197,1188,-5,1422,9.0344994682,1.4783726403,-0.073918632,9.8311780577,9.7572594257,27840
17165,"Saline","Illinois","US","2020-05-24 02:32:43",37.75332999,-88.54119706,6,0,0,6,"Saline, Illinois, US",23491,-298,278,343,-65,-2,-231,-233,0,881,14.509306261,-2.749576988,-0.084602369,-9.771573604,-9.856175973,9811
20169,"Saline","Kansas","US","2020-05-24 02:32:43",38.78369175,-97.65185177,24,2,0,22,"Saline, Kansas, US",54224,-163,682,500,182,2,-346,-344,-1,1471,9.2071705444,3.3514100782,0.0368286822,-6.371362017,-6.334533335,29901
29195,"Saline","Missouri","US","2020-05-24 02:32:43",39.13734288,-93.20259964,266,2,0,264,"Saline, Missouri, US",22761,-129,240,241,-1,45,-174,-129,1,1489,10.558366739,-0.04381065,1.9714792666,-7.623053164,-5.651573898,10268
31151,"Saline","Nebraska","US","2020-05-24 02:32:43",40.52418865,-97.14085859,467,1,0,466,"Saline, Nebraska, US",14224,-112,190,131,59,60,-233,-173,2,908,9.1736694678,4.1316526611,4.2016806723,-16.31652661,-12.11484594,7026
49035,"Salt Lake","Utah","US","2020-05-24 02:32:43",40.66616532,-111.9216011,4441,67,0,4374,"Salt Lake, Utah, US",1160437,11745,16530,6741,9789,3592,-1604,1988,-32,14692,5.838565104,8.4785215551,3.111129781,-1.389268421,1.7218613598,606597
45081,"Saluda","South Carolina","US","2020-05-24 02:32:43",34.00795823,-81.72713237,134,0,0,134,"Saluda, South Carolina, US",20473,76,226,199,27,28,22,50,-1,298,9.7381942745,1.3212625398,1.3701981894,1.0765842917,2.446782481,5856
37163,"Sampson","North Carolina","US","2020-05-24 02:32:43",34.98820368,-78.36914061,367,1,0,366,"Sampson, North Carolina, US",63531,186,825,685,140,128,-78,50,-4,961,10.79794445,2.2068791576,2.017718087,-1.229546959,0.7881711277,21564
48405,"San Augustine","Texas","US","2020-05-24 02:32:43",31.39457611,-94.17000399,28,1,0,27,"San Augustine, Texas, US",8237,-17,78,118,-40,1,23,24,-1,202,14.310836214,-4.85113092,0.121278273,2.7894002789,2.9106785519,1896
6069,"San Benito","California","US","2020-05-24 02:32:43",36.60308176,-121.069975,69,2,0,67,"San Benito, California, US",62808,1341,774,324,450,-38,926,888,3,289,5.2142426071,7.242003621,-0.611546972,14.902434118,14.290887145,17470
6071,"San Bernardino","California","US","2020-05-24 02:32:43",34.84060306,-116.1774685,4315,176,0,4139,"San Bernardino, California, US",2180085,13332,29341,15223,14118,162,-914,-752,-34,37308,7.0041717681,6.4957562256,0.0745369393,-0.420535571,-0.345998632,744663
6073,"San Diego","California","US","2020-05-24 02:32:43",33.03484597,-116.7365326,6559,249,0,6310,"San Diego, California, US",3338330,4469,40603,23052,17551,6733,-19731,-12998,-84,107139,6.9098741328,5.2609405216,2.0182275957,-5.914399033,-3.896171438,1534345
6075,"San Francisco","California","US","2020-05-24 02:32:43",37.75215114,-122.4385672,2350,40,0,2310,"San Francisco, California, US",881549,853,8868,6359,2509,4498,-6094,-1596,-60,24242,7.2169306765,2.8475041779,5.1048520495,-6.916177943,-1.811325894,661099
48407,"San Jacinto","Texas","US","2020-05-24 02:32:43",30.57933681,-95.16260304,13,0,0,13,"San Jacinto, Texas, US",28859,142,298,315,-17,-10,169,159,0,127,10.942059191,-0.590523829,-0.347366958,5.8705015979,5.5231346394,3692
6077,"San Joaquin","California","US","2020-05-24 02:32:43",37.93433732,-121.2730061,752,33,0,719,"San Joaquin, California, US",762148,9657,9975,5838,4137,687,4842,5529,-9,15758,7.7087675677,5.4626878088,0.9071468515,6.3936027,7.3007495515,242122
8111,"San Juan","Colorado","US","2020-05-24 02:32:43",37.76248981,-107.6763289,1,0,0,1,"San Juan, Colorado, US",728,-36,4,4,0,0,-37,-37,1,0,5.3619302949,0,0,-49.59785523,-49.59785523,299
35045,"San Juan","New Mexico","US","2020-05-24 02:32:43",36.50838318,-108.320437,1490,103,0,1387,"San Juan, New Mexico, US",123958,-1541,1410,1109,301,-12,-1837,-1849,7,1738,8.8913119295,2.4132415607,-0.096208966,-14.72798919,-14.82419816,51694
49037,"San Juan","Utah","US","2020-05-24 02:32:43",37.62762978,-109.8033714,259,4,0,255,"San Juan, Utah, US",15308,-50,186,128,58,1,-109,-108,0,346,8.3480075654,3.7826909281,0.0652188091,-7.108850192,-7.043631383,5137
53055,"San Juan","Washington","US","2020-05-24 02:32:43",48.60182783,-122.96745,15,0,0,15,"San Juan, Washington, US",17582,458,88,132,-44,27,474,501,1,187,7.6067538754,-2.535584625,1.5559269291,27.315161644,28.871088573,7400
6079,"San Luis Obispo","California","US","2020-05-24 02:32:43",35.38822029,-120.4039028,259,1,0,258,"San Luis Obispo, California, US",283111,-243,2488,2465,23,-7,-245,-252,-14,15937,8.7030972787,0.0812053701,-0.024714678,-0.865013725,-0.889728403,121723
6081,"San Mateo","California","US","2020-05-24 02:32:43",37.4228808,-122.3275546,1833,76,0,1757,"San Mateo, California, US",766573,-2108,8425,5187,3238,3610,-8953,-5343,-3,8786,6.7571880614,4.2181945137,4.7028048779,-11.66321664,-6.960411762,380392
8113,"San Miguel","Colorado","US","2020-05-24 02:32:43",38.00450883,-108.4020725,23,0,0,23,"San Miguel, Colorado, US",8179,-1,61,24,37,41,-79,-38,0,9,2.93416468,4.5235038817,5.0125313283,-9.658292072,-4.645760743,5075
35047,"San Miguel","New Mexico","US","2020-05-24 02:32:43",35.48014807,-104.8163562,10,0,0,10,"San Miguel, New Mexico, US",27277,-203,247,271,-24,41,-222,-181,2,1296,9.8982778458,-0.876600252,1.4975254305,-8.108552331,-6.611026901,8325
48409,"San Patricio","Texas","US","2020-05-24 02:32:43",28.00880118,-97.51763891,28,0,0,28,"San Patricio, Texas, US",66730,59,915,584,331,46,-318,-272,0,500,8.755556555,4.9624815406,0.6896500026,-4.767580453,-4.07793045,20939
48411,"San Saba","Texas","US","2020-05-24 02:32:43",31.1577796,-98.81758731,1,0,0,1,"San Saba, Texas, US",6055,-5,65,79,-14,7,2,9,0,719,13.041683863,-2.311184482,1.155592241,0.3301692117,1.4857614527,2168
46111,"Sanborn","South Dakota","US","2020-05-24 02:32:43",44.02351092,-98.0909816,9,0,0,9,"Sanborn, South Dakota, US",2344,-52,33,17,16,0,-69,-69,1,174,7.1729957806,6.7510548523,0,-29.11392405,-29.11392405,883
35043,"Sandoval","New Mexico","US","2020-05-24 02:32:43",35.68862401,-106.8687803,529,24,0,505,"Sandoval, New Mexico, US",146748,1652,1405,1145,260,-22,1414,1392,0,760,7.8466578035,1.7817738244,-0.150765477,9.6901084141,9.5393429366,35556
39143,"Sandusky","Ohio","US","2020-05-24 02:32:43",41.35624126,-83.137872,65,10,0,55,"Sandusky, Ohio, US",58518,-222,603,624,-21,2,-201,-199,-2,902,10.643197053,-0.358184516,0.0341128111,-3.428337512,-3.394224701,26964
17167,"Sangamon","Illinois","US","2020-05-24 02:32:43",39.75836914,-89.65872023,328,26,0,302,"Sangamon, Illinois, US",194672,-967,2201,2101,100,203,-1272,-1069,2,4018,10.76577396,0.5124118972,1.0401961513,-6.517879332,-5.477683181,109663
26151,"Sanilac","Michigan","US","2020-05-24 02:32:43",43.42406072,-82.82055898,39,5,0,34,"Sanilac, Michigan, US",41170,-22,426,491,-65,4,42,46,-3,564,11.922974187,-1.578397805,0.0971321726,1.0198878123,1.1170199849,13362
6083,"Santa Barbara","California","US","2020-05-24 02:32:43",34.65329488,-120.0188492,1551,12,0,1539,"Santa Barbara, California, US",446499,719,5390,3288,2102,553,-1924,-1371,-12,20112,7.3698921526,4.7115308104,1.2395226157,-4.312552464,-3.073029848,213822
6085,"Santa Clara","California","US","2020-05-24 02:32:43",37.23104908,-121.6970462,2571,139,0,2432,"Santa Clara, California, US",1927852,-4485,21713,11258,10455,13409,-28421,-15012,72,30212,5.8328750224,5.4168332172,6.9473282267,-14.72518574,-7.777857509,1015257
4023,"Santa Cruz","Arizona","US","2020-05-24 02:32:43",31.52508998,-110.8479088,143,0,0,143,"Santa Cruz, Arizona, US",46498,103,619,316,303,56,-257,-201,1,474,6.8035266382,6.5236347195,1.205688265,-5.53324793,-4.327559665,17453
6087,"Santa Cruz","California","US","2020-05-24 02:32:43",37.05580291,-122.0066524,192,2,0,190,"Santa Cruz, California, US",273213,-628,2540,1885,655,59,-1339,-1280,-3,14386,6.8914586129,2.39464477,0.2157008266,-4.89531198,-4.679611154,117139
35049,"Santa Fe","New Mexico","US","2020-05-24 02:32:43",35.50708973,-105.9774716,129,3,0,126,"Santa Fe, New Mexico, US",150358,597,1189,1191,-2,63,542,605,-6,2632,7.9368517155,-0.013328047,0.4198334661,3.6119006128,4.0317340788,71801
12113,"Santa Rosa","Florida","US","2020-05-24 02:32:43",30.6934145,-87.02458128,207,9,0,198,"Santa Rosa, Florida, US",184313,5018,1971,1692,279,-68,4787,4719,20,6169,9.3067259246,1.5346197003,-0.374029174,26.330553783,25.956524609,41461
12115,"Sarasota","Florida","US","2020-05-24 02:32:43",27.18546175,-82.33174248,576,73,0,503,"Sarasota, Florida, US",433742,7413,2835,6127,-3292,724,9945,10669,36,6004,14.247660949,-7.655181956,1.6835819368,23.125997737,24.809579674,170172
36091,"Saratoga","New York","US","2020-05-24 02:32:43",43.10904162,-73.86653895,452,11,0,441,"Saratoga, New York, US",229863,-307,2103,2050,53,132,-490,-358,-2,3383,8.9124041101,0.2304182526,0.5738718744,-2.130281958,-1.556410084,86417
38081,"Sargent","North Dakota","US","2020-05-24 02:32:43",46.10830372,-97.63217159,3,0,0,3,"Sargent, North Dakota, US",3898,47,45,33,12,3,31,34,1,38,8.5172280294,3.0971738289,0.7742934572,8.0010323913,8.7753258485,3072
31153,"Sarpy","Nebraska","US","2020-05-24 02:32:43",41.11314181,-96.11156432,434,2,0,432,"Sarpy, Nebraska, US",187196,3134,2490,1069,1421,107,1607,1714,-1,1263,5.7587984636,7.6550538978,0.5764185553,8.657052508,9.2334710632,63826
55111,"Sauk","Wisconsin","US","2020-05-24 02:32:43",43.42574087,-89.94966132,77,3,0,74,"Sauk, Wisconsin, US",64442,124,728,606,122,19,-14,5,-3,719,9.412861137,1.8949984467,0.2951227089,-0.217458838,0.0776638708,34799
31155,"Saunders","Nebraska","US","2020-05-24 02:32:43",41.2278103,-96.63773905,27,1,0,26,"Saunders, Nebraska, US",21578,304,247,202,45,3,258,261,-2,336,9.4277980024,2.1002520302,0.140016802,12.041444973,12.181461775,6158
55113,"Sawyer","Wisconsin","US","2020-05-24 02:32:43",45.87931905,-91.14504927,7,0,0,7,"Sawyer, Wisconsin, US",16558,94,150,204,-54,2,146,148,0,311,12.355399431,-3.270546908,0.121131367,8.8425897886,8.9637211556,7151
36093,"Schenectady","New York","US","2020-05-24 02:32:43",42.81668777,-74.05278291,648,29,0,619,"Schenectady, New York, US",155299,220,1792,1486,306,223,-305,-82,-4,4380,9.5754209383,1.9717892376,1.4369575163,-1.965345482,-0.528387966,66766
13249,"Schley","Georgia","US","2020-05-24 02:32:43",32.2654021,-84.31258912,16,1,0,15,"Schley, Georgia, US",5257,27,46,38,8,12,7,19,0,0,7.2470677982,1.5256984838,2.2885477258,1.3349861734,3.6235338991,1117
36095,"Schoharie","New York","US","2020-05-24 02:32:43",42.58831742,-74.4433903,49,0,0,49,"Schoharie, New York, US",30999,-147,237,313,-76,6,-76,-70,-1,1266,10.073215866,-2.44589267,0.1930967898,-2.44589267,-2.252795881,10745
26153,"Schoolcraft","Michigan","US","2020-05-24 02:32:43",46.19235734,-86.19972234,4,0,0,4,"Schoolcraft, Michigan, US",8094,50,64,108,-44,-1,94,93,1,140,13.384558186,-5.45296815,-0.123931094,11.649522865,11.525591771,2682
17169,"Schuyler","Illinois","US","2020-05-24 02:32:43",40.1571798,-90.61114163,10,0,0,10,"Schuyler, Illinois, US",6768,-102,54,93,-39,6,-68,-62,-1,463,13.638363396,-5.719313682,0.8798944127,-9.972136677,-9.092242264,2093
36097,"Schuyler","New York","US","2020-05-24 02:32:43",42.39184015,-76.8773299,11,0,0,11,"Schuyler, New York, US",17807,-77,146,187,-41,6,-40,-34,-2,204,10.478832199,-2.297497969,0.3362192149,-2.241461433,-1.905242218,5747
42107,"Schuylkill","Pennsylvania","US","2020-05-24 02:32:43",40.70497338,-76.2150785,576,26,0,550,"Schuylkill, Pennsylvania, US",141359,-456,1282,1778,-496,23,27,50,-10,6722,12.557650067,-3.503146475,0.1624442922,0.1906954735,0.3531397657,51678
39145,"Scioto","Ohio","US","2020-05-24 02:32:43",38.80270163,-82.98907345,14,0,0,14,"Scioto, Ohio, US",75314,-166,825,958,-133,8,-39,-31,-2,3391,12.706075839,-1.763995915,0.1061050174,-0.51726196,-0.411156943,24912
29199,"Scotland","Missouri","US","2020-05-24 02:32:43",40.45214695,-92.14709064,4,0,0,4,"Scotland, Missouri, US",4902,-36,73,40,33,0,-69,-69,0,76,8.1300813008,6.7073170732,0,-14.02439024,-14.02439024,1724
37165,"Scotland","North Carolina","US","2020-05-24 02:32:43",34.8386299,-79.4757978,62,0,0,62,"Scotland, North Carolina, US",34823,72,436,427,9,13,53,66,-3,2519,12.274700319,0.2587173369,0.37370282,1.5235576508,1.8972604709,12243
5127,"Scott","Arkansas","US","2020-05-24 02:32:43",34.85588887,-94.0632176,1,0,0,1,"Scott, Arkansas, US",10281,-58,112,117,-5,-5,-48,-53,0,79,11.348205626,-0.484966052,-0.484966052,-4.655674103,-5.140640155,3877
18143,"Scott","Indiana","US","2020-05-24 02:32:43",38.68672078,-85.74627859,115,3,0,112,"Scott, Indiana, US",23873,89,262,310,-48,20,117,137,0,312,13.009631324,-2.014394528,0.8393310532,4.9100866609,5.7494177141,7084
19163,"Scott","Iowa","US","2020-05-24 02:32:43",41.63935978,-90.61959493,329,9,0,320,"Scott, Iowa, US",172943,140,2069,1509,560,65,-481,-416,-4,3387,8.7289513111,3.2393722559,0.3759985654,-2.782389384,-2.406390819,85786
20171,"Scott","Kansas","US","2020-05-24 02:32:43",38.48222076,-100.9066539,13,0,0,13,"Scott, Kansas, US",4823,-86,58,59,-1,-2,-83,-85,0,105,12.124948623,-0.205507604,-0.411015208,-17.05713111,-17.46814632,2262
21209,"Scott","Kentucky","US","2020-05-24 02:32:43",38.29622293,-84.5816631,34,0,0,34,"Scott, Kentucky, US",57004,1036,702,437,265,-6,776,770,1,1092,7.7364302659,4.6914279645,-0.106221011,13.73791736,13.63169635,28381
27139,"Scott","Minnesota","US","2020-05-24 02:32:43",44.6490231,-93.53340251,334,2,0,332,"Scott, Minnesota, US",149013,1822,1765,677,1088,126,611,737,-3,1289,4.5711739207,7.3462883688,0.8507650133,4.1255351042,4.9763001175,48665
28123,"Scott","Mississippi","US","2020-05-24 02:32:43",32.4067041,-89.53789439,587,10,0,577,"Scott, Mississippi, US",28124,-195,451,312,139,20,-355,-335,1,186,11.055401024,4.9253228921,0.7086795528,-12.57906206,-11.87038251,11757
29201,"Scott","Missouri","US","2020-05-24 02:32:43",37.05588075,-89.56474493,91,8,0,83,"Scott, Missouri, US",38280,-261,482,454,28,-6,-280,-286,-3,559,11.819684722,0.7289673397,-0.156207287,-7.289673397,-7.445880684,16917
47151,"Scott","Tennessee","US","2020-05-24 02:32:43",36.42325673,-84.50360494,11,0,0,11,"Scott, Tennessee, US",22068,40,257,287,-30,0,72,72,-2,302,13.017053701,-1.360667634,0,3.2656023222,3.2656023222,6238
51169,"Scott","Virginia","US","2020-05-24 02:32:43",36.71466456,-82.60171704,7,2,0,5,"Scott, Virginia, US",21566,-106,176,302,-126,-1,23,22,-2,792,13.969193765,-5.82820667,-0.046255608,1.0638789953,1.0176233868,5303
31157,"Scotts Bluff","Nebraska","US","2020-05-24 02:32:43",41.85070896,-103.7080986,62,0,0,62,"Scotts Bluff, Nebraska, US",35618,-307,454,388,66,23,-397,-374,1,850,10.846623709,1.8450442391,0.6429699621,-11.09822065,-10.45525069,18423
13251,"Screven","Georgia","US","2020-05-24 02:32:43",32.74976524,-81.60779441,26,2,0,24,"Screven, Georgia, US",13966,6,196,176,20,3,-17,-14,0,479,12.604741101,1.4323569434,0.2148535415,-1.217503402,-1.00264986,4234
48415,"Scurry","Texas","US","2020-05-24 02:32:43",32.74613808,-100.9162664,2,0,0,2,"Scurry, Texas, US",16703,-109,203,182,21,6,-136,-130,0,1659,10.860808593,1.2531702223,0.3580486349,-8.115769059,-7.757720424,7925
5129,"Searcy","Arkansas","US","2020-05-24 02:32:43",35.9109364,-92.69936482,6,0,0,6,"Searcy, Arkansas, US",7881,-49,73,111,-38,2,-11,-9,-2,71,14.040857631,-4.80678009,0.2529884258,-1.391436342,-1.138447916,2026
5131,"Sebastian","Arkansas","US","2020-05-24 02:32:43",35.19605503,-94.27162713,19,0,0,19,"Sebastian, Arkansas, US",127827,257,1780,1276,504,-51,-194,-245,-2,2242,9.9922865186,3.946796556,-0.399378223,-1.519203436,-1.918581659,69392
20173,"Sedgwick","Kansas","US","2020-05-24 02:32:43",37.6842718,-97.4608198,553,21,0,532,"Sedgwick, Kansas, US",516042,2558,6705,4511,2194,622,-240,382,-18,7238,8.7632561004,4.2621555939,1.2083230535,-0.466233976,0.7420890779,255609
12117,"Seminole","Florida","US","2020-05-24 02:32:43",28.7158582,-81.24060348,454,12,0,442,"Seminole, Florida, US",471826,3704,4714,3672,1042,836,1840,2676,-14,3513,7.8131981769,2.2171439271,1.7788218072,3.9151101976,5.6939320047,178461
13253,"Seminole","Georgia","US","2020-05-24 02:32:43",30.93464824,-84.86823924,42,2,0,40,"Seminole, Georgia, US",8090,-180,94,116,-22,-1,-157,-158,0,53,14.180929095,-2.689486553,-0.122249389,-19.19315403,-19.31540342,2681
40133,"Seminole","Oklahoma","US","2020-05-24 02:32:43",35.16478725,-96.61686741,21,2,0,19,"Seminole, Oklahoma, US",24258,-262,304,354,-50,1,-214,-213,1,581,14.514740252,-2.050104555,0.0410020911,-8.774447497,-8.733445406,8414
36099,"Seneca","New York","US","2020-05-24 02:32:43",42.78081007,-76.82497064,54,0,0,54,"Seneca, New York, US",34016,-163,318,313,5,8,-175,-167,-1,2675,9.1795586187,0.1466383166,0.2346213065,-5.132341081,-4.897719774,13131
39147,"Seneca","Ohio","US","2020-05-24 02:32:43",41.12351311,-83.12783209,17,2,0,15,"Seneca, Ohio, US",55178,-16,589,561,28,34,-76,-42,-2,2676,10.165621716,0.5073750589,0.6160982858,-1.377160874,-0.761062588,19378
47153,"Sequatchie","Tennessee","US","2020-05-24 02:32:43",35.36979721,-85.41022136,10,0,0,10,"Sequatchie, Tennessee, US",15026,135,166,168,-2,-1,138,137,0,188,11.231072634,-0.133703246,-0.066851623,9.2255239496,9.1586723268,3117
40135,"Sequoyah","Oklahoma","US","2020-05-24 02:32:43",35.49447108,-94.75463785,14,3,0,11,"Sequoyah, Oklahoma, US",41569,-16,512,545,-33,23,-3,20,-3,464,13.108208865,-0.79370806,0.5531904659,-0.072155278,0.4810351877,10619
5133,"Sevier","Arkansas","US","2020-05-24 02:32:43",33.99780401,-94.2424869,79,1,0,78,"Sevier, Arkansas, US",17007,-54,246,149,97,-22,-130,-152,1,173,8.7472114594,5.6944933662,-1.291534578,-7.631795233,-8.923329811,5659
47155,"Sevier","Tennessee","US","2020-05-24 02:32:43",35.78077323,-83.52244332,72,2,0,70,"Sevier, Tennessee, US",98250,355,1025,1063,-38,169,230,399,-6,1059,10.838920187,-0.387468454,1.7232149685,2.3452038033,4.0684187718,43566
20175,"Seward","Kansas","US","2020-05-24 02:32:43",37.19324632,-100.8507201,821,1,0,820,"Seward, Kansas, US",21428,-474,403,110,293,106,-878,-772,5,476,5.0773136395,13.52411724,4.8926840526,-40.52619432,-35.63351027,11953
31159,"Seward","Nebraska","US","2020-05-24 02:32:43",40.87241834,-97.139673,27,1,0,26,"Seward, Nebraska, US",17284,11,194,162,32,9,-30,-21,0,1342,9.3758138727,1.8520126168,0.5208785485,-1.736261828,-1.21538328,6469
48417,"Shackelford","Texas","US","2020-05-24 02:32:43",32.73587756,-99.35401337,1,0,0,1,"Shackelford, Texas, US",3265,9,29,31,-2,0,11,11,0,11,9.507744211,-0.613402852,0,3.3737156878,3.3737156878,1493
28125,"Sharkey","Mississippi","US","2020-05-24 02:32:43",32.88149103,-90.8159538,7,0,0,7,"Sharkey, Mississippi, US",4321,-54,65,50,15,1,-70,-69,0,108,11.499540018,3.4498620055,0.2299908004,-16.09935603,-15.86936523,1395
5135,"Sharp","Arkansas","US","2020-05-24 02:32:43",36.16258158,-91.47819342,42,2,0,40,"Sharp, Arkansas, US",17442,152,193,240,-47,2,199,201,-2,189,13.820108258,-2.706437867,0.1151675688,11.459173097,11.574340666,4242
6089,"Shasta","California","US","2020-05-24 02:32:43",40.76391419,-122.0396884,36,4,0,32,"Shasta, California, US",180080,371,1977,2297,-320,193,514,707,-16,2854,12.768594926,-1.778820364,1.0728510321,2.8572302099,3.9300812421,68830
55115,"Shawano","Wisconsin","US","2020-05-24 02:32:43",44.78902246,-88.76443896,37,0,0,37,"Shawano, Wisconsin, US",40899,128,449,376,73,8,49,57,-2,662,9.2077874372,1.7876821354,0.195910371,1.1999510224,1.3958613934,15000
20177,"Shawnee","Kansas","US","2020-05-24 02:32:43",39.04100763,-95.7557264,247,6,0,241,"Shawnee, Kansas, US",176875,-415,2002,1800,202,132,-743,-611,-6,4389,10.164753716,1.1407112504,0.7454152725,-4.195784451,-3.450369178,95991
55117,"Sheboygan","Wisconsin","US","2020-05-24 02:32:43",43.72099677,-87.94579284,82,3,0,79,"Sheboygan, Wisconsin, US",115340,107,1226,1079,147,41,-76,-35,-5,2809,9.3592918512,1.2750842466,0.3556357423,-0.65922723,-0.303591487,58974
1117,"Shelby","Alabama","US","2020-05-24 02:32:43",33.26879845,-86.66232561,426,19,0,407,"Shelby, Alabama, US",217702,2119,2237,1626,611,137,1381,1518,-10,2416,7.5054525312,2.8203145735,0.6323782268,6.3745571621,7.0069353889,79605
17173,"Shelby","Illinois","US","2020-05-24 02:32:43",39.39133527,-88.80611122,16,1,0,15,"Shelby, Illinois, US",21634,-92,228,246,-18,0,-73,-73,-1,205,11.346863469,-0.830258303,0,-3.367158672,-3.367158672,6566
18145,"Shelby","Indiana","US","2020-05-24 02:32:43",39.52305623,-85.7915857,311,21,0,290,"Shelby, Indiana, US",44729,207,492,442,50,32,126,158,-1,683,9.9046509283,1.1204356254,0.7170788002,2.8234977759,3.5405765762,18634
19165,"Shelby","Iowa","US","2020-05-24 02:32:43",41.6850066,-95.31015553,31,0,0,31,"Shelby, Iowa, US",11454,-105,110,132,-22,-1,-81,-82,-1,206,11.471776822,-1.911962804,-0.0869074,-7.039499413,-7.126406814,6267
21211,"Shelby","Kentucky","US","2020-05-24 02:32:43",38.21476019,-85.194223,92,4,0,88,"Shelby, Kentucky, US",49024,965,550,389,161,25,776,801,3,1812,8.0137614206,3.3167495854,0.5150232275,15.986320983,16.501344211,16448
29205,"Shelby","Missouri","US","2020-05-24 02:32:43",39.79742518,-92.07634971,1,0,0,1,"Shelby, Missouri, US",5930,-67,76,51,25,0,-93,-93,1,198,8.5520248176,4.1921690283,0,-15.59486879,-15.59486879,2381
39149,"Shelby","Ohio","US","2020-05-24 02:32:43",40.33163494,-84.20258189,37,2,0,35,"Shelby, Ohio, US",48590,-32,613,442,171,34,-239,-205,2,589,9.093527548,3.5180841871,0.6995021191,-4.917088425,-4.217586306,27663
47157,"Shelby","Tennessee","US","2020-05-24 02:32:43",35.1864775,-89.89692423,4225,92,0,4133,"Shelby, Tennessee, US",937166,801,12894,8484,4410,1581,-5190,-3609,0,17353,9.0566956191,4.7076883169,1.6877222741,-5.540340672,-3.852618398,494978
48419,"Shelby","Texas","US","2020-05-24 02:32:43",31.79211404,-94.14550696,180,5,0,175,"Shelby, Texas, US",25274,-33,340,296,44,-13,-62,-75,-2,154,11.703999526,1.7397837133,-0.514027006,-2.451513414,-2.96554042,8842
51171,"Shenandoah","Virginia","US","2020-05-24 02:32:43",38.85905135,-78.56813762,365,16,0,349,"Shenandoah, Virginia, US",43616,143,452,484,-32,7,170,177,-2,427,11.115066197,-0.73488041,0.1607550896,3.9040521765,4.0648072661,14752
27141,"Sherburne","Minnesota","US","2020-05-24 02:32:43",45.44447208,-93.77617511,202,1,0,201,"Sherburne, Minnesota, US",97238,1281,1217,533,684,20,582,602,-5,2204,5.5177411424,7.0809285955,0.2070446958,6.025000647,6.2320453428,24844
20179,"Sheridan","Kansas","US","2020-05-24 02:32:43",39.35018161,-100.4418259,2,0,0,2,"Sheridan, Kansas, US",2521,-1,31,21,10,2,-14,-12,1,33,8.3283759667,3.9658933175,0.7931786635,-5.552250644,-4.759071981,1219
31161,"Sheridan","Nebraska","US","2020-05-24 02:32:43",42.50284406,-102.4126613,0,0,0,0,"Sheridan, Nebraska, US",5246,57,57,63,-6,3,59,62,1,142,12.074748443,-1.149976042,0.5749880211,11.308097748,11.883085769,2059
56033,"Sheridan","Wyoming","US","2020-05-24 02:32:43",44.79048913,-106.8862389,16,0,0,16,"Sheridan, Wyoming, US",30485,266,308,346,-38,14,289,303,1,1039,11.399578281,-1.251976805,0.4612546125,9.5216130733,9.9828676858,13618
20181,"Sherman","Kansas","US","2020-05-24 02:32:43",39.35147699,-101.7197624,6,0,0,6,"Sherman, Kansas, US",5917,0,72,74,-2,-1,5,4,-2,102,12.506337671,-0.338009126,-0.169004563,0.8450228156,0.6760182525,2782
31163,"Sherman","Nebraska","US","2020-05-24 02:32:43",41.22045983,-98.97588642,2,0,0,2,"Sherman, Nebraska, US",3001,-43,37,38,-1,0,-42,-42,0,56,12.572373863,-0.330851944,0,-13.89578164,-13.89578164,1082
41055,"Sherman","Oregon","US","2020-05-24 02:32:43",45.41501554,-120.6827834,1,0,0,1,"Sherman, Oregon, US",1780,80,15,11,4,0,76,76,0,0,6.3218390805,2.2988505747,0,43.67816092,43.67816092,837
48421,"Sherman","Texas","US","2020-05-24 02:32:43",36.27751473,-101.8933156,23,0,0,23,"Sherman, Texas, US",3022,-79,39,14,25,7,-111,-104,0,29,4.5729217704,8.1659317328,2.2864608852,-36.25673689,-33.97027601,1126
26155,"Shiawassee","Michigan","US","2020-05-24 02:32:43",42.953928,-84.14585902,238,24,0,214,"Shiawassee, Michigan, US",68122,-11,676,734,-58,8,43,51,-4,821,10.773916554,-0.851344905,0.1174268834,0.6311694984,0.7485963818,18620
27143,"Sibley","Minnesota","US","2020-05-24 02:32:43",44.5796592,-94.23164924,12,0,0,12,"Sibley, Minnesota, US",14865,-132,167,131,36,6,-174,-168,0,230,8.773692318,2.4110910187,0.4018485031,-11.65360659,-11.25175809,5120
6091,"Sierra","California","US","2020-05-24 02:32:43",39.57713498,-120.5200701,1,0,0,1,"Sierra, California, US",3005,8,25,37,-12,0,20,20,0,33,12.329223592,-3.998667111,0,6.6644451849,6.6644451849,799
35051,"Sierra","New Mexico","US","2020-05-24 02:32:43",33.13028233,-107.1925893,1,0,0,1,"Sierra, New Mexico, US",10791,-158,98,236,-138,1,-20,-19,-1,265,21.711131555,-12.69549218,0.0919963201,-1.839926403,-1.747930083,4169
30093,"Silver Bow","Montana","US","2020-05-24 02:32:43",45.90018933,-112.6620092,11,0,0,11,"Silver Bow, Montana, US",34915,176,364,419,-55,51,181,232,-1,999,12.03089557,-1.579234502,1.4643810836,5.1971171792,6.6614982628,16052
21213,"Simpson","Kentucky","US","2020-05-24 02:32:43",36.74058474,-86.58047435,44,3,0,41,"Simpson, Kentucky, US",18572,169,228,180,48,3,118,121,0,327,9.7363083164,2.5963488844,0.1622718053,6.3826910074,6.5449628127,8376
28127,"Simpson","Mississippi","US","2020-05-24 02:32:43",31.91282117,-89.91716179,83,0,0,83,"Simpson, Mississippi, US",26658,-59,305,313,-8,3,-53,-50,-1,545,11.728337237,-0.299765808,0.112412178,-1.985948478,-1.8735363,6725
19167,"Sioux","Iowa","US","2020-05-24 02:32:43",43.08221074,-96.1767568,194,0,0,194,"Sioux, Iowa, US",34855,53,487,254,233,24,-205,-181,1,2203,7.2928779591,6.6899234822,0.6890908308,-5.88598418,-5.196893349,20953
38085,"Sioux","North Dakota","US","2020-05-24 02:32:43",46.11323337,-101.0440149,2,0,0,2,"Sioux, North Dakota, US",4230,-147,78,74,4,2,-156,-154,3,54,17.195306146,0.9294760079,0.464738004,-36.24956431,-35.7848263,1794
6093,"Siskiyou","California","US","2020-05-24 02:32:43",41.59198861,-122.5407434,6,1,0,5,"Siskiyou, California, US",43539,-11,382,525,-143,2,133,135,-3,613,12.056631722,-3.283996831,0.0459300256,3.0543467028,3.1002767284,16309
2220,"Sitka","Alaska","US","2020-05-24 02:32:43",57.24124555,-135.3206587,1,0,0,1,"Sitka, Alaska, US",8493,-61,77,58,19,16,-96,-80,0,258,6.8047163724,2.2291312254,1.8771631372,-11.26297882,-9.385815686,4733
53057,"Skagit","Washington","US","2020-05-24 02:32:43",48.48171488,-121.766131,426,15,0,411,"Skagit, Washington, US",129205,1370,1431,1265,166,170,1030,1200,4,1626,9.8428260193,1.2916277622,1.3227513228,8.0143168378,9.3370681606,52991
53059,"Skamania","Washington","US","2020-05-24 02:32:43",46.02408726,-121.9164403,3,0,0,3,"Skamania, Washington, US",12083,164,99,94,5,4,154,158,1,25,7.8326806099,0.4166319473,0.3333055579,12.832263978,13.165569536,2598
38087,"Slope","North Dakota","US","2020-05-24 02:32:43",46.44737738,-103.4601547,3,0,0,3,"Slope, North Dakota, US",750,-11,8,0,8,1,-20,-19,0,0,0,10.589013898,1.3236267373,-26.47253475,-25.14890801,331
20183,"Smith","Kansas","US","2020-05-24 02:32:43",39.78516566,-98.78566062,2,0,0,2,"Smith, Kansas, US",3583,-7,41,39,2,0,-10,-10,1,56,10.874111251,0.5576467308,0,-2.788233654,-2.788233654,1732
28129,"Smith","Mississippi","US","2020-05-24 02:32:43",32.01744532,-89.50644846,126,10,0,116,"Smith, Mississippi, US",15916,-113,186,180,6,1,-122,-121,2,119,11.269369228,0.3756456409,0.0626076068,-7.638128033,-7.575520426,3890
47159,"Smith","Tennessee","US","2020-05-24 02:32:43",36.25359775,-85.95411046,29,1,0,28,"Smith, Tennessee, US",20157,178,223,232,-9,-3,190,187,0,236,11.560693642,-0.448475184,-0.149491728,9.4678094479,9.3183177198,5690
48423,"Smith","Texas","US","2020-05-24 02:32:43",32.37474036,-95.2717568,195,4,0,191,"Smith, Texas, US",232751,3002,2969,2177,792,92,2120,2212,-2,5131,9.4140540541,3.4248648649,0.3978378378,9.1675675676,9.5654054054,100226
51173,"Smyth","Virginia","US","2020-05-24 02:32:43",36.84455636,-81.53344948,15,0,0,15,"Smyth, Virginia, US",30104,-350,286,485,-199,-2,-147,-149,-2,768,16.017702038,-6.572211764,-0.06605238,-4.854849896,-4.920902276,12376
53061,"Snohomish","Washington","US","2020-05-24 02:32:43",48.04615983,-121.7170703,2863,135,0,2728,"Snohomish, Washington, US",822083,9024,9993,5850,4143,2230,2641,4871,10,10397,7.1553418602,5.0674497995,2.7275918544,3.2303004877,5.9578923421,287524
42109,"Snyder","Pennsylvania","US","2020-05-24 02:32:43",40.77129231,-77.06840691,38,1,0,37,"Snyder, Pennsylvania, US",40372,-146,426,385,41,5,-191,-186,-1,2656,9.5191000124,1.013722339,0.1236246755,-4.722462604,-4.598837928,17987
35053,"Socorro","New Mexico","US","2020-05-24 02:32:43",34.00715494,-106.9298354,49,4,0,45,"Socorro, New Mexico, US",16637,-67,175,148,27,47,-142,-95,1,581,8.8779580696,1.6196274857,2.8193515491,-8.518040851,-5.698689301,5422
6095,"Solano","California","US","2020-05-24 02:32:43",38.26827353,-121.9357113,455,20,0,435,"Solano, California, US",447643,1918,5088,3711,1377,280,277,557,-16,11538,8.3078865596,3.0827161931,0.6268413465,0.6201251892,1.2469665356,140641
23025,"Somerset","Maine","US","2020-05-24 02:32:43",45.51229767,-69.95995554,21,0,0,21,"Somerset, Maine, US",50484,-5,457,543,-86,2,81,83,-2,663,10.75535044,-1.703425668,0.0396145504,1.6043892922,1.6440038426,19431
24039,"Somerset","Maryland","US","2020-05-24 02:32:43",38.1163542,-75.75118623,71,1,0,70,"Somerset, Maryland, US",25616,10,216,276,-60,18,53,71,-1,5318,10.776619421,-2.342743352,0.7028230057,2.0694232947,2.7722463004,6818
34035,"Somerset","New Jersey","US","2020-05-24 02:32:43",40.56465737,-74.61683016,4425,397,0,4028,"Somerset, New Jersey, US",328934,-1247,3033,2613,420,598,-2279,-1681,14,5435,7.9288136365,1.2744361758,1.8145543646,-6.91533344,-5.100779075,184338
42111,"Somerset","Pennsylvania","US","2020-05-24 02:32:43",39.97172723,-79.02699593,37,0,0,37,"Somerset, Pennsylvania, US",73447,-425,638,938,-300,17,-137,-120,-5,5016,12.734270529,-4.072794412,0.2307916834,-1.859909448,-1.629117765,27564
6097,"Sonoma","California","US","2020-05-24 02:32:43",38.52746429,-122.8862506,467,4,0,463,"Sonoma, California, US",494336,-4307,4509,4379,130,97,-4534,-4437,0,10912,8.8199246913,0.2618383672,0.1953717047,-9.132116591,-8.936744886,215529
51175,"Southampton","Virginia","US","2020-05-24 02:32:43",36.72231125,-77.10642712,141,2,0,139,"Southampton, Virginia, US",17631,-82,122,205,-83,0,2,2,-1,1576,11.600271616,-4.696695337,0,0.1131733816,0.1131733816,4028
2240,"Southeast Fairbanks","Alaska","US","2020-05-24 02:32:43",63.87692095,-143.2127643,3,0,0,3,"Southeast Fairbanks, Alaska, US",6893,-44,109,35,74,12,-129,-117,-1,369,5.0614605929,10.701373825,1.7353579176,-18.65509761,-16.9197397,3526
13255,"Spalding","Georgia","US","2020-05-24 02:32:43",33.26310031,-84.28013991,253,14,0,239,"Spalding, Georgia, US",66703,596,824,827,-3,3,595,598,1,1384,12.453881485,-0.045177321,0.045177321,8.960168662,9.005345983,20954
45083,"Spartanburg","South Carolina","US","2020-05-24 02:32:43",34.92960077,-81.99225984,450,16,0,434,"Spartanburg, South Carolina, US",319785,5648,3897,3178,719,242,4672,4914,15,7849,10.026470134,2.2684178811,0.7635008723,14.739983783,15.503484656,131415
18147,"Spencer","Indiana","US","2020-05-24 02:32:43",38.01519732,-87.0079644,14,1,0,13,"Spencer, Indiana, US",20277,-108,212,235,-23,-2,-84,-86,1,368,11.558703458,-1.13127736,-0.098371944,-4.131621662,-4.229993606,7540
21215,"Spencer","Kentucky","US","2020-05-24 02:32:43",38.03223971,-85.32749335,16,0,0,16,"Spencer, Kentucky, US",19351,330,205,147,58,10,262,272,0,113,7.661836756,3.0230376316,0.5212133848,13.655790681,14.177004065,1898
46115,"Spink","South Dakota","US","2020-05-24 02:32:43",44.93837606,-98.34626602,4,0,0,4,"Spink, South Dakota, US",6376,-108,81,69,12,-2,-119,-121,1,403,10.730948678,1.866251944,-0.311041991,-18.50699844,-18.81804044,3071
53063,"Spokane","Washington","US","2020-05-24 02:32:43",47.62113146,-117.4046494,437,31,0,406,"Spokane, Washington, US",522798,9195,5880,4799,1081,489,7594,8083,31,14247,9.2608941906,2.0860651427,0.9436501895,14.654559384,15.598209573,217936
51177,"Spotsylvania","Virginia","US","2020-05-24 02:32:43",38.18574462,-77.655399,386,4,0,382,"Spotsylvania, Virginia, US",136215,2204,1481,1017,464,32,1711,1743,-3,524,7.527032928,3.4341625158,0.2368387942,12.663474277,12.900313071,36650
22087,"St. Bernard","Louisiana","US","2020-05-24 02:32:43",29.87761636,-89.51887093,521,21,0,500,"St. Bernard, Louisiana, US",47244,464,632,398,234,45,185,230,0,293,8.465923594,4.9774525653,0.9572024164,3.9351654897,4.8923679061,13097
22089,"St. Charles","Louisiana","US","2020-05-24 02:32:43",29.90709658,-90.35555967,622,43,0,579,"St. Charles, Louisiana, US",53100,325,571,446,125,26,179,205,-5,592,8.4250295159,2.3612750885,0.4911452184,3.3813459268,3.8724911452,25838
29183,"St. Charles","Missouri","US","2020-05-24 02:32:43",38.77875681,-90.66662425,730,54,0,676,"St. Charles, Missouri, US",402022,3242,4289,2988,1301,387,1567,1954,-13,5450,7.4625188249,3.2492426343,0.9665310526,3.9135766394,4.880107692,139518
1115,"St. Clair","Alabama","US","2020-05-24 02:32:43",33.71902176,-86.31029372,100,1,0,99,"St. Clair, Alabama, US",89512,858,983,975,8,23,828,851,-1,1582,10.944849186,0.0898038908,0.2581861859,9.294702693,9.5528888789,19600
17163,"St. Clair","Illinois","US","2020-05-24 02:32:43",38.46996033,-89.93063427,939,70,0,869,"St. Clair, Illinois, US",259686,-1674,3095,2723,372,61,-2115,-2054,8,4556,10.452052218,1.4278969611,0.2341443942,-8.118285142,-7.884140748,104407
26147,"St. Clair","Michigan","US","2020-05-24 02:32:43",42.92655373,-82.67937954,429,34,0,395,"St. Clair, Michigan, US",159128,97,1426,1741,-315,22,403,425,-13,1998,10.944213428,-1.980142004,0.1382956321,2.5333245327,2.6716201648,50696
29185,"St. Clair","Missouri","US","2020-05-24 02:32:43",38.03699437,-93.77631447,3,0,0,3,"St. Clair, Missouri, US",9397,8,92,134,-42,-5,56,51,-1,207,14.265942723,-4.471414883,-0.532311296,5.9618865112,5.4295752156,2495
55109,"St. Croix","Wisconsin","US","2020-05-24 02:32:43",45.03437474,-92.45000068,65,0,0,65,"St. Croix, Wisconsin, US",90687,999,992,641,351,29,622,651,-3,742,7.1074151074,3.8918918919,0.3215523216,6.8967428967,7.2182952183,33652
5123,"St. Francis","Arkansas","US","2020-05-24 02:32:43",35.02201976,-90.74828138,628,1,0,627,"St. Francis, Arkansas, US",24994,-515,305,315,-10,2,-508,-506,1,4099,12.474506465,-0.396016078,0.0792032157,-20.11761678,-20.03841356,8980
29187,"St. Francois","Missouri","US","2020-05-24 02:32:43",37.81214171,-90.47598685,33,2,0,31,"St. Francois, Missouri, US",67215,478,693,774,-81,-7,566,559,0,7012,11.556378404,-1.209388438,-0.10451505,8.4507883421,8.3462732919,24877
22091,"St. Helena","Louisiana","US","2020-05-24 02:32:43",30.82210324,-90.71013176,44,1,0,43,"St. Helena, Louisiana, US",10132,-55,99,105,-6,-2,-46,-48,-1,121,10.335154289,-0.590580245,-0.196860082,-4.527781879,-4.724641961,1558
22093,"St. James","Louisiana","US","2020-05-24 02:32:43",30.02531716,-90.80212061,289,24,0,265,"St. James, Louisiana, US",21096,-55,279,226,53,5,-113,-108,0,204,10.698984543,2.5090538973,0.2367031979,-5.349492272,-5.112789074,9203
22095,"St. John the Baptist","Louisiana","US","2020-05-24 02:32:43",30.12597499,-90.4753503,838,77,0,761,"St. John the Baptist, Louisiana, US",42837,-282,534,421,113,15,-413,-398,3,471,9.7957094327,2.6292521755,0.3490157755,-9.609567686,-9.26055191,16801
12109,"St. Johns","Florida","US","2020-05-24 02:32:43",29.90096506,-81.43589967,238,5,0,233,"St. Johns, Florida, US",264672,10858,2216,2105,111,83,10628,10711,36,2966,8.1197949414,0.4281697095,0.3201629359,40.996285338,41.316448274,72596
18141,"St. Joseph","Indiana","US","2020-05-24 02:32:43",41.61756781,-86.29040834,1132,34,0,1098,"St. Joseph, Indiana, US",271826,854,3429,2460,969,802,-914,-112,-3,11613,9.0641454095,3.5703889845,2.955058788,-3.367735327,-0.412676539,123519
26149,"St. Joseph","Michigan","US","2020-05-24 02:32:43",41.91441767,-85.52797979,100,2,0,98,"St. Joseph, Michigan, US",60964,52,726,582,144,22,-113,-91,-1,764,9.5506908661,2.3630575339,0.3610226788,-1.854343759,-1.49332108,23841
22097,"St. Landry","Louisiana","US","2020-05-24 02:32:43",30.59724262,-92.00135806,247,52,0,195,"St. Landry, Louisiana, US",82124,-658,1111,1017,94,6,-756,-750,-2,1106,12.33429954,1.1400434187,0.0727687289,-9.168859835,-9.096091106,23831
36089,"St. Lawrence","New York","US","2020-05-24 02:32:43",44.4976179,-75.06550039,196,2,0,194,"St. Lawrence, New York, US",107740,-587,988,1082,-94,96,-591,-495,2,10603,10.015411886,-0.870100478,0.8886132542,-5.470525346,-4.581912092,41917
27137,"St. Louis","Minnesota","US","2020-05-24 02:32:43",47.6048407,-92.46879855,110,13,0,97,"St. Louis, Minnesota, US",199070,-615,1876,2084,-208,82,-480,-398,-9,8927,10.452533511,-1.043247107,0.4112801093,-2.407493323,-1.996213214,101973
29189,"St. Louis","Missouri","US","2020-05-24 02:32:43",38.6377004,-90.4458375,4472,384,0,4088,"St. Louis, Missouri, US",994205,-1014,11089,10264,825,1722,-3548,-1826,-13,19318,10.318564569,0.8293857921,1.7311543442,-3.566861564,-1.83570722,578492
29510,"St. Louis City","Missouri","US","2020-05-24 02:32:43",38.63555736,-90.24349225,1789,110,0,1679,"St. Louis City, Missouri, US",300576,-2843,3938,3079,859,734,-4414,-3680,-22,11599,10.195448638,2.8443944072,2.4304836961,-14.61601503,-12.18553134,253902
12111,"St. Lucie","Florida","US","2020-05-24 02:32:43",27.37763908,-80.47106649,386,28,0,358,"St. Lucie, Florida, US",328297,7872,3082,3501,-419,603,7656,8259,32,3040,10.793529432,-1.291770589,1.8590397736,23.603330857,25.46237063,86006
22099,"St. Martin","Louisiana","US","2020-05-24 02:32:43",30.13112107,-91.61403569,288,22,0,266,"St. Martin, Louisiana, US",53431,-131,663,537,126,11,-265,-254,-3,701,10.038039872,2.3552942716,0.2056209285,-4.953595095,-4.747974167,14683
22101,"St. Mary","Louisiana","US","2020-05-24 02:32:43",29.69262097,-91.44702164,294,29,0,265,"St. Mary, Louisiana, US",49348,-493,647,557,90,38,-622,-584,1,868,11.231084092,1.8147173578,0.7662139955,-12.54171329,-11.7754993,25166
24037,"St. Mary's","Maryland","US","2020-05-24 02:32:43",38.30058422,-76.6062928,379,14,0,365,"St. Mary's, Maryland, US",113510,790,1319,874,445,60,288,348,-3,2797,7.7266498696,3.9340494187,0.5304336295,2.5460814216,3.0765150511,51274
22103,"St. Tammany","Louisiana","US","2020-05-24 02:32:43",30.40942847,-89.95642711,1609,154,0,1455,"St. Tammany, Louisiana, US",260419,2384,2822,2423,399,105,1894,1999,-14,1277,9.3470201792,1.5391915194,0.4050503998,7.3063376886,7.7113880884,88328
20185,"Stafford","Kansas","US","2020-05-24 02:32:43",38.03100851,-98.71762001,1,0,0,1,"Stafford, Kansas, US",4156,-6,51,49,2,0,-9,-9,1,69,11.781678288,0.4808848281,0,-2.163981726,-2.163981726,1690
51179,"Stafford","Virginia","US","2020-05-24 02:32:43",38.41758738,-77.45917053,569,4,0,565,"Stafford, Virginia, US",152882,3058,1773,813,960,91,2018,2109,-11,3608,5.3715486313,6.3427880518,0.6012434507,13.33306905,13.934312501,42628
6099,"Stanislaus","California","US","2020-05-24 02:32:43",37.55862499,-120.9970722,621,28,0,593,"Stanislaus, California, US",550660,2534,7393,4317,3076,144,-679,-535,-7,6511,7.8577630221,5.5989064295,0.2621074531,-1.235909449,-0.973801996,184403
46117,"Stanley","South Dakota","US","2020-05-24 02:32:43",44.41381872,-100.7349153,9,0,0,9,"Stanley, South Dakota, US",3098,81,37,7,30,0,51,51,0,0,2.2894521668,9.8119378577,0,16.680294358,16.680294358,1264
37167,"Stanly","North Carolina","US","2020-05-24 02:32:43",35.31647813,-80.25093221,42,4,0,38,"Stanly, North Carolina, US",62806,626,709,715,-6,10,623,633,-1,2190,11.441281424,-0.096010753,0.160017922,9.9691165411,10.129134463,20969
20187,"Stanton","Kansas","US","2020-05-24 02:32:43",37.56304714,-101.7843534,9,0,0,9,"Stanton, Kansas, US",2006,-19,29,20,9,12,-42,-30,2,47,9.923096006,4.4653932027,5.9538576036,-20.83850161,-14.88464401,1094
31167,"Stanton","Nebraska","US","2020-05-24 02:32:43",41.9169835,-97.19394708,16,0,0,16,"Stanton, Nebraska, US",5920,-50,68,38,30,3,-84,-81,1,3,6.3919259882,5.0462573591,0.5046257359,-14.12952061,-13.62489487,1926
17175,"Stark","Illinois","US","2020-05-24 02:32:43",41.09309773,-89.79745866,3,0,0,3,"Stark, Illinois, US",5342,-76,57,76,-19,2,-59,-57,0,92,14.126394052,-3.531598513,0.3717472119,-10.96654275,-10.59479554,1638
38089,"Stark","North Dakota","US","2020-05-24 02:32:43",46.80851182,-102.6576326,61,2,0,59,"Stark, North Dakota, US",31489,596,506,234,272,33,293,326,-2,551,7.5021640858,8.7204642365,1.0579974993,9.3937353724,10.451732872,18357
39151,"Stark","Ohio","US","2020-05-24 02:32:43",40.81482476,-81.36437305,670,89,0,581,"Stark, Ohio, US",370606,-642,3985,4092,-107,27,-545,-518,-17,8813,11.031820277,-0.288466464,0.072790603,-1.469291801,-1.396501198,165252
18149,"Starke","Indiana","US","2020-05-24 02:32:43",41.27890281,-86.64686895,30,3,0,27,"Starke, Indiana, US",22995,44,262,284,-22,-2,69,67,-1,16,12.362338397,-0.957645932,-0.087058721,3.0035258782,2.9164671571,5233
48427,"Starr","Texas","US","2020-05-24 02:32:43",26.56150059,-98.73892358,23,0,0,23,"Starr, Texas, US",64633,384,1178,400,778,-10,-387,-397,3,830,6.2072283174,12.073059077,-0.155180708,-6.005493397,-6.160674105,17210
51790,"Staunton","Virginia","US","2020-05-24 02:32:43",38.15965544,-79.05979937,35,0,0,35,"Staunton, Virginia, US",24932,370,338,348,-10,22,356,378,2,992,14.062310583,-0.404089385,0.8889966461,14.385582091,15.274578737,11870
29186,"Ste. Genevieve","Missouri","US","2020-05-24 02:32:43",37.89090059,-90.1949941,8,1,0,7,"Ste. Genevieve, Missouri, US",17894,17,204,199,5,-1,15,14,-2,277,11.126331386,0.279556065,-0.055911213,0.8386681949,0.7827569819,5947
27145,"Stearns","Minnesota","US","2020-05-24 02:32:43",45.55192576,-94.61078221,1918,12,0,1906,"Stearns, Minnesota, US",161075,1419,2039,1044,995,556,-127,429,-5,7231,6.5101284254,6.2045764207,3.4670798894,-0.79194091,2.6751389794,91932
27147,"Steele","Minnesota","US","2020-05-24 02:32:43",44.02240351,-93.22627088,138,0,0,138,"Steele, Minnesota, US",36649,-89,391,308,83,-6,-166,-172,0,594,8.3938572227,2.2619810048,-0.163516699,-4.52396201,-4.687478709,20059
38091,"Steele","North Dakota","US","2020-05-24 02:32:43",47.45611548,-97.72728747,1,0,0,1,"Steele, North Dakota, US",1890,-2,20,6,14,0,-17,-17,1,0,3.1729243786,7.4034902168,0,-8.989952406,-8.989952406,897
13257,"Stephens","Georgia","US","2020-05-24 02:32:43",34.55151201,-83.29405315,123,2,0,121,"Stephens, Georgia, US",25925,-82,317,356,-39,0,-42,-42,-1,567,13.710236463,-1.501964107,0,-1.617499807,-1.617499807,9659
40137,"Stephens","Oklahoma","US","2020-05-24 02:32:43",34.48556989,-97.85141892,37,1,0,36,"Stephens, Oklahoma, US",43143,-36,491,571,-80,22,25,47,-3,541,13.229535924,-1.853525173,0.5097194226,0.5792266166,1.0889460392,18326
48429,"Stephens","Texas","US","2020-05-24 02:32:43",32.73553157,-98.83631615,2,0,0,2,"Stephens, Texas, US",9366,-39,108,98,10,-6,-44,-50,1,673,10.441638698,1.0654733365,-0.639284002,-4.688082681,-5.327366683,3463
17177,"Stephenson","Illinois","US","2020-05-24 02:32:43",42.35129217,-89.662598,176,2,0,174,"Stephenson, Illinois, US",44498,-299,476,547,-71,24,-252,-228,0,836,12.251525841,-1.590234616,0.5375440954,-5.644213002,-5.106668906,20086
18151,"Steuben","Indiana","US","2020-05-24 02:32:43",41.64423868,-85.00101094,76,2,0,74,"Steuben, Indiana, US",34594,107,336,348,-12,15,106,121,-2,1310,10.075129196,-0.347418248,0.4342728102,3.0688611919,3.5031340021,14578
36101,"Steuben","New York","US","2020-05-24 02:32:43",42.2689144,-77.3829924,240,41,0,199,"Steuben, New York, US",95379,-481,981,1022,-41,49,-489,-440,0,1767,10.688196445,-0.428782832,0.5124477748,-5.11401963,-4.601571855,41282
20189,"Stevens","Kansas","US","2020-05-24 02:32:43",37.1923008,-101.3118967,27,0,0,27,"Stevens, Kansas, US",5485,-51,62,32,30,23,-106,-83,2,72,5.8070955449,5.4441520733,4.1738499229,-19.23600399,-15.06215407,2618
53065,"Stevens","Washington","US","2020-05-24 02:32:43",48.40035475,-117.8542701,10,1,0,9,"Stevens, Washington, US",45723,499,434,488,-54,-3,557,554,-1,266,10.731524954,-1.18750481,-0.065972489,12.248892212,12.182919722,11898
13259,"Stewart","Georgia","US","2020-05-24 02:32:43",32.07996777,-84.83208037,42,0,0,42,"Stewart, Georgia, US",6621,186,34,62,-28,170,45,215,-1,1701,9.4975490196,-4.289215686,26.041666667,6.8933823529,32.93504902,1355
47161,"Stewart","Tennessee","US","2020-05-24 02:32:43",36.50235092,-87.83920548,8,0,0,8,"Stewart, Tennessee, US",13715,96,136,174,-38,-7,142,135,-1,142,12.731396795,-2.78041999,-0.51218263,10.389990488,9.8778078583,3331
30095,"Stillwater","Montana","US","2020-05-24 02:32:43",45.67071407,-109.3950061,1,0,0,1,"Stillwater, Montana, US",9642,159,77,82,-5,9,157,166,-2,112,8.5751633987,-0.522875817,0.9411764706,16.418300654,17.359477124,3828
29207,"Stoddard","Missouri","US","2020-05-24 02:32:43",36.85571651,-89.9444155,70,0,0,70,"Stoddard, Missouri, US",29025,-239,328,388,-60,-2,-177,-179,0,690,13.312975004,-2.058707475,-0.068623582,-6.073187051,-6.141810633,10156
37169,"Stokes","North Carolina","US","2020-05-24 02:32:43",36.4017975,-80.23893369,50,0,0,50,"Stokes, North Carolina, US",45591,80,387,556,-169,22,231,253,-4,455,12.206098659,-3.71012711,0.4829751268,5.0712388312,5.554213958,9738
5137,"Stone","Arkansas","US","2020-05-24 02:32:43",35.86251946,-92.15684085,8,0,0,8,"Stone, Arkansas, US",12506,52,111,166,-55,-8,115,107,0,151,13.301282051,-4.407051282,-0.641025641,9.2147435897,8.5737179487,3827
28131,"Stone","Mississippi","US","2020-05-24 02:32:43",30.79187949,-89.11547539,30,0,0,30,"Stone, Mississippi, US",18336,339,204,168,36,-1,302,301,2,1267,9.2477912641,1.9816695566,-0.055046377,16.624005725,16.568959348,5031
29209,"Stone","Missouri","US","2020-05-24 02:32:43",36.75000327,-93.45256475,4,0,0,4,"Stone, Missouri, US",31952,251,253,403,-150,-5,406,401,0,300,12.662403972,-4.713053587,-0.157101786,12.756665043,12.599563257,7647
32029,"Storey","Nevada","US","2020-05-24 02:32:43",39.44875482,-119.5250207,1,0,0,1,"Storey, Nevada, US",4123,142,11,21,-10,-4,155,151,1,5,5.1826258638,-2.467917078,-0.987166831,38.252714709,37.265547878,965
19169,"Story","Iowa","US","2020-05-24 02:32:43",42.03621213,-93.46499005,90,1,0,89,"Story, Iowa, US",97117,336,872,526,346,355,-369,-14,4,10508,5.4255330122,3.5688867343,3.6617190482,-3.80612487,-0.144405822,51767
33017,"Strafford","New Hampshire","US","2020-05-24 02:32:43",43.291833,-71.02336013,253,12,0,241,"Strafford, New Hampshire, US",130633,836,1163,1072,91,259,484,743,2,8802,8.232538494,0.6988442192,1.9890181623,3.7169296932,5.7059478555,54301
38093,"Stutsman","North Dakota","US","2020-05-24 02:32:43",46.97962541,-98.95637318,18,0,0,18,"Stutsman, North Dakota, US",20704,-171,223,214,9,8,-189,-181,1,1646,10.293657856,0.4329108444,0.3848096395,-9.091127733,-8.706318093,11556
56035,"Sublette","Wyoming","US","2020-05-24 02:32:43",42.76558279,-109.9130922,3,0,0,3,"Sublette, Wyoming, US",9831,33,88,80,8,-8,32,24,1,550,8.15120485,0.815120485,-0.815120485,3.26048194,2.445361455,6269
25025,"Suffolk","Massachusetts","US","2020-05-24 02:32:43",42.3279514,-71.07850442,17291,827,0,16464,"Suffolk, Massachusetts, US",803907,760,9219,5210,4009,7805,-11034,-3229,-20,50977,6.483914044,4.9892536281,9.7134259334,-13.73195922,-4.018533291,642267
36103,"Suffolk","New York","US","2020-05-24 02:32:43",40.88320119,-72.8012172,38802,1822,0,36980,"Suffolk, New York, US",1476601,-4229,15129,13146,1983,1603,-7842,-6239,27,29121,8.8901482401,1.341028751,1.0840489601,-5.303251369,-4.219202409,634128
51800,"Suffolk","Virginia","US","2020-05-24 02:32:43",36.70155394,-76.63603554,290,25,0,265,"Suffolk, Virginia, US",92108,1133,1136,845,291,11,827,838,4,996,9.2307860369,3.178886079,0.1201640786,9.0341539083,9.1543179869,31523
18153,"Sullivan","Indiana","US","2020-05-24 02:32:43",39.08952258,-87.41414469,31,1,0,30,"Sullivan, Indiana, US",20669,-27,207,209,-2,-2,-24,-26,1,2260,10.105161368,-0.096700109,-0.096700109,-1.160401305,-1.257101414,6841
29211,"Sullivan","Missouri","US","2020-05-24 02:32:43",40.2099105,-93.11150106,44,0,0,44,"Sullivan, Missouri, US",6089,-144,86,71,15,10,-169,-159,0,108,11.52410323,2.4346696965,1.623113131,-27.43061191,-25.80749878,2893
33019,"Sullivan","New Hampshire","US","2020-05-24 02:32:43",43.36094111,-72.22203125,17,1,0,16,"Sullivan, New Hampshire, US",43146,32,380,432,-52,7,77,84,0,727,10.016230002,-1.205657315,0.1623000232,1.785300255,1.9476002782,14645
36105,"Sullivan","New York","US","2020-05-24 02:32:43",41.71579493,-74.76394559,1297,29,0,1268,"Sullivan, New York, US",75432,33,779,779,0,-2,40,38,-5,3778,10.32944156,0,-0.026519747,0.5303949453,0.5038751981,27134
42113,"Sullivan","Pennsylvania","US","2020-05-24 02:32:43",41.44634738,-76.51246591,2,0,0,2,"Sullivan, Pennsylvania, US",6066,-10,41,97,-56,2,45,47,-1,439,15.977598419,-9.22418053,0.3294350189,7.4122879262,7.7417229451,2157
47163,"Sullivan","Tennessee","US","2020-05-24 02:32:43",36.51240691,-82.30412917,61,2,0,59,"Sullivan, Tennessee, US",158348,749,1517,1967,-450,-18,1220,1202,-3,2811,12.451455466,-2.848579034,-0.113943161,7.7228142695,7.6088711081,73895
46119,"Sully","South Dakota","US","2020-05-24 02:32:43",44.71571812,-100.1278092,1,0,0,1,"Sully, South Dakota, US",1391,14,16,11,5,0,9,9,0,0,7.9479768786,3.612716763,0,6.5028901734,6.5028901734,816
54089,"Summers","West Virginia","US","2020-05-24 02:32:43",37.65390597,-80.86009693,1,0,0,1,"Summers, West Virginia, US",12573,-99,98,155,-57,-1,-39,-40,-2,1030,12.279659338,-4.515745692,-0.079223609,-3.089720737,-3.168944345,2979
8117,"Summit","Colorado","US","2020-05-24 02:32:43",39.63803232,-106.1150762,203,2,0,201,"Summit, Colorado, US",31011,194,266,69,197,101,-105,-4,1,273,2.2319984473,6.3725173061,3.267128162,-3.396519376,-0.129391214,19656
39153,"Summit","Ohio","US","2020-05-24 02:32:43",41.12464734,-81.53123079,1204,159,0,1045,"Summit, Ohio, US",541013,-340,5840,5734,106,533,-961,-428,-18,10351,10.595306948,0.195867202,0.9848794216,-1.775739445,-0.790860023,272508
49043,"Summit","Utah","US","2020-05-24 02:32:43",40.86688146,-110.9535882,403,0,0,403,"Summit, Utah, US",42145,255,416,159,257,131,-133,-2,0,115,3.7841375617,6.1164990778,3.1177485571,-3.165347772,-0.047599215,24458
20191,"Sumner","Kansas","US","2020-05-24 02:32:43",37.23682549,-97.47721621,6,1,0,5,"Sumner, Kansas, US",22836,-183,249,252,-3,9,-189,-180,0,409,10.991167812,-0.130847236,0.3925417076,-8.243375859,-7.850834151,7846
47165,"Sumner","Tennessee","US","2020-05-24 02:32:43",36.46824103,-86.45917204,809,45,0,764,"Sumner, Tennessee, US",191283,3793,2173,1701,472,141,3175,3316,5,1525,8.9816327985,2.4922578959,0.7445092443,16.764658516,17.50916776,56173
1119,"Sumter","Alabama","US","2020-05-24 02:32:43",32.59117397,-88.19916205,185,6,0,179,"Sumter, Alabama, US",12427,-207,136,163,-27,27,-207,-180,0,916,13.008259846,-2.154742428,2.1547424285,-16.51969195,-14.36494952,3705
12119,"Sumter","Florida","US","2020-05-24 02:32:43",28.70181754,-82.0794267,253,17,0,236,"Sumter, Florida, US",132420,3701,478,2017,-1539,-57,5269,5212,28,8271,15.447711755,-11.78682617,-0.436549118,40.353987723,39.917438605,25659
13261,"Sumter","Georgia","US","2020-05-24 02:32:43",32.03650571,-84.19821492,439,40,0,399,"Sumter, Georgia, US",29524,-272,377,339,38,27,-340,-313,3,1685,11.429534727,1.2811867835,0.9103169252,-11.46325017,-10.55293324,12024
45085,"Sumter","South Carolina","US","2020-05-24 02:32:43",33.91826534,-80.37942316,344,17,0,327,"Sumter, South Carolina, US",106721,312,1343,1075,268,89,-40,49,-5,2536,10.087739877,2.5148970112,0.8351710224,-0.375357763,0.4598132595,43836
28133,"Sunflower","Mississippi","US","2020-05-24 02:32:43",33.60192578,-90.58882684,77,3,0,74,"Sunflower, Mississippi, US",25110,-1101,275,307,-32,3,-1081,-1078,9,4042,11.963913408,-1.247052863,0.1169112059,-42.12700454,-42.01009333,7844
37171,"Surry","North Carolina","US","2020-05-24 02:32:43",36.41689489,-80.69102283,151,1,0,150,"Surry, North Carolina, US",71783,-176,736,874,-138,40,-72,-32,-6,812,12.160676768,-1.920106858,0.5565527125,-1.001794882,-0.44524217,29623
51181,"Surry","Virginia","US","2020-05-24 02:32:43",37.11781893,-76.88450012,6,1,0,5,"Surry, Virginia, US",6422,-41,56,68,-12,0,-30,-30,1,0,10.554908809,-1.862630966,0,-4.656577416,-4.656577416,2511
42115,"Susquehanna","Pennsylvania","US","2020-05-24 02:32:43",41.82147784,-75.80071959,95,15,0,80,"Susquehanna, Pennsylvania, US",40328,-232,352,472,-120,1,-111,-110,-2,282,11.670457917,-2.967065572,0.0247255464,-2.744535654,-2.719810108,12725
10005,"Sussex","Delaware","US","2020-05-24 02:32:43",38.66143781,-75.39031349,4048,119,0,3929,"Sussex, Delaware, US",234225,4836,2288,2781,-493,-58,5350,5292,37,2846,11.997049269,-2.126769252,-0.250208147,23.079544621,22.829336474,80650
34037,"Sussex","New Jersey","US","2020-05-24 02:32:43",41.13891592,-74.69118243,1079,145,0,934,"Sussex, New Jersey, US",140488,-313,1207,1266,-59,-5,-245,-250,-4,1664,9.00141847,-0.419497385,-0.035550626,-1.741980668,-1.777531293,44030
51183,"Sussex","Virginia","US","2020-05-24 02:32:43",36.92432914,-77.25791182,114,1,0,113,"Sussex, Virginia, US",11159,-82,86,129,-43,2,-41,-39,0,2599,11.517857143,-3.839285714,0.1785714286,-3.660714286,-3.482142857,3304
6101,"Sutter","California","US","2020-05-24 02:32:43",39.03417539,-121.6945899,40,2,0,38,"Sutter, California, US",96971,623,1267,834,433,100,95,195,-5,731,8.6282258857,4.4796424563,1.0345594587,0.9828314858,2.0173909445,30113
12121,"Suwannee","Florida","US","2020-05-24 02:32:43",30.19746066,-82.9909967,164,18,0,146,"Suwannee, Florida, US",44417,238,444,561,-117,-5,361,356,-1,2509,12.664228633,-2.641202763,-0.112871913,8.1493521152,8.0364802023,13030
37173,"Swain","North Carolina","US","2020-05-24 02:32:43",35.48665845,-83.48748932,10,0,0,10,"Swain, North Carolina, US",14271,22,143,221,-78,-3,103,100,0,246,15.497896213,-5.469845722,-0.210378682,7.2230014025,7.0126227209,6189
56037,"Sweetwater","Wyoming","US","2020-05-24 02:32:43",41.65943896,-108.8827882,25,0,0,25,"Sweetwater, Wyoming, US",42343,-515,506,298,208,23,-750,-727,4,627,6.9952230608,4.8825718008,0.5398997664,-17.60542717,-17.0655274,24690
27151,"Swift","Minnesota","US","2020-05-24 02:32:43",45.2829032,-95.68264092,15,0,0,15,"Swift, Minnesota, US",9266,-57,112,98,14,4,-74,-70,-1,150,10.543870031,1.5062671472,0.4303620421,-7.961697778,-7.531335736,4568
48437,"Swisher","Texas","US","2020-05-24 02:32:43",34.53028891,-101.7349174,15,0,0,15,"Swisher, Texas, US",7397,-16,80,66,14,-2,-27,-29,-1,642,8.9128966914,1.8906144497,-0.270087779,-3.64618501,-3.916272789,2098
18155,"Switzerland","Indiana","US","2020-05-24 02:32:43",38.82767338,-85.03022429,19,0,0,19,"Switzerland, Indiana, US",10751,20,110,109,1,13,7,20,-1,107,10.14803091,0.093101201,1.2103156131,0.651708407,1.8620240201,2454
13263,"Talbot","Georgia","US","2020-05-24 02:32:43",32.69642758,-84.53351366,34,1,0,33,"Talbot, Georgia, US",6195,-95,63,91,-28,0,-67,-67,0,0,14.577492992,-4.485382459,0,-10.73287946,-10.73287946,700
24041,"Talbot","Maryland","US","2020-05-24 02:32:43",38.76618159,-76.10882561,77,1,0,76,"Talbot, Maryland, US",37181,107,338,478,-140,9,242,251,-4,373,12.874553902,-3.770789846,0.2424079187,6.5180795906,6.7604875093,21338
13265,"Taliaferro","Georgia","US","2020-05-24 02:32:43",33.56543317,-82.88136816,1,0,0,1,"Taliaferro, Georgia, US",1537,-75,13,27,-14,1,-62,-61,0,7,17.148301048,-8.891711654,0.635122261,-39.37758018,-38.74245792,304
1121,"Talladega","Alabama","US","2020-05-24 02:32:43",33.37823223,-86.16886178,86,2,0,84,"Talladega, Alabama, US",79978,-159,844,1044,-200,32,14,46,-5,3095,13.040627049,-2.498204416,0.3997127065,0.1748743091,0.5745870156,29446
28135,"Tallahatchie","Mississippi","US","2020-05-24 02:32:43",33.95339918,-90.1729398,23,1,0,22,"Tallahatchie, Mississippi, US",13809,-152,162,162,0,-7,-144,-151,-1,2426,11.667266835,0,-0.50414116,-10.37090385,-10.87504501,3194
1123,"Tallapoosa","Alabama","US","2020-05-24 02:32:43",32.86698258,-85.79833053,392,62,0,330,"Tallapoosa, Alabama, US",40367,-168,385,534,-149,2,-18,-16,-3,576,13.201156955,-3.683468888,0.0494425354,-0.444982819,-0.395540283,13797
19171,"Tama","Iowa","US","2020-05-24 02:32:43",42.07991767,-92.53266945,390,23,0,367,"Tama, Iowa, US",16854,-15,219,193,26,3,-42,-39,-2,292,11.446193992,1.5419743202,0.1779201139,-2.490881594,-2.31296148,5764
29213,"Taney","Missouri","US","2020-05-24 02:32:43",36.65465345,-93.04075153,14,2,0,12,"Taney, Missouri, US",55928,209,615,555,60,7,145,152,-3,1755,9.9420494953,1.0748161617,0.1253952189,2.5974723907,2.7228676095,27064
22105,"Tangipahoa","Louisiana","US","2020-05-24 02:32:43",30.62888673,-90.40664996,767,31,0,736,"Tangipahoa, Louisiana, US",134758,921,1953,1383,570,1,350,351,0,3645,10.298032354,4.2443083453,0.007446155,2.6061542471,2.6136004021,43272
35055,"Taos","New Mexico","US","2020-05-24 02:32:43",36.58006022,-105.6310198,22,0,0,22,"Taos, New Mexico, US",32723,24,271,317,-46,-14,86,72,-2,470,9.6909296567,-1.406254777,-0.427990584,2.6290850173,2.2010944331,13931
48439,"Tarrant","Texas","US","2020-05-24 02:32:43",32.77143818,-97.29101614,4899,132,0,4767,"Tarrant, Texas, US",2102515,21069,27512,13796,13716,4856,2546,7402,-49,25670,6.5947077423,6.556466468,2.3212453462,1.2170285526,3.5382738988,904159
28137,"Tate","Mississippi","US","2020-05-24 02:32:43",34.65133709,-89.94485778,58,1,0,57,"Tate, Mississippi, US",28321,-26,347,320,27,-6,-45,-51,-2,1100,11.293851909,0.9529187549,-0.211759723,-1.588197925,-1.799957648,6804
13267,"Tattnall","Georgia","US","2020-05-24 02:32:43",32.04785085,-82.05539188,14,0,0,14,"Tattnall, Georgia, US",25286,-199,254,245,9,32,-242,-210,2,4452,9.6511788226,0.3545330996,1.2605621319,-9.533001123,-8.272438991,5860
12123,"Taylor","Florida","US","2020-05-24 02:32:43",30.04848048,-83.60445406,11,0,0,11,"Taylor, Florida, US",21569,24,216,258,-42,4,62,66,0,2430,11.968270167,-1.948323051,0.1855545762,2.8760959317,3.061650508,7394
13269,"Taylor","Georgia","US","2020-05-24 02:32:43",32.55792548,-84.25077141,21,2,0,19,"Taylor, Georgia, US",8020,0,86,83,3,0,-2,-2,-1,148,10.349127182,0.3740648379,0,-0.249376559,-0.249376559,2053
19173,"Taylor","Iowa","US","2020-05-24 02:32:43",40.73710579,-94.69778563,10,0,0,10,"Taylor, Iowa, US",6121,-39,70,62,8,1,-48,-47,0,54,10.096897647,1.3028255028,0.1628531879,-7.816953017,-7.654099829,2241
21217,"Taylor","Kentucky","US","2020-05-24 02:32:43",37.3677562,-85.3329931,11,0,0,11,"Taylor, Kentucky, US",25769,255,324,302,22,7,227,234,-1,1338,11.777782111,0.8579841273,0.2729949496,8.8528362225,9.1258311721,11662
48441,"Taylor","Texas","US","2020-05-24 02:32:43",32.30163422,-99.89007449,228,5,0,223,"Taylor, Texas, US",138034,740,2062,1423,639,214,-107,107,-6,4893,10.336761971,4.6417364017,1.5545095305,-0.777254765,0.7772547652,65998
54091,"Taylor","West Virginia","US","2020-05-24 02:32:43",39.33602617,-80.0421439,8,0,0,8,"Taylor, West Virginia, US",16695,-133,129,199,-70,-2,-60,-62,-1,509,11.872445783,-4.17623721,-0.119321063,-3.579631895,-3.698952958,3415
55119,"Taylor","Wisconsin","US","2020-05-24 02:32:43",45.21179252,-90.5004405,1,0,0,1,"Taylor, Wisconsin, US",20343,-21,210,188,22,10,-55,-45,2,203,9.2367406097,1.0808951777,0.4913159899,-2.702237944,-2.210921954,9351
17179,"Tazewell","Illinois","US","2020-05-24 02:32:43",40.50716185,-89.51404662,67,3,0,64,"Tazewell, Illinois, US",131803,-647,1375,1444,-69,67,-644,-577,-1,2567,10.928920391,-0.522226805,0.5070897965,-4.87411685,-4.367027054,56378
51185,"Tazewell","Virginia","US","2020-05-24 02:32:43",37.12191123,-81.56685568,6,0,0,6,"Tazewell, Virginia, US",40595,-463,408,621,-213,-9,-240,-249,-1,1763,15.210708731,-5.217199613,-0.220445054,-5.878534775,-6.098979829,16859
6103,"Tehama","California","US","2020-05-24 02:32:43",40.12570935,-122.2370171,3,1,0,2,"Tehama, California, US",65084,1066,739,661,78,-29,1014,985,3,844,10.239965299,1.2083468885,-0.449257176,15.708509551,15.259252374,19170
13271,"Telfair","Georgia","US","2020-05-24 02:32:43",31.92829517,-82.93491155,32,1,0,31,"Telfair, Georgia, US",15860,-114,137,156,-19,50,-146,-96,1,3143,9.8008418672,-1.193692279,3.1412954703,-9.172582773,-6.031287303,4925
8119,"Teller","Colorado","US","2020-05-24 02:32:43",38.88133511,-105.1614893,32,2,0,30,"Teller, Colorado, US",25388,275,176,198,-22,-3,300,297,0,132,7.8414288826,-0.871269876,-0.118809529,11.880952852,11.762143324,8663
22107,"Tensas","Louisiana","US","2020-05-24 02:32:43",32.00760749,-91.32915234,10,0,0,10,"Tensas, Louisiana, US",4334,-136,47,56,-9,0,-128,-128,1,16,12.721490232,-2.044525216,0,-29.07769196,-29.07769196,1501
22109,"Terrebonne","Louisiana","US","2020-05-24 02:32:43",29.37343766,-90.82626855,623,45,0,578,"Terrebonne, Louisiana, US",110461,-702,1475,1125,350,-1,-1052,-1053,1,1478,10.152330073,3.1585026892,-0.009024293,-9.493556655,-9.502580948,57887
13273,"Terrell","Georgia","US","2020-05-24 02:32:43",31.77527543,-84.44069698,211,26,0,185,"Terrell, Georgia, US",8531,-56,98,115,-17,0,-38,-38,-1,268,13.436149083,-1.986213343,0,-4.439771001,-4.439771001,2305
48445,"Terry","Texas","US","2020-05-24 02:32:43",33.17402785,-102.3354521,13,0,0,13,"Terry, Texas, US",12337,-7,181,119,62,-2,-67,-69,0,1028,9.6430452575,5.0241076131,-0.162067988,-5.429277582,-5.591345569,4478
16081,"Teton","Idaho","US","2020-05-24 02:32:43",43.75303583,-111.2056773,11,0,0,11,"Teton, Idaho, US",12142,491,135,43,92,15,380,395,4,7,3.6145084689,7.7333669567,1.2608750473,31.942167864,33.203042912,3445
56039,"Teton","Wyoming","US","2020-05-24 02:32:43",43.93522482,-110.5890801,100,0,0,100,"Teton, Wyoming, US",23464,195,228,75,153,79,-37,42,0,269,3.2097233218,6.5478355766,3.3809085657,-1.583463505,1.7974450602,17393
29215,"Texas","Missouri","US","2020-05-24 02:32:43",37.31728859,-91.96564727,0,0,0,0,"Texas, Missouri, US",25398,-108,268,290,-22,-11,-75,-86,0,1891,11.393996543,-0.864372152,-0.432186076,-2.946723244,-3.37890932,7801
40139,"Texas","Oklahoma","US","2020-05-24 02:32:43",36.74777635,-101.4889765,855,5,0,850,"Texas, Oklahoma, US",19983,-508,350,149,201,61,-775,-714,5,574,7.362751396,9.9323022187,3.0142807728,-38.29619015,-35.28190937,10192
31169,"Thayer","Nebraska","US","2020-05-24 02:32:43",40.17626377,-97.59504381,0,0,0,0,"Thayer, Nebraska, US",5003,-36,47,73,-26,2,-12,-10,0,89,14.538936467,-5.178251344,0.3983270265,-2.389962159,-1.991635132,2685
13275,"Thomas","Georgia","US","2020-05-24 02:32:43",30.86392347,-83.91847289,309,31,0,278,"Thomas, Georgia, US",44451,117,531,516,15,18,87,105,-3,662,11.623585065,0.3378949147,0.4054738976,1.9597905052,2.3652644028,18605
31171,"Thomas","Nebraska","US","2020-05-24 02:32:43",41.91358968,-100.5556632,1,0,0,1,"Thomas, Nebraska, US",722,8,6,0,6,0,3,3,-1,2,0,8.356545961,0,4.1782729805,4.1782729805,373
31173,"Thurston","Nebraska","US","2020-05-24 02:32:43",42.15725356,-96.54157099,24,0,0,24,"Thurston, Nebraska, US",7224,-50,152,83,69,1,-120,-119,0,51,11.449855152,9.5185542833,0.1379500621,-16.55400745,-16.41605739,2879
53067,"Thurston","Washington","US","2020-05-24 02:32:43",46.9291895,-122.8290656,124,1,0,123,"Thurston, Washington, US",290536,4480,3135,2377,758,362,3351,3713,9,3960,8.2449981963,2.6292421678,1.2556539113,11.623470322,12.879124233,107347
13277,"Tift","Georgia","US","2020-05-24 02:32:43",31.45743864,-83.5236119,213,14,0,199,"Tift, Georgia, US",40644,102,554,419,135,-4,-30,-34,1,1587,10.321976695,3.3256965487,-0.098539157,-0.739043677,-0.837582834,20841
41057,"Tillamook","Oregon","US","2020-05-24 02:32:43",45.46248721,-123.712066,6,0,0,6,"Tillamook, Oregon, US",27036,326,230,303,-73,-13,412,399,0,481,11.275257694,-2.716481227,-0.483756931,15.331373498,14.847616567,9502
40141,"Tillman","Oklahoma","US","2020-05-24 02:32:43",34.37288446,-98.92426619,22,1,0,21,"Tillman, Oklahoma, US",7250,-73,75,78,-3,16,-86,-70,0,267,10.704727921,-0.411720305,2.1958416249,-11.80264873,-9.606807109,2417
36107,"Tioga","New York","US","2020-05-24 02:32:43",42.16852837,-76.30835812,121,21,0,100,"Tioga, New York, US",48203,-238,425,492,-67,-9,-161,-170,-1,493,10.181697777,-1.386532014,-0.186250569,-3.331815736,-3.518066305,15028
42117,"Tioga","Pennsylvania","US","2020-05-24 02:32:43",41.77255149,-77.25433032,16,2,0,14,"Tioga, Pennsylvania, US",40591,-99,402,481,-79,8,-24,-16,-4,1240,11.835484308,-1.943873722,0.1968479719,-0.590543916,-0.393695944,17242
28139,"Tippah","Mississippi","US","2020-05-24 02:32:43",34.76872156,-88.90988194,69,11,0,58,"Tippah, Mississippi, US",22015,-24,262,243,19,0,-44,-44,1,333,11.031915377,0.8625777455,0,-1.997548463,-1.997548463,6931
18157,"Tippecanoe","Indiana","US","2020-05-24 02:32:43",40.38872739,-86.89413959,356,3,0,353,"Tippecanoe, Indiana, US",195732,1915,2196,1204,992,2070,-1159,911,12,16553,6.1815073328,5.0930691646,10.627674567,-5.950470929,4.6772036381,95547
18159,"Tipton","Indiana","US","2020-05-24 02:32:43",40.31123252,-86.05234925,22,1,0,21,"Tipton, Indiana, US",15148,36,144,157,-13,7,43,50,-1,205,10.376734964,-0.859220093,0.4626569729,2.8420356907,3.3046926636,5768
47167,"Tipton","Tennessee","US","2020-05-24 02:32:43",35.501942,-89.73694895,426,2,0,424,"Tipton, Tennessee, US",61599,23,660,605,55,1,-30,-29,-3,1044,9.8234219606,0.8930383601,0.0162370611,-0.487111833,-0.470874772,12676
28141,"Tishomingo","Mississippi","US","2020-05-24 02:32:43",34.74023475,-88.23917219,23,0,0,23,"Tishomingo, Mississippi, US",19383,0,195,283,-88,3,86,89,-1,283,14.600423051,-4.540060878,0.1547748027,4.4368776763,4.591652479,5995
48449,"Titus","Texas","US","2020-05-24 02:32:43",33.21339719,-94.96797273,248,2,0,246,"Titus, Texas, US",32750,7,473,264,209,-23,-181,-204,2,451,8.0619302826,6.3823614737,-0.702365138,-5.527308262,-6.2296734,16416
21219,"Todd","Kentucky","US","2020-05-24 02:32:43",36.8381152,-87.17878374,16,0,0,16,"Todd, Kentucky, US",12294,-12,170,126,44,5,-62,-57,1,195,10.243902439,3.5772357724,0.406504065,-5.040650407,-4.634146341,2709
27153,"Todd","Minnesota","US","2020-05-24 02:32:43",46.06996226,-94.89785296,183,0,0,183,"Todd, Minnesota, US",24664,94,321,204,117,-6,-16,-22,-1,346,8.2869561685,4.7528130966,-0.243734005,-0.649957347,-0.893691352,8265
46121,"Todd","South Dakota","US","2020-05-24 02:32:43",43.19338568,-100.7195503,17,0,0,17,"Todd, South Dakota, US",10177,-68,238,131,107,10,-186,-176,1,28,12.829301733,10.478895309,0.9793360102,-18.21564979,-17.23631378,3029
9013,"Tolland","Connecticut","US","2020-05-24 02:32:43",41.85853803,-72.3308481,799,55,0,744,"Tolland, Connecticut, US",150721,32,1134,1048,86,449,-503,-54,0,14695,6.9539829468,0.5706512724,2.9793304801,-3.337646395,-0.358315915,49664
48451,"Tom Green","Texas","US","2020-05-24 02:32:43",31.40464436,-100.462443,90,1,0,89,"Tom Green, Texas, US",119200,1186,1498,1071,427,-46,802,756,3,5211,9.0298211741,3.6001247818,-0.387835457,6.7618268736,6.373991417,54034
36109,"Tompkins","New York","US","2020-05-24 02:32:43",42.44945765,-76.47229843,149,0,0,149,"Tompkins, New York, US",102180,-239,742,636,106,447,-797,-350,5,12985,6.217039184,1.0361731973,4.3695228227,-7.790849418,-3.421326595,59385
49045,"Tooele","Utah","US","2020-05-24 02:32:43",40.44862644,-113.1295715,112,0,0,112,"Tooele, Utah, US",72259,2270,1025,353,672,75,1523,1598,0,318,4.9631629267,9.4482874979,1.0544963725,21.413306338,22.467802711,16853
30101,"Toole","Montana","US","2020-05-24 02:32:43",48.65577551,-111.6942414,29,6,0,23,"Toole, Montana, US",4736,-99,63,44,19,-4,-115,-119,1,669,9.1944415422,3.9703270296,-0.835858322,-24.03092676,-24.86678508,2475
13279,"Toombs","Georgia","US","2020-05-24 02:32:43",32.12059861,-82.32957247,50,4,0,46,"Toombs, Georgia, US",26830,-72,372,308,64,-17,-118,-135,-1,390,11.464304325,2.3821931065,-0.632770044,-4.39216854,-5.024938584,12657
35057,"Torrance","New Mexico","US","2020-05-24 02:32:43",34.64048375,-105.8508949,19,1,0,18,"Torrance, New Mexico, US",15461,-51,153,150,3,23,-76,-53,-1,611,9.6858554225,0.1937171084,1.4851644981,-4.907500081,-3.422335583,3809
13281,"Towns","Georgia","US","2020-05-24 02:32:43",34.91369188,-83.7410746,22,1,0,21,"Towns, Georgia, US",12037,171,94,181,-87,4,253,257,1,1166,15.144542526,-7.279420993,0.3346860227,21.168890934,21.503576957,3550
38097,"Traill","North Dakota","US","2020-05-24 02:32:43",47.45367788,-97.16323288,20,0,0,20,"Traill, North Dakota, US",8036,16,87,83,4,4,8,12,0,305,10.33881415,0.4982561036,0.4982561036,0.9965122073,1.4947683109,3696
37175,"Transylvania","North Carolina","US","2020-05-24 02:32:43",35.20383864,-82.79638423,11,0,0,11,"Transylvania, North Carolina, US",34385,212,261,394,-133,-3,349,346,-1,1052,11.493917559,-3.879926486,-0.087517139,10.181160477,10.093643338,11772
27155,"Traverse","Minnesota","US","2020-05-24 02:32:43",45.77298854,-96.47062949,3,0,0,3,"Traverse, Minnesota, US",3259,-32,37,38,-1,1,-34,-33,2,100,11.603053435,-0.305343511,0.3053435115,-10.38167939,-10.07633588,1482
48453,"Travis","Texas","US","2020-05-24 02:32:43",30.33432034,-97.7853562,2761,82,0,2679,"Travis, Texas, US",1273954,27382,15147,6196,8951,4296,13964,18260,171,23055,4.9164341094,7.102485751,3.4088122876,11.080226905,14.489039193,697487
20195,"Trego","Kansas","US","2020-05-24 02:32:43",38.91467218,-99.87284448,1,0,0,1,"Trego, Kansas, US",2803,6,19,41,-22,2,26,28,0,64,14.642857143,-7.857142857,0.7142857143,9.2857142857,10,1474
55121,"Trempealeau","Wisconsin","US","2020-05-24 02:32:43",44.30360275,-91.35893614,14,0,0,14,"Trempealeau, Wisconsin, US",29649,155,425,253,172,55,-71,-16,-1,448,8.55553489,5.8164110715,1.8598988891,-2.400960384,-0.541061495,14766
13283,"Treutlen","Georgia","US","2020-05-24 02:32:43",32.40422134,-82.56904553,8,0,0,8,"Treutlen, Georgia, US",6901,88,71,74,-3,6,85,91,0,498,10.791891498,-0.437509115,0.8750182295,12.396091585,13.271109815,1536
21221,"Trigg","Kentucky","US","2020-05-24 02:32:43",36.80767017,-87.87333656,9,0,0,9,"Trigg, Kentucky, US",14651,-7,153,163,-10,-1,4,3,0,78,11.122863284,-0.682384251,-0.068238425,0.2729537002,0.2047152752,4023
21223,"Trimble","Kentucky","US","2020-05-24 02:32:43",38.61056487,-85.33775972,5,0,0,5,"Trimble, Kentucky, US",8471,3,82,94,-12,-1,16,15,0,41,11.09864809,-1.416848692,-0.118070724,1.8891315898,1.7710608655,1581
6105,"Trinity","California","US","2020-05-24 02:32:43",40.6491767,-123.114713,1,0,0,1,"Trinity, California, US",12285,-282,118,161,-43,-1,-239,-240,1,385,12.956703686,-3.460486078,-0.08047642,-19.23386448,-19.3143409,4971
48455,"Trinity","Texas","US","2020-05-24 02:32:43",31.0879489,-95.1367187,11,0,0,11,"Trinity, Texas, US",14651,-37,139,232,-93,9,48,57,-1,142,15.815126623,-6.339684379,0.6135178431,3.2720951634,3.8856130066,3150
46123,"Tripp","South Dakota","US","2020-05-24 02:32:43",43.34459388,-99.8854891,6,0,0,6,"Tripp, South Dakota, US",5441,-50,86,56,30,-1,-80,-81,1,131,10.245151848,5.4884742042,-0.18294914,-14.63593121,-14.81888035,2739
13285,"Troup","Georgia","US","2020-05-24 02:32:43",33.03349196,-85.02812115,245,9,0,236,"Troup, Georgia, US",69922,-156,886,763,123,94,-377,-283,4,2159,10.9,1.7571428571,1.3428571429,-5.385714286,-4.042857143,37070
47169,"Trousdale","Tennessee","US","2020-05-24 02:32:43",36.39026213,-86.16087954,1390,4,0,1386,"Trousdale, Tennessee, US",11284,251,111,95,16,0,234,234,1,2616,8.5136891159,1.4338844827,0,20.970560559,20.970560559,1998
39155,"Trumbull","Ohio","US","2020-05-24 02:32:43",41.31735028,-80.76109643,514,42,0,472,"Trumbull, Ohio, US",197974,-565,2039,2477,-438,-17,-98,-115,-12,3807,12.49391571,-2.209259217,-0.085747504,-0.49430914,-0.580056644,78056
54093,"Tucker","West Virginia","US","2020-05-24 02:32:43",39.11240885,-79.57053576,4,0,0,4,"Tucker, West Virginia, US",6839,-98,60,128,-68,0,-28,-28,-2,180,18.583042973,-9.87224158,0,-4.06504065,-4.06504065,2756
6107,"Tulare","California","US","2020-05-24 02:32:43",36.22026558,-118.8020203,1641,75,0,1566,"Tulare, California, US",466195,1606,7032,3209,3823,-270,-1960,-2230,13,4932,6.8952624884,8.2145803967,-0.580156083,-4.211503421,-4.791659504,156043
40143,"Tulsa","Oklahoma","US","2020-05-24 02:32:43",36.11939621,-95.94013939,903,44,0,859,"Tulsa, Oklahoma, US",651552,3869,8762,6147,2615,1127,150,1277,-23,9856,9.4624913892,4.0254457431,1.7348670564,0.2309051095,1.9657721659,359460
28143,"Tunica","Mississippi","US","2020-05-24 02:32:43",34.64967704,-90.37481167,48,2,0,46,"Tunica, Mississippi, US",9632,-290,169,102,67,3,-362,-359,2,104,10.432648052,6.8528178378,0.3068425898,-37.0256725,-36.71882991,9876
6109,"Tuolumne","California","US","2020-05-24 02:32:43",38.02644018,-119.9525093,2,0,0,2,"Tuolumne, California, US",54478,91,466,621,-155,20,232,252,-6,3523,11.408625362,-2.847563496,0.3674275479,4.2621595554,4.6295871033,18971
13287,"Turner","Georgia","US","2020-05-24 02:32:43",31.71612656,-83.62069378,96,12,0,84,"Turner, Georgia, US",7985,77,111,92,19,0,59,59,-1,392,11.577424023,2.3909897439,0,7.4246523627,7.4246523627,2211
46125,"Turner","South Dakota","US","2020-05-24 02:32:43",43.3109081,-97.14865776,22,0,0,22,"Turner, South Dakota, US",8384,-38,102,91,11,1,-50,-49,0,153,10.829465667,1.3090562894,0.1190051172,-5.950255861,-5.831250744,2569
1125,"Tuscaloosa","Alabama","US","2020-05-24 02:32:43",33.28726072,-87.52556818,479,11,0,468,"Tuscaloosa, Alabama, US",209355,1036,2431,1872,559,221,261,482,-5,9954,8.9639288057,2.6767287406,1.0582415951,1.2497785354,2.3080201305,94108
39157,"Tuscarawas","Ohio","US","2020-05-24 02:32:43",40.44214695,-81.47226262,306,2,0,304,"Tuscarawas, Ohio, US",91987,-92,1098,1048,50,26,-163,-137,-5,1251,11.387219802,0.5432833875,0.2825073615,-1.771103843,-1.488596482,36751
26157,"Tuscola","Michigan","US","2020-05-24 02:32:43",43.46606813,-83.41897025,183,23,0,160,"Tuscola, Michigan, US",52245,-388,536,650,-114,7,-281,-274,0,1078,12.395354602,-2.1739545,0.1334884342,-5.358607144,-5.225118709,14659
13289,"Twiggs","Georgia","US","2020-05-24 02:32:43",32.67435595,-83.43078662,13,0,0,13,"Twiggs, Georgia, US",8120,-54,72,141,-69,14,2,16,-1,106,17.306984166,-8.46937523,1.7184239597,0.2454891371,1.9639130968,1659
16083,"Twin Falls","Idaho","US","2020-05-24 02:32:43",42.35440512,-114.6685381,374,19,0,355,"Twin Falls, Idaho, US",86878,849,1195,778,417,65,369,434,-2,964,8.9990572967,4.8234021757,0.75184926,4.2681904145,5.0200396745,36268
48457,"Tyler","Texas","US","2020-05-24 02:32:43",30.77031716,-94.37690895,10,0,0,10,"Tyler, Texas, US",21672,63,187,268,-81,0,145,145,-1,2421,12.384187057,-3.742981909,0,6.7003997135,6.7003997135,5161
54095,"Tyler","West Virginia","US","2020-05-24 02:32:43",39.46811972,-80.88772676,3,0,0,3,"Tyler, West Virginia, US",8591,-149,74,108,-34,-2,-113,-115,0,67,12.463216202,-3.923605101,-0.2308003,-13.04021695,-13.27101725,2422
37177,"Tyrrell","North Carolina","US","2020-05-24 02:32:43",35.87147226,-76.17055253,4,0,0,4,"Tyrrell, North Carolina, US",4016,-99,31,48,-17,0,-83,-83,1,622,11.806665847,-4.181527487,0,-20.41569303,-20.41569303,1411
56041,"Uinta","Wyoming","US","2020-05-24 02:32:43",41.2878183,-110.5475782,12,0,0,12,"Uinta, Wyoming, US",20226,-66,255,136,119,0,-186,-186,1,231,6.7130657979,5.8739325732,0,-9.181104694,-9.181104694,8922
36111,"Ulster","New York","US","2020-05-24 02:32:43",41.89027881,-74.26252104,1606,72,0,1534,"Ulster, New York, US",177573,-845,1433,1743,-310,148,-677,-529,-6,11625,9.7923823917,-1.741617063,0.8314816948,-3.803466942,-2.971985247,68022
41059,"Umatilla","Oregon","US","2020-05-24 02:32:43",45.59073056,-118.7353826,110,3,0,107,"Umatilla, Oregon, US",77950,529,949,665,284,38,211,249,-4,4154,8.5601560137,3.6557658765,0.4891517722,2.7160795773,3.2052313495,30247
47171,"Unicoi","Tennessee","US","2020-05-24 02:32:43",36.10890856,-82.43709629,3,0,0,3,"Unicoi, Tennessee, US",17883,61,173,281,-108,12,157,169,0,452,15.740092424,-6.049572889,0.6721747654,8.7942865145,9.4664612799,5832
5139,"Union","Arkansas","US","2020-05-24 02:32:43",33.16887091,-92.59746952,152,5,0,147,"Union, Arkansas, US",38682,-457,480,550,-70,-1,-386,-387,0,524,14.13500212,-1.79900027,-0.025700004,-9.920201488,-9.945901492,18418
12125,"Union","Florida","US","2020-05-24 02:32:43",30.04412971,-82.37497443,29,0,0,29,"Union, Florida, US",15237,-91,149,224,-75,0,-16,-16,0,4810,14.657287747,-4.907574023,0,-1.046949125,-1.046949125,4574
13291,"Union","Georgia","US","2020-05-24 02:32:43",34.82995757,-83.98967069,39,1,0,38,"Union, Georgia, US",24511,606,167,305,-138,-6,747,741,3,296,12.59914078,-5.700594845,-0.24785195,30.857567746,30.609715796,7637
17181,"Union","Illinois","US","2020-05-24 02:32:43",37.47119609,-89.25548938,138,5,0,133,"Union, Illinois, US",16653,-179,173,224,-51,0,-129,-129,1,566,13.379124981,-3.046140063,0,-7.704942512,-7.704942512,5341
18161,"Union","Indiana","US","2020-05-24 02:32:43",39.62550777,-84.92497066,8,0,0,8,"Union, Indiana, US",7054,25,66,66,0,-10,37,27,-2,67,9.3730029113,0,-1.420151956,5.2545622382,3.8344102819,1536
19175,"Union","Iowa","US","2020-05-24 02:32:43",41.0277278,-94.24234847,5,0,0,5,"Union, Iowa, US",12241,-57,130,138,-8,4,-53,-49,0,457,11.247402095,-0.65202331,0.3260116549,-4.319654428,-3.993642773,7127
21225,"Union","Kentucky","US","2020-05-24 02:32:43",37.66166713,-87.94300009,10,0,0,10,"Union, Kentucky, US",14381,-90,151,160,-9,-9,-72,-81,0,1655,11.09108554,-0.623873562,-0.623873562,-4.990988493,-5.614862055,6370
22111,"Union","Louisiana","US","2020-05-24 02:32:43",32.83121059,-92.3749373,287,16,0,271,"Union, Louisiana, US",22108,-135,230,249,-19,5,-120,-115,-1,476,11.228608149,-0.856801425,0.2254740592,-5.411377421,-5.185903362,5188
28145,"Union","Mississippi","US","2020-05-24 02:32:43",34.49162015,-89.00776006,70,5,0,65,"Union, Mississippi, US",28815,200,355,284,71,36,94,130,-1,277,9.8903012363,2.4725753091,1.2537001567,3.2735504092,4.5272505659,10669
34039,"Union","New Jersey","US","2020-05-24 02:32:43",40.65835409,-74.30680092,15186,1022,0,14164,"Union, New Jersey, US",556341,-61,6738,4195,2543,2002,-4631,-2629,25,6177,7.5399261105,4.570687032,3.5983151545,-8.323575165,-4.725260011,234221
35059,"Union","New Mexico","US","2020-05-24 02:32:43",36.48126404,-103.4709624,3,0,0,3,"Union, New Mexico, US",4059,-49,38,37,1,-2,-47,-49,-1,670,9.060854659,0.2448879638,-0.489775928,-11.5097343,-11.99951022,1815
37179,"Union","North Carolina","US","2020-05-24 02:32:43",34.98960527,-80.52955873,393,17,0,376,"Union, North Carolina, US",239859,4029,2431,1521,910,19,3115,3134,-15,2800,6.3949345055,3.8260291913,0.079884126,13.096792232,13.176676358,66557
39159,"Union","Ohio","US","2020-05-24 02:32:43",40.30016061,-83.37239023,42,0,0,42,"Union, Ohio, US",58988,1206,689,379,310,36,859,895,1,2673,6.4913933373,5.3095829408,0.6165967286,14.712683052,15.329279781,31840
41061,"Union","Oregon","US","2020-05-24 02:32:43",45.30915495,-118.0068979,6,0,0,6,"Union, Oregon, US",26835,134,277,280,-3,11,126,137,0,966,10.460251046,-0.112074118,0.410938434,4.7071129707,5.1180514047,10881
42119,"Union","Pennsylvania","US","2020-05-24 02:32:43",40.96188846,-77.05996014,52,1,0,51,"Union, Pennsylvania, US",44923,-94,402,422,-20,2,-76,-74,0,8852,9.3840338003,-0.444740938,0.0444740938,-1.690015566,-1.645541472,19571
45087,"Union","South Carolina","US","2020-05-24 02:32:43",34.68835752,-81.61730349,31,0,0,31,"Union, South Carolina, US",27316,-8,294,378,-84,-1,80,79,-3,405,13.83601757,-3.074670571,-0.036603221,2.9282576867,2.8916544656,8916
46127,"Union","South Dakota","US","2020-05-24 02:32:43",42.83112163,-96.6557828,75,0,0,75,"Union, South Dakota, US",15932,362,185,112,73,14,277,291,-2,89,7.1106596407,4.6346263729,0.8888324551,17.586185004,18.475017459,8481
47173,"Union","Tennessee","US","2020-05-24 02:32:43",36.28590426,-83.83651902,4,0,0,4,"Union, Tennessee, US",19972,283,201,214,-13,4,291,295,1,174,10.791457603,-0.655555836,0.2017094879,14.674365245,14.876074733,2838
48459,"Upshur","Texas","US","2020-05-24 02:32:43",32.73706798,-94.93999853,18,0,0,18,"Upshur, Texas, US",41753,574,452,437,15,-4,566,562,-3,481,10.538754642,0.3617421502,-0.096464573,13.649737134,13.553272561,8727
54097,"Upshur","West Virginia","US","2020-05-24 02:32:43",38.89285061,-80.23689136,6,0,0,6,"Upshur, West Virginia, US",24176,-196,221,285,-64,-2,-131,-133,1,1225,11.740957403,-2.636565873,-0.082392684,-5.396720771,-5.479113455,9507
13293,"Upson","Georgia","US","2020-05-24 02:32:43",32.87920671,-84.30024826,272,33,0,239,"Upson, Georgia, US",26320,135,306,400,-94,-4,238,234,-5,414,15.236644129,-3.58061137,-0.152366441,9.0658032568,8.9134368155,8490
49049,"Utah","Utah","US","2020-05-24 02:32:43",40.1166722,-111.6657662,1678,14,0,1664,"Utah, Utah, US",636235,14715,11884,2419,9465,959,4255,5214,36,14075,3.8465360901,15.050625917,1.5249392767,6.7660235896,8.2909628664,216540
48463,"Uvalde","Texas","US","2020-05-24 02:32:43",29.35739637,-99.76229172,6,0,0,6,"Uvalde, Texas, US",26741,-46,378,253,125,-36,-135,-171,0,561,9.4529965625,4.6704528471,-1.34509042,-5.044089075,-6.389179495,10517
48465,"Val Verde","Texas","US","2020-05-24 02:32:43",29.89149232,-101.1525205,14,0,0,14,"Val Verde, Texas, US",49025,37,759,379,380,-15,-329,-344,1,1949,7.7336679828,7.7540734392,-0.306081846,-6.713395162,-7.019477008,18511
35061,"Valencia","New Mexico","US","2020-05-24 02:32:43",34.71669834,-106.8103733,70,1,0,69,"Valencia, New Mexico, US",76688,383,832,699,133,-21,274,253,-3,1552,9.1376729654,1.7386416372,-0.274522364,3.5818632225,3.3073408587,17593
16085,"Valley","Idaho","US","2020-05-24 02:32:43",44.76728382,-115.5676773,2,0,0,2,"Valley, Idaho, US",11392,371,102,72,30,-14,354,340,1,66,6.4248427252,2.6770178022,-1.249274974,31.588810066,30.339535091,4521
31175,"Valley","Nebraska","US","2020-05-24 02:32:43",41.56730777,-98.98197724,3,0,0,3,"Valley, Nebraska, US",4158,-39,46,46,0,8,-47,-39,0,45,11.011370437,0,1.9150209455,-11.25074806,-9.33572711,2340
5141,"Van Buren","Arkansas","US","2020-05-24 02:32:43",35.58095779,-92.51295036,28,2,0,26,"Van Buren, Arkansas, US",16545,-90,141,250,-109,11,9,20,-1,189,15.069318867,-6.570223026,0.6630500301,0.5424954792,1.2055455093,4545
19177,"Van Buren","Iowa","US","2020-05-24 02:32:43",40.75326764,-91.95017958,8,0,0,8,"Van Buren, Iowa, US",7044,31,88,96,-8,0,40,40,-1,57,13.658675393,-1.138222949,0,5.6911147471,5.6911147471,2627
26159,"Van Buren","Michigan","US","2020-05-24 02:32:43",42.25190229,-86.01939087,121,6,0,115,"Van Buren, Michigan, US",75677,196,865,802,63,39,99,138,-5,877,10.611413223,0.8335648791,0.5160163537,1.3098876672,1.825904021,24190
47175,"Van Buren","Tennessee","US","2020-05-24 02:32:43",35.69864497,-85.45221699,4,0,0,4,"Van Buren, Tennessee, US",5872,109,69,55,14,0,95,95,0,123,9.4542329179,2.4065320155,0,16.330038676,16.330038676,1394
39161,"Van Wert","Ohio","US","2020-05-24 02:32:43",40.8554138,-84.591117,5,0,0,5,"Van Wert, Ohio, US",28275,22,339,295,44,-1,-20,-21,-1,396,10.437305406,1.5567506369,-0.035380696,-0.707613926,-0.742994622,11168
48467,"Van Zandt","Texas","US","2020-05-24 02:32:43",32.56483801,-95.83766469,25,1,0,24,"Van Zandt, Texas, US",56590,624,635,656,-21,47,602,649,-4,559,11.656419915,-0.373147589,0.8351398415,10.696897544,11.532037386,13301
37181,"Vance","North Carolina","US","2020-05-24 02:32:43",36.36880673,-78.40670845,239,18,0,221,"Vance, North Carolina, US",44535,-100,571,525,46,32,-177,-145,-1,800,11.775260738,1.0317371313,0.7177301783,-3.969945049,-3.25221487,16152
18163,"Vanderburgh","Indiana","US","2020-05-24 02:32:43",38.02658833,-87.58763124,240,2,0,238,"Vanderburgh, Indiana, US",181451,331,2058,1889,169,217,-47,170,-8,7069,10.420028077,0.9322312044,1.1970069311,-0.259259566,0.9377473653,105843
42121,"Venango","Pennsylvania","US","2020-05-24 02:32:43",41.40323442,-79.75845449,8,0,0,8,"Venango, Pennsylvania, US",50668,-533,452,680,-228,1,-306,-305,0,1302,13.350479537,-4.476337257,0.0196330581,-6.007715792,-5.988082734,21543
6111,"Ventura","California","US","2020-05-24 02:32:43",34.44465746,-119.0910613,912,30,0,882,"Ventura, California, US",846006,-2136,9161,6241,2920,140,-5193,-5053,-3,11171,7.3677152173,3.4471604606,0.1652748166,-6.130515162,-5.965240345,346493
17183,"Vermilion","Illinois","US","2020-05-24 02:32:43",40.18417171,-87.73384359,39,1,0,38,"Vermilion, Illinois, US",75758,-944,918,945,-27,19,-937,-918,1,2906,12.396694215,-0.354191263,0.2492457038,-12.29174866,-12.04250295,31005
22113,"Vermilion","Louisiana","US","2020-05-24 02:32:43",29.83517605,-92.30292538,50,3,0,47,"Vermilion, Louisiana, US",59511,-375,730,602,128,4,-507,-503,0,537,10.084005461,2.1441074734,0.0670033585,-8.492675695,-8.425672337,16252
18165,"Vermillion","Indiana","US","2020-05-24 02:32:43",39.8523352,-87.46160542,8,0,0,8,"Vermillion, Indiana, US",15498,-12,170,199,-29,17,1,18,-1,209,12.835397317,-1.870485036,1.0964912281,0.064499484,1.1609907121,4985
22115,"Vernon","Louisiana","US","2020-05-24 02:32:43",31.10884837,-93.18153838,23,2,0,21,"Vernon, Louisiana, US",47429,-672,828,366,462,31,-1161,-1130,-4,2593,7.6625143934,9.6723542343,0.649010782,-24.30650058,-23.65748979,24230
29217,"Vernon","Missouri","US","2020-05-24 02:32:43",37.8457799,-94.34127305,7,0,0,7,"Vernon, Missouri, US",20563,71,242,227,15,3,55,58,-2,868,11.058336378,0.7307270734,0.1461454147,2.6793326026,2.8254780173,9230
55123,"Vernon","Wisconsin","US","2020-05-24 02:32:43",43.59422667,-90.8324691,14,0,0,14,"Vernon, Wisconsin, US",30822,50,412,326,86,1,-35,-34,-2,317,10.585446634,2.792479787,0.0324706952,-1.136474332,-1.104003637,10361
48469,"Victoria","Texas","US","2020-05-24 02:32:43",28.79780988,-96.96813006,157,7,0,150,"Victoria, Texas, US",92084,206,1175,835,340,25,-156,-131,-3,1881,9.077961753,3.6964155641,0.2717952621,-1.696002435,-1.424207173,43269
18167,"Vigo","Indiana","US","2020-05-24 02:32:43",39.42944561,-87.39169027,135,7,0,128,"Vigo, Indiana, US",107038,-329,1192,1169,23,194,-547,-353,1,9590,10.904596441,0.2145472354,1.8096592897,-5.102492946,-3.292833656,54970
55125,"Vilas","Wisconsin","US","2020-05-24 02:32:43",46.05467334,-89.51719204,6,0,0,6,"Vilas, Wisconsin, US",22195,267,182,308,-126,10,383,393,0,209,13.960972735,-5.711307028,0.4532783356,17.360560252,17.813838588,8582
39163,"Vinton","Ohio","US","2020-05-24 02:32:43",39.25208988,-82.4831444,19,0,0,19,"Vinton, Ohio, US",13085,-60,144,157,-13,0,-47,-47,0,68,11.971025543,-0.991231414,0,-3.583682806,-3.583682806,2465
51810,"Virginia Beach","Virginia","US","2020-05-24 02:32:43",36.73285734,-76.04566934,598,19,0,579,"Virginia Beach, Virginia, US",449974,125,5514,3319,2195,296,-2367,-2071,1,9793,7.3770063668,4.8787372628,0.6579071662,-5.26103467,-4.603127504,201028
12127,"Volusia","Florida","US","2020-05-24 02:32:43",29.05858895,-81.18263252,655,36,0,619,"Volusia, Florida, US",553284,7183,4933,7178,-2245,420,8975,9395,33,14476,13.058209817,-4.084101566,0.7640635446,16.327310269,17.091373814,175165
17185,"Wabash","Illinois","US","2020-05-24 02:32:43",38.44272901,-87.84922065,1,0,0,1,"Wabash, Illinois, US",11520,-3,131,114,17,34,-55,-21,1,88,9.8945449811,1.4755023217,2.9510046435,-4.773683982,-1.822679339,3781
18169,"Wabash","Indiana","US","2020-05-24 02:32:43",40.84704239,-85.79328272,72,2,0,70,"Wabash, Indiana, US",30996,-202,306,406,-100,10,-113,-103,1,1843,13.055921793,-3.215744284,0.3215744284,-3.633791041,-3.312216613,13904
27157,"Wabasha","Minnesota","US","2020-05-24 02:32:43",44.28424356,-92.23121312,16,0,0,16,"Wabasha, Minnesota, US",21627,-18,235,186,49,4,-72,-68,1,246,8.5967831392,2.2647439453,0.1848770568,-3.327787022,-3.142909965,7716
20197,"Wabaunsee","Kansas","US","2020-05-24 02:32:43",38.95471985,-96.20350509,29,0,0,29,"Wabaunsee, Kansas, US",6931,19,74,51,23,2,-7,-5,1,90,7.3683450119,3.322979123,0.2889547063,-1.011341472,-0.722386766,1664
27159,"Wadena","Minnesota","US","2020-05-24 02:32:43",46.58589171,-94.96968506,6,0,0,6,"Wadena, Minnesota, US",13682,-41,186,177,9,1,-49,-48,-2,482,12.917350848,0.6568144499,0.0729793833,-3.575989783,-3.5030104,6454
40145,"Wagoner","Oklahoma","US","2020-05-24 02:32:43",35.96024096,-95.51911308,145,17,0,128,"Wagoner, Oklahoma, US",81289,1166,853,696,157,36,976,1012,-3,319,8.6238941343,1.9453324412,0.4460634897,12.093276832,12.539340322,12017
53069,"Wahkiakum","Washington","US","2020-05-24 02:32:43",46.2918004,-123.4250831,4,0,0,4,"Wahkiakum, Washington, US",4488,73,33,46,-13,4,83,87,-1,48,10.333595417,-2.920363922,0.8985735145,18.645400427,19.543973941,1065
37183,"Wake","North Carolina","US","2020-05-24 02:32:43",35.78879266,-78.65249174,1434,32,0,1402,"Wake, North Carolina, US",1111761,20488,12634,6210,6424,3165,10857,14022,42,22346,5.6376796727,5.8319572008,2.8733101713,9.8564071185,12.72971729,516628
12129,"Wakulla","Florida","US","2020-05-24 02:32:43",30.16548905,-84.39895211,32,1,0,31,"Wakulla, Florida, US",33739,1326,329,276,53,-2,1263,1261,12,3249,8.344418914,1.6023702987,-0.060466804,38.184786552,38.124319748,5942
23027,"Waldo","Maine","US","2020-05-24 02:32:43",44.4858305,-69.12061935,51,14,0,37,"Waldo, Maine, US",39715,58,330,446,-116,32,144,176,-2,588,11.238220027,-2.922945119,0.8063296881,3.6284835962,4.4348132843,13162
1127,"Walker","Alabama","US","2020-05-24 02:32:43",33.80270512,-87.30027177,191,1,0,190,"Walker, Alabama, US",63521,-148,750,969,-219,-1,75,74,-3,852,15.237046938,-3.443666955,-0.015724507,1.1793379983,1.1636134916,20758
13295,"Walker","Georgia","US","2020-05-24 02:32:43",34.73376362,-85.30165174,95,0,0,95,"Walker, Georgia, US",69761,318,745,835,-90,18,391,409,-1,1353,11.996781702,-1.293066291,0.2586132582,5.6176546651,5.8762679233,15724
48471,"Walker","Texas","US","2020-05-24 02:32:43",30.73872995,-95.57440968,436,27,0,409,"Walker, Texas, US",72971,-165,592,593,-1,151,-319,-168,4,17712,8.1173386628,-0.013688598,2.0669783104,-4.366662788,-2.299684478,23732
53071,"Walla Walla","Washington","US","2020-05-24 02:32:43",46.23040051,-118.4775539,106,2,0,104,"Walla Walla, Washington, US",60760,145,610,575,35,-15,128,113,-3,4653,9.4747682801,0.5767250257,-0.247167868,2.1091658084,1.8619979403,29322
48473,"Waller","Texas","US","2020-05-24 02:32:43",30.01058447,-95.99011759,45,0,0,45,"Waller, Texas, US",55246,1734,683,336,347,25,1359,1384,3,4672,6.1788558083,6.3811397782,0.4597362953,24.99126501,25.451001306,17220
41063,"Wallowa","Oregon","US","2020-05-24 02:32:43",45.57894064,-117.183538,2,0,0,2,"Wallowa, Oregon, US",7208,150,61,71,-10,0,160,160,0,104,9.9537361559,-1.40193467,0,22.430954718,22.430954718,2853
38099,"Walsh","North Dakota","US","2020-05-24 02:32:43",48.36876964,-97.72574783,11,0,0,11,"Walsh, North Dakota, US",10641,-4,124,128,-4,13,-11,2,-2,334,12.026684206,-0.375833881,1.2214601146,-1.033543174,0.1879169407,5554
28147,"Walthall","Mississippi","US","2020-05-24 02:32:43",31.14971548,-90.10446654,51,0,0,51,"Walthall, Mississippi, US",14286,-150,165,193,-28,-2,-118,-120,-2,102,13.439175545,-1.94972495,-0.139266068,-8.216698002,-8.355964069,2776
12131,"Walton","Florida","US","2020-05-24 02:32:43",30.64204028,-86.16935664,103,7,0,96,"Walton, Florida, US",74071,3339,780,718,62,5,3252,3257,20,2030,9.9169216107,0.8563358494,0.0690593427,44.916196488,44.98525583,25377
13297,"Walton","Georgia","US","2020-05-24 02:32:43",33.78017694,-83.73552314,186,10,0,176,"Walton, Georgia, US",94593,1391,1174,937,237,-9,1162,1153,1,791,9.9789664262,2.5240288613,-0.095849197,12.375196358,12.27934716,22519
46129,"Walworth","South Dakota","US","2020-05-24 02:32:43",45.43019636,-100.0307514,5,0,0,5,"Walworth, South Dakota, US",5435,-42,78,65,13,6,-60,-54,-1,152,11.913489736,2.3826979472,1.0997067449,-10.99706745,-9.897360704,2414
55127,"Walworth","Wisconsin","US","2020-05-24 02:32:43",42.66858202,-88.54163073,339,12,0,327,"Walworth, Wisconsin, US",103868,318,924,947,-23,-23,366,343,-2,3140,9.1313193648,-0.221774388,-0.221774388,3.5291054778,3.3073310899,45063
19179,"Wapello","Iowa","US","2020-05-24 02:32:43",41.03064984,-92.40954728,477,4,0,473,"Wapello, Iowa, US",34969,-22,436,392,44,87,-154,-67,1,859,11.206403659,1.2578616352,2.487135506,-4.402515723,-1.915380217,17048
38101,"Ward","North Dakota","US","2020-05-24 02:32:43",48.22390169,-101.5436763,54,1,0,53,"Ward, North Dakota, US",67641,-72,1099,491,608,117,-798,-681,1,2538,7.2550497215,8.9838497569,1.7288000355,-11.79130281,-10.06250277,40593
13299,"Ware","Georgia","US","2020-05-24 02:32:43",31.05449097,-82.42224148,206,13,0,193,"Ware, Georgia, US",35734,147,476,455,21,-6,133,127,-1,2468,12.759215378,0.5888868636,-0.16825339,3.7296168029,3.5613634133,16428
13301,"Warren","Georgia","US","2020-05-24 02:32:43",33.41146451,-82.67795848,17,0,0,17,"Warren, Georgia, US",5254,7,61,68,-7,1,13,14,0,89,12.95114751,-1.333206361,0.1904580516,2.475954671,2.6664127226,1360
17187,"Warren","Illinois","US","2020-05-24 02:32:43",40.84925021,-90.6147432,114,0,0,114,"Warren, Illinois, US",16844,-148,204,178,26,37,-212,-175,1,977,10.52133822,1.5368246838,2.1870197423,-12.53103204,-10.34401229,7189
18171,"Warren","Indiana","US","2020-05-24 02:32:43",40.34728141,-87.35602659,12,1,0,11,"Warren, Indiana, US",8265,-15,86,84,2,4,-19,-15,-2,84,10.154125113,0.2417648837,0.4835297673,-2.296766395,-1.813236627,2256
19181,"Warren","Iowa","US","2020-05-24 02:32:43",41.33559454,-93.56007641,100,0,0,100,"Warren, Iowa, US",51466,452,586,439,147,1,308,309,-4,1508,8.5675253708,2.868852459,0.0195160031,6.0109289617,6.0304449649,11923
21227,"Warren","Kentucky","US","2020-05-24 02:32:43",36.99903045,-86.42672751,920,5,0,915,"Warren, Kentucky, US",132896,2146,1723,1000,723,111,1308,1419,4,7424,7.5859296177,5.4846271136,0.8420381876,9.92239594,10.764434128,62618
28149,"Warren","Mississippi","US","2020-05-24 02:32:43",32.35810271,-90.83352619,148,6,0,142,"Warren, Mississippi, US",45381,-712,576,518,58,16,-786,-770,0,522,11.325622581,1.2681199029,0.3498261801,-17.1852111,-16.83538492,21812
29219,"Warren","Missouri","US","2020-05-24 02:32:43",38.76529479,-91.16124662,28,0,0,28,"Warren, Missouri, US",35649,883,416,313,103,7,771,778,2,317,8.8901512462,2.9255130299,0.1988212739,21.898743166,22.097564439,8008
34041,"Warren","New Jersey","US","2020-05-24 02:32:43",40.85951833,-74.99556527,1119,126,0,993,"Warren, New Jersey, US",105267,-261,927,969,-42,104,-323,-219,0,1975,9.1937664556,-0.398491425,0.9867406722,-3.064588819,-2.077848146,37063
36113,"Warren","New York","US","2020-05-24 02:32:43",43.56173026,-73.8433699,249,26,0,223,"Warren, New York, US",63944,-271,529,674,-145,23,-146,-123,-3,651,10.518184443,-2.262814161,0.3589291427,-2.278419775,-1.919490633,37647
37185,"Warren","North Carolina","US","2020-05-24 02:32:43",36.39728256,-78.10652228,54,0,0,54,"Warren, North Carolina, US",19731,-88,161,267,-106,-6,27,21,-3,927,13.501896334,-5.360303413,-0.303413401,1.3653603034,1.0619469027,4656
39165,"Warren","Ohio","US","2020-05-24 02:32:43",39.42581994,-84.16557457,319,19,0,300,"Warren, Ohio, US",234602,2657,2316,1858,458,187,2019,2206,-7,5711,7.9648995707,1.9633606046,0.8016341333,8.6550765518,9.4567106851,88237
42123,"Warren","Pennsylvania","US","2020-05-24 02:32:43",41.81304978,-79.26969577,3,0,0,3,"Warren, Pennsylvania, US",39191,-360,417,531,-114,5,-250,-245,-1,759,13.487084402,-2.895532245,0.1269970283,-6.349851413,-6.222854385,17104
47177,"Warren","Tennessee","US","2020-05-24 02:32:43",35.6728299,-85.77969117,19,0,0,19,"Warren, Tennessee, US",41277,451,473,471,2,37,413,450,-1,572,11.473393177,0.0487192916,0.901306895,10.06053372,10.961840615,15759
51187,"Warren","Virginia","US","2020-05-24 02:32:43",38.90847745,-78.20280433,110,2,0,108,"Warren, Virginia, US",40164,158,457,395,62,2,94,96,0,679,9.8540601222,1.5467132344,0.0498939753,2.3450168392,2.3949108145,13296
18173,"Warrick","Indiana","US","2020-05-24 02:32:43",38.08922676,-87.2716085,163,26,0,137,"Warrick, Indiana, US",62998,524,627,617,10,58,460,518,-4,727,9.8348635552,0.1593981127,0.9245090538,7.3323131854,8.2568222392,17168
49051,"Wasatch","Utah","US","2020-05-24 02:32:43",40.33110236,-111.1691419,237,1,0,236,"Wasatch, Utah, US",34091,1024,452,145,307,24,689,713,4,250,4.3181750499,9.1426188987,0.714732422,20.518776616,21.233509038,7811
41065,"Wasco","Oregon","US","2020-05-24 02:32:43",45.16292781,-121.1670954,18,1,0,17,"Wasco, Oregon, US",26682,250,299,299,0,3,248,251,-1,741,11.258801822,0,0.1129645668,9.3384041872,9.451368754,10671
27161,"Waseca","Minnesota","US","2020-05-24 02:32:43",44.02211116,-93.58720034,24,0,0,24,"Waseca, Minnesota, US",18612,-52,204,149,55,-4,-103,-107,0,949,7.9944200021,2.9509604035,-0.214615302,-5.526344028,-5.74095933,7791
56043,"Washakie","Wyoming","US","2020-05-24 02:32:43",43.90451606,-107.680187,21,0,0,21,"Washakie, Wyoming, US",7805,-72,83,90,-7,-5,-60,-65,0,140,11.47812779,-0.892743273,-0.637673766,-7.652085193,-8.289758959,3930
55129,"Washburn","Wisconsin","US","2020-05-24 02:32:43",45.89838588,-91.79050449,2,0,0,2,"Washburn, Wisconsin, US",15720,-117,133,225,-92,3,-26,-23,-2,195,14.259910638,-5.830719016,0.1901321418,-1.647811896,-1.457679754,6534
1129,"Washington","Alabama","US","2020-05-24 02:32:43",31.4092794,-88.20689944,64,5,0,59,"Washington, Alabama, US",16326,-76,165,191,-26,14,-65,-51,1,147,11.671962845,-1.588853581,0.8555365436,-3.972133953,-3.116597409,4568
5143,"Washington","Arkansas","US","2020-05-24 02:32:43",35.976844,-94.21800746,233,5,0,228,"Washington, Arkansas, US",239187,2576,3203,1599,1604,164,802,966,6,8244,6.7213397282,6.7423570507,0.6893681773,3.3711785253,4.0605467026,102623
8121,"Washington","Colorado","US","2020-05-24 02:32:43",39.97015535,-103.202587,30,0,0,30,"Washington, Colorado, US",4908,20,47,48,-1,-1,21,20,1,184,9.799918334,-0.204164965,-0.204164965,4.2874642711,4.0832993058,1602
12133,"Washington","Florida","US","2020-05-24 02:32:43",30.61359259,-85.66002461,26,1,0,25,"Washington, Florida, US",25473,680,257,305,-48,9,715,724,4,2619,12.135439462,-1.909839653,0.3580949349,28.448653165,28.8067481,6979
13303,"Washington","Georgia","US","2020-05-24 02:32:43",32.96711864,-82.79357039,73,1,0,72,"Washington, Georgia, US",20374,-36,219,227,-8,1,-28,-27,-1,1878,11.131816399,-0.39231071,0.0490388388,-1.373087485,-1.324048647,7430
16087,"Washington","Idaho","US","2020-05-24 02:32:43",44.45275475,-116.7847688,34,0,0,34,"Washington, Idaho, US",10194,79,108,86,22,-8,64,56,1,119,8.4691516077,2.1665271554,-0.787828057,6.3026244522,5.5147963957,2871
17189,"Washington","Illinois","US","2020-05-24 02:32:43",38.35309213,-89.40982703,18,0,0,18,"Washington, Illinois, US",13887,-112,154,143,11,0,-123,-123,0,246,10.256042459,0.788926343,0,-8.821630926,-8.821630926,7332
18175,"Washington","Indiana","US","2020-05-24 02:32:43",38.60219804,-86.1049363,52,1,0,51,"Washington, Indiana, US",28036,104,321,302,19,0,87,87,-2,261,10.791881075,0.6789594054,0,3.1089193825,3.1089193825,6399
19183,"Washington","Iowa","US","2020-05-24 02:32:43",41.33577126,-91.71725711,179,8,0,171,"Washington, Iowa, US",21965,-93,275,225,50,-1,-142,-143,0,303,10.221929446,2.2715398769,-0.045430798,-6.45117325,-6.496604048,8628
20201,"Washington","Kansas","US","2020-05-24 02:32:43",39.78420784,-97.0875323,0,0,0,0,"Washington, Kansas, US",5406,-44,72,85,-13,3,-34,-31,0,114,15.65954311,-2.394988946,0.5526897568,-6.263817244,-5.711127487,2278
21229,"Washington","Kentucky","US","2020-05-24 02:32:43",37.75599461,-85.17407732,6,0,0,6,"Washington, Kentucky, US",12095,72,146,132,14,5,53,58,0,205,10.946181275,1.1609586201,0.4146280786,4.3950576333,4.8096857119,3884
22117,"Washington","Louisiana","US","2020-05-24 02:32:43",30.85288548,-90.03866652,383,36,0,347,"Washington, Louisiana, US",46194,-394,600,635,-35,-16,-341,-357,-2,1582,13.687999828,-0.754456683,-0.344894484,-7.350563687,-7.695458171,12509
23029,"Washington","Maine","US","2020-05-24 02:32:43",45.01607142,-67.62813524,2,0,0,2,"Washington, Maine, US",31379,58,259,414,-155,31,185,216,-3,547,13.205741627,-4.944178628,0.9888357257,5.9011164274,6.8899521531,12355
24043,"Washington","Maryland","US","2020-05-24 02:32:43",39.60835778,-77.82002295,398,10,0,388,"Washington, Maryland, US",151049,393,1649,1619,30,116,256,372,-9,8314,10.73233788,0.1988697569,0.7689630599,1.6970219254,2.4659849853,68753
27163,"Washington","Minnesota","US","2020-05-24 02:32:43",45.03864533,-92.88429635,485,25,0,460,"Washington, Minnesota, US",262440,3541,2722,1712,1010,124,2420,2544,-13,3474,6.567703548,3.8746381913,0.4756981542,9.2837865573,9.7594847115,88711
28151,"Washington","Mississippi","US","2020-05-24 02:32:43",33.28392041,-90.94196237,151,5,0,146,"Washington, Mississippi, US",43909,-1127,565,608,-43,19,-1107,-1088,4,608,13.671369948,-0.966889651,0.4272303109,-24.89178706,-24.46455675,17068
29221,"Washington","Missouri","US","2020-05-24 02:32:43",37.96130078,-90.87948158,10,1,0,9,"Washington, Missouri, US",24730,-203,274,271,3,-1,-206,-207,1,1092,10.913557377,0.1208142883,-0.040271429,-8.295914463,-8.336185893,5778
31177,"Washington","Nebraska","US","2020-05-24 02:32:43",41.52815707,-96.22019892,26,1,0,25,"Washington, Nebraska, US",20729,112,207,176,31,10,73,83,-2,135,8.5135200503,1.4995404634,0.4837227301,3.53117593,4.0148986601,9200
36115,"Washington","New York","US","2020-05-24 02:32:43",43.31153794,-73.43043448,225,13,0,212,"Washington, New York, US",61204,-70,545,681,-136,7,63,70,-4,3070,11.120364474,-2.220807002,0.1143062428,1.0287561848,1.1430624275,18040
37187,"Washington","North Carolina","US","2020-05-24 02:32:43",35.83810081,-76.57299037,26,3,0,23,"Washington, North Carolina, US",11580,-189,129,155,-26,-8,-154,-162,-1,145,13.276799863,-2.227076106,-0.685254186,-13.19114309,-13.87639728,4184
39167,"Washington","Ohio","US","2020-05-24 02:32:43",39.45690571,-81.49121382,116,18,0,98,"Washington, Ohio, US",59911,-200,594,725,-131,10,-76,-66,-3,1524,12.081118462,-2.182933129,0.1666361167,-1.266434487,-1.09979837,25384
40147,"Washington","Oklahoma","US","2020-05-24 02:32:43",36.71380786,-95.90514104,310,33,0,277,"Washington, Oklahoma, US",51527,-264,586,677,-91,83,-255,-172,-1,798,13.105170445,-1.761551714,1.606690025,-4.936216342,-3.329526317,23706
41067,"Washington","Oregon","US","2020-05-24 02:32:43",45.55972701,-123.0955257,673,17,0,656,"Washington, Oregon, US",601592,4688,6611,3582,3029,1193,478,1671,-12,7806,5.9774917897,5.0546685179,1.9908285051,0.7976664086,2.7884949136,272129
42125,"Washington","Pennsylvania","US","2020-05-24 02:32:43",40.19208869,-80.24582867,135,5,0,130,"Washington, Pennsylvania, US",206865,-153,1926,2509,-583,47,402,449,-19,5478,12.124199351,-2.817221292,0.2271173254,1.9425779749,2.1696953004,90688
44009,"Washington","Rhode Island","US","2020-05-24 02:32:43",41.45961631,-71.61435303,485,0,0,485,"Washington, Rhode Island, US",125577,-520,840,1247,-407,99,-208,-109,-4,6832,9.909645017,-3.23434284,0.7867320422,-1.652931968,-0.866199925,55803
47179,"Washington","Tennessee","US","2020-05-24 02:32:43",36.29472368,-82.4945472,72,0,0,72,"Washington, Tennessee, US",129375,714,1223,1365,-142,182,678,860,-4,4257,10.579919081,-1.100621619,1.4106558775,5.2550806864,6.6657365639,63671
48477,"Washington","Texas","US","2020-05-24 02:32:43",30.21498498,-96.40946246,187,22,0,165,"Washington, Texas, US",35882,386,364,383,-19,-2,409,407,-2,2536,10.731597971,-0.532376923,-0.056039676,11.460113761,11.404074084,16237
50023,"Washington","Vermont","US","2020-05-24 02:32:43",44.27343241,-72.61604978,39,1,0,38,"Washington, Vermont, US",58409,330,534,534,0,-9,338,329,1,2960,9.1683263512,0,-0.154522354,5.803172859,5.6486505048,33859
51191,"Washington","Virginia","US","2020-05-24 02:32:43",36.72341572,-81.95666289,51,4,0,47,"Washington, Virginia, US",53740,-327,446,692,-246,-7,-71,-78,-3,1781,12.837756361,-4.563711076,-0.129861697,-1.317168644,-1.447030341,23631
55131,"Washington","Wisconsin","US","2020-05-24 02:32:43",43.36863664,-88.22974712,181,4,0,177,"Washington, Wisconsin, US",136034,589,1285,1161,124,22,453,475,-10,1000,8.5531477573,0.9135144892,0.1620751513,3.3372747063,3.4993498576,54842
40149,"Washita","Oklahoma","US","2020-05-24 02:32:43",35.29071824,-98.99180434,1,0,0,1,"Washita, Oklahoma, US",10916,-120,121,145,-24,3,-98,-95,-1,206,13.210641399,-2.186588921,0.2733236152,-8.928571429,-8.655247813,3202
32031,"Washoe","Nevada","US","2020-05-24 02:32:43",40.66562265,-119.6631594,1356,49,0,1307,"Washoe, Nevada, US",471519,7165,5259,4032,1227,-387,6281,5894,44,5310,8.6165537418,2.6221506551,-0.827035292,13.422761422,12.59572613,203368
26161,"Washtenaw","Michigan","US","2020-05-24 02:32:43",42.253105,-83.83853204,1282,96,0,1186,"Washtenaw, Michigan, US",367601,-1882,3473,2448,1025,1160,-4098,-2938,31,20947,6.6423908266,2.7812298191,3.1475381368,-11.11949249,-7.97195435,209801
37189,"Watauga","North Carolina","US","2020-05-24 02:32:43",36.23103603,-81.70033724,13,0,0,13,"Watauga, North Carolina, US",56177,143,381,401,-20,43,121,164,-1,5848,7.1472493784,-0.356471291,0.766413275,2.1566513087,2.9230645837,26384
27165,"Watonwan","Minnesota","US","2020-05-24 02:32:43",43.97823903,-94.61413846,46,0,0,46,"Watonwan, Minnesota, US",10897,-110,162,113,49,43,-203,-160,1,150,10.317750183,4.4740686633,3.9262235208,-18.53542732,-14.6092038,4479
55133,"Waukesha","Wisconsin","US","2020-05-24 02:32:43",43.01833055,-88.30431188,553,25,0,528,"Waukesha, Wisconsin, US",404198,1676,3851,3587,264,151,1300,1451,-39,5344,8.892800476,0.6545021817,0.3743554145,3.2229274098,3.5972828243,232566
55135,"Waupaca","Wisconsin","US","2020-05-24 02:32:43",44.47068056,-88.96534501,20,1,0,19,"Waupaca, Wisconsin, US",50990,-140,511,724,-213,17,59,76,-3,1463,14.179396788,-4.171562867,0.3329416373,1.1555033294,1.4884449667,22339
55137,"Waushara","Wisconsin","US","2020-05-24 02:32:43",44.11324419,-89.24317107,7,0,0,7,"Waushara, Wisconsin, US",24443,176,205,243,-38,14,202,216,-2,1224,9.9774173681,-1.560254568,0.5748306303,8.293984808,8.8688154383,7174
13305,"Wayne","Georgia","US","2020-05-24 02:32:43",31.5521809,-81.91894878,16,0,0,16,"Wayne, Georgia, US",29927,117,360,358,2,8,108,116,-1,2065,11.985871403,0.0669601754,0.2678407017,3.6158494735,3.8836901753,9885
17191,"Wayne","Illinois","US","2020-05-24 02:32:43",38.42955355,-88.42586459,9,1,0,8,"Wayne, Illinois, US",16215,-111,187,211,-24,3,-90,-87,0,76,12.968255432,-1.475062229,0.1843827786,-5.531483359,-5.347100581,6114
18177,"Wayne","Indiana","US","2020-05-24 02:32:43",39.8633444,-85.01044989,66,5,0,61,"Wayne, Indiana, US",65884,-162,757,866,-109,70,-122,-52,-1,2705,13.128174032,-1.65239142,1.0611688016,-1.849465626,-0.788296824,29836
19185,"Wayne","Iowa","US","2020-05-24 02:32:43",40.73969028,-93.32752197,1,0,0,1,"Wayne, Iowa, US",6441,36,80,88,-8,0,43,43,1,93,13.700762883,-1.245523898,0,6.6946909544,6.6946909544,2437
21231,"Wayne","Kentucky","US","2020-05-24 02:32:43",36.80310688,-84.8251971,8,0,0,8,"Wayne, Kentucky, US",20333,-97,216,208,8,1,-107,-106,1,331,10.205333268,0.392512818,0.0490641022,-5.249858941,-5.200794838,5549
26163,"Wayne","Michigan","US","2020-05-24 02:32:43",42.28098405,-83.281255,19697,2361,0,17336,"Wayne, Michigan, US",1749343,-5110,22766,18385,4381,2533,-12052,-9519,28,23181,10.494332433,2.5007163659,1.4458604325,-6.879395947,-5.433535514,740312
28153,"Wayne","Mississippi","US","2020-05-24 02:32:43",31.64135687,-88.69573913,76,0,0,76,"Wayne, Mississippi, US",20183,-113,257,217,40,-1,-153,-154,1,137,10.721608735,1.9763334074,-0.049408335,-7.559475283,-7.608883619,5916
31179,"Wayne","Nebraska","US","2020-05-24 02:32:43",42.20934475,-97.11926964,12,0,0,12,"Wayne, Nebraska, US",9385,67,95,68,27,1,40,41,-1,1037,7.2715607122,2.8872373416,0.1069347164,4.2773886542,4.3843233706,5084
36117,"Wayne","New York","US","2020-05-24 02:32:43",43.15494365,-77.02976528,107,3,0,104,"Wayne, New York, US",89918,-282,941,873,68,21,-370,-349,-1,1113,9.693645277,0.7550605714,0.2331804706,-4.108417815,-3.875237344,30477
37191,"Wayne","North Carolina","US","2020-05-24 02:32:43",35.36438125,-78.00027268,980,18,0,962,"Wayne, North Carolina, US",123131,-106,1608,1384,224,214,-542,-328,-2,2465,11.235225354,1.8184179764,1.7372386024,-4.399922068,-2.662683465,50805
39169,"Wayne","Ohio","US","2020-05-24 02:32:43",40.82925852,-81.88844833,248,50,0,198,"Wayne, Ohio, US",115710,-80,1446,1150,296,47,-424,-377,1,3568,9.9352051836,2.5572354212,0.4060475162,-3.663066955,-3.257019438,50743
42127,"Wayne","Pennsylvania","US","2020-05-24 02:32:43",41.64938475,-75.29956506,117,7,0,110,"Wayne, Pennsylvania, US",51361,-34,376,615,-239,1,206,207,-2,3855,11.970103936,-4.651796489,0.0194635836,4.0094982288,4.0289618124,17206
47181,"Wayne","Tennessee","US","2020-05-24 02:32:43",35.23868267,-87.78644456,63,0,0,63,"Wayne, Tennessee, US",16673,38,125,197,-72,1,110,111,-1,2240,11.828990032,-4.323285697,0.0600456347,6.6050198151,6.6650654497,4542
54099,"Wayne","West Virginia","US","2020-05-24 02:32:43",38.14901357,-82.42287994,97,9,0,88,"Wayne, West Virginia, US",39402,-559,330,537,-207,-12,-342,-354,2,246,13.532754558,-5.216536673,-0.302407923,-8.618625808,-8.921033731,10489
51820,"Waynesboro","Virginia","US","2020-05-24 02:32:43",38.06451466,-78.90293905,38,0,0,38,"Waynesboro, Virginia, US",22630,99,357,249,108,53,-60,-7,-2,192,11.027213746,4.78288789,2.347157946,-2.657159939,-0.310001993,9356
47183,"Weakley","Tennessee","US","2020-05-24 02:32:43",36.29896232,-88.71990865,26,0,0,26,"Weakley, Tennessee, US",33328,-85,311,359,-48,34,-68,-34,-3,1553,10.758004825,-1.438396188,1.0188639667,-2.037727933,-1.018863967,11379
48479,"Webb","Texas","US","2020-05-24 02:32:43",27.7610369,-99.33237355,502,18,0,484,"Webb, Texas, US",276652,1532,4735,1378,3357,377,-2208,-1831,6,3608,4.9948166997,12.16806942,1.3665064556,-8.003305713,-6.636799258,96788
13307,"Webster","Georgia","US","2020-05-24 02:32:43",32.04066113,-84.54742852,11,1,0,10,"Webster, Georgia, US",2607,1,23,22,1,0,0,0,0,0,8.4404373681,0.383656244,0,0,0,599
19187,"Webster","Iowa","US","2020-05-24 02:32:43",42.42853483,-94.17987389,27,1,0,26,"Webster, Iowa, US",35904,-435,421,418,3,28,-467,-439,1,2768,11.572055424,0.0830530294,0.7751616074,-12.92858824,-12.15342663,18010
21233,"Webster","Kentucky","US","2020-05-24 02:32:43",37.52168356,-87.67989953,32,0,0,32,"Webster, Kentucky, US",12942,-109,178,142,36,2,-145,-143,-2,393,10.926018543,2.7699765321,0.1538875851,-11.15684992,-11.00296234,4191
22119,"Webster","Louisiana","US","2020-05-24 02:32:43",32.70847669,-93.33121835,126,5,0,121,"Webster, Louisiana, US",38340,-452,452,531,-79,5,-376,-371,-2,1231,13.76860447,-2.048436447,0.1296478764,-9.749520303,-9.619872426,13081
28155,"Webster","Mississippi","US","2020-05-24 02:32:43",33.61300486,-89.28392912,27,1,0,26,"Webster, Mississippi, US",9689,-99,112,151,-39,-3,-57,-60,0,55,15.505467988,-4.00472352,-0.308055655,-5.853057452,-6.161113108,2227
29225,"Webster","Missouri","US","2020-05-24 02:32:43",37.2813734,-92.876329,17,0,0,17,"Webster, Missouri, US",39592,413,572,378,194,0,218,218,1,927,9.5974406825,4.9256706148,0,5.535031928,5.535031928,8090
31181,"Webster","Nebraska","US","2020-05-24 02:32:43",40.17642643,-98.50019851,5,0,0,5,"Webster, Nebraska, US",3487,-47,39,47,-8,0,-40,-40,1,156,13.38840621,-2.278877653,0,-11.39438826,-11.39438826,1337
8123,"Weld","Colorado","US","2020-05-24 02:32:43",40.55499405,-104.3929621,2391,125,0,2266,"Weld, Colorado, US",324492,9677,4360,1856,2504,363,6778,7141,32,5903,5.8062871203,7.8334821924,1.1356046469,21.204210184,22.339814831,107551
18179,"Wells","Indiana","US","2020-05-24 02:32:43",40.72934187,-85.22132966,22,0,0,22,"Wells, Indiana, US",28296,213,321,246,75,31,109,140,-2,472,8.7266535412,2.660565104,1.099700243,3.8666879512,4.9663881942,11244
38103,"Wells","North Dakota","US","2020-05-24 02:32:43",47.58614526,-99.65904998,3,0,0,3,"Wells, North Dakota, US",3834,-74,45,50,-5,1,-70,-69,0,86,12.916559029,-1.291655903,0.2583311806,-18.08318264,-17.82485146,2213
22121,"West Baton Rouge","Louisiana","US","2020-05-24 02:32:43",30.46058217,-91.30989571,154,30,0,124,"West Baton Rouge, Louisiana, US",26465,65,346,218,128,-9,-52,-61,-2,556,8.2474226804,4.8425234087,-0.340489927,-1.967275135,-2.307765062,11516
22123,"West Carroll","Louisiana","US","2020-05-24 02:32:43",32.78550125,-91.461201,33,0,0,33,"West Carroll, Louisiana, US",10830,-147,92,149,-57,6,-96,-90,0,434,13.665336818,-5.227679186,0.5502820195,-8.804512313,-8.254230293,2680
22125,"West Feliciana","Louisiana","US","2020-05-24 02:32:43",30.87882871,-91.4148538,194,8,0,186,"West Feliciana, Louisiana, US",15568,76,124,120,4,7,66,73,-1,5327,7.7269800386,0.2575660013,0.4507405023,4.2498390212,4.7005795235,5156
36119,"Westchester","New York","US","2020-05-24 02:32:43",41.16278376,-73.75741653,32881,1327,0,31554,"Westchester, New York, US",967506,-707,10183,7582,2601,2060,-5390,-3330,22,27689,7.8337816594,2.6873735289,2.1284081006,-5.568990127,-3.440582027,435102
42129,"Westmoreland","Pennsylvania","US","2020-05-24 02:32:43",40.3137798,-79.46615476,437,38,0,399,"Westmoreland, Pennsylvania, US",348899,-1560,2869,4435,-1566,42,-8,34,-28,6976,12.68306075,-4.47839304,0.1201101582,-0.022878125,0.0972320328,144558
51193,"Westmoreland","Virginia","US","2020-05-24 02:32:43",38.11021557,-76.80213247,46,0,0,46,"Westmoreland, Virginia, US",18015,198,181,222,-41,-6,245,239,0,70,12.391158741,-2.288457245,-0.334896182,13.674927439,13.340031257,4076
54103,"Wetzel","West Virginia","US","2020-05-24 02:32:43",39.6065771,-80.6401654,8,0,0,8,"Wetzel, West Virginia, US",15065,-194,141,243,-102,0,-91,-91,-1,124,16.026909379,-6.727344677,0,-6.001846722,-6.001846722,6426
26165,"Wexford","Michigan","US","2020-05-24 02:32:43",44.33853602,-85.57712739,11,2,0,9,"Wexford, Michigan, US",33631,185,362,341,21,6,160,166,-2,389,10.167419533,0.6261460709,0.1788988774,4.7706367309,4.9495356083,15035
48481,"Wharton","Texas","US","2020-05-24 02:32:43",29.27765923,-96.22319248,45,0,0,45,"Wharton, Texas, US",41556,57,564,420,144,-15,-70,-85,-2,486,10.113780025,3.467581723,-0.361206429,-1.685630004,-2.046836434,16362
53073,"Whatcom","Washington","US","2020-05-24 02:32:43",48.82227976,-121.7490018,363,36,0,327,"Whatcom, Washington, US",229247,4050,2204,1662,542,403,3087,3490,18,5813,7.3144325814,2.3853324062,1.7735958666,13.585832358,15.359428224,93694
30107,"Wheatland","Montana","US","2020-05-24 02:32:43",46.46652491,-109.8464636,1,0,0,1,"Wheatland, Montana, US",2126,-58,26,21,5,-2,-61,-63,0,147,9.7447795824,2.3201856148,-0.928074246,-28.3062645,-29.23433875,832
13309,"Wheeler","Georgia","US","2020-05-24 02:32:43",32.12009104,-82.72574721,9,0,0,9,"Wheeler, Georgia, US",7855,-43,64,63,1,0,-44,-44,0,2511,7.9984764807,0.1269599441,0,-5.586237542,-5.586237542,1459
48483,"Wheeler","Texas","US","2020-05-24 02:32:43",35.40114335,-100.2699514,15,0,0,15,"Wheeler, Texas, US",5056,-102,53,64,-11,0,-93,-93,2,40,12.531819072,-2.153906403,0,-18.21029959,-18.21029959,3686
5145,"White","Arkansas","US","2020-05-24 02:32:43",35.25688493,-91.74908296,38,1,0,37,"White, Arkansas, US",78753,372,881,837,44,-27,360,333,-5,3175,10.653327733,0.5600315654,-0.343655733,4.5820764443,4.238420711,28555
13311,"White","Georgia","US","2020-05-24 02:32:43",34.64624278,-83.74905525,93,3,0,90,"White, Georgia, US",30798,810,288,316,-28,2,830,832,6,822,10.397130918,-0.921264765,0.0658046261,27.308919817,27.374724443,8873
17193,"White","Illinois","US","2020-05-24 02:32:43",38.08706198,-88.17657461,2,0,0,2,"White, Illinois, US",13537,-81,132,199,-67,2,-16,-14,0,391,14.656600994,-4.934634506,0.1473025226,-1.17842018,-1.031117658,5470
18181,"White","Indiana","US","2020-05-24 02:32:43",40.74911165,-86.86492015,212,8,0,204,"White, Indiana, US",24102,-31,291,282,9,28,-66,-38,-2,307,11.692754224,0.3731730072,1.1609826889,-2.736602052,-1.575619364,9606
47185,"White","Tennessee","US","2020-05-24 02:32:43",35.92929884,-85.45591799,24,0,0,24,"White, Tennessee, US",27345,259,292,369,-77,5,330,335,1,384,13.558450148,-2.829270085,0.1837188367,12.125443222,12.309162058,7478
32033,"White Pine","Nevada","US","2020-05-24 02:32:43",39.44157041,-114.899966,4,0,0,4,"White Pine, Nevada, US",9580,40,104,96,8,4,29,33,-1,1301,10.041841004,0.8368200837,0.4184100418,3.0334728033,3.4518828452,3863
17195,"Whiteside","Illinois","US","2020-05-24 02:32:43",41.75509713,-89.91556058,133,10,0,123,"Whiteside, Illinois, US",55175,-378,610,649,-39,-7,-330,-337,-2,1011,11.7224189,-0.704428871,-0.126435951,-5.960551983,-6.086987934,22390
13313,"Whitfield","Georgia","US","2020-05-24 02:32:43",34.80987459,-84.96093476,270,7,0,263,"Whitfield, Georgia, US",104628,379,1305,837,468,41,-130,-89,0,1126,8.0142859195,4.4811061055,0.3925755349,-1.244751696,-0.852176161,55650
18183,"Whitley","Indiana","US","2020-05-24 02:32:43",41.13863784,-85.50791236,34,2,0,32,"Whitley, Indiana, US",33964,-83,409,312,97,12,-192,-180,0,436,9.1749863993,2.8524797459,0.3528840923,-5.646145476,-5.293261384,12498
21235,"Whitley","Kentucky","US","2020-05-24 02:32:43",36.75700531,-84.14541217,13,0,0,13,"Whitley, Kentucky, US",36264,163,528,473,55,-6,115,109,-1,1762,13.072617978,1.5200718579,-0.165826021,3.1783320666,3.0125060457,12359
53075,"Whitman","Washington","US","2020-05-24 02:32:43",46.90022523,-117.5241763,16,0,0,16,"Whitman, Washington, US",50104,421,390,239,151,393,-121,272,-2,6797,4.7902031327,3.0264463307,7.8767775362,-2.425165603,5.4516119334,23635
48485,"Wichita","Texas","US","2020-05-24 02:32:43",33.98842886,-98.7041034,82,2,0,80,"Wichita, Texas, US",132230,423,1585,1363,222,160,45,205,-4,12787,10.324310608,1.6815825055,1.2119513553,0.3408613187,1.552812674,64389
24045,"Wicomico","Maryland","US","2020-05-24 02:32:43",38.37301947,-75.62705831,859,22,0,837,"Wicomico, Maryland, US",103609,565,1264,1066,198,185,186,371,-4,4876,10.316811273,1.9162557524,1.7904409808,1.8001190401,3.5905600209,47800
48487,"Wilbarger","Texas","US","2020-05-24 02:32:43",34.07945812,-99.24178437,6,0,0,6,"Wilbarger, Texas, US",12769,-8,154,143,11,2,-20,-18,-1,667,11.195490488,0.861191576,0.1565802865,-1.565802865,-1.409222579,6334
1131,"Wilcox","Alabama","US","2020-05-24 02:32:43",31.98773215,-87.30891118,113,7,0,106,"Wilcox, Alabama, US",10373,-226,133,162,-29,0,-197,-197,0,108,15.449170322,-2.765592218,0,-18.78695403,-18.78695403,2826
13315,"Wilcox","Georgia","US","2020-05-24 02:32:43",31.97496928,-83.43438555,98,13,0,85,"Wilcox, Georgia, US",8635,-192,78,88,-10,1,-184,-183,1,1854,10.079028748,-1.145344176,0.1145344176,-21.07433284,-20.95979842,1951
13317,"Wilkes","Georgia","US","2020-05-24 02:32:43",33.78290391,-82.74286107,32,1,0,31,"Wilkes, Georgia, US",9777,-87,95,147,-52,6,-39,-33,-2,183,14.968687949,-5.295046077,0.610966855,-3.971284558,-3.360317703,3302
37193,"Wilkes","North Carolina","US","2020-05-24 02:32:43",36.2084135,-81.16232895,472,3,0,469,"Wilkes, North Carolina, US",68412,-151,670,817,-147,52,-50,2,-6,915,11.929184158,-2.146377076,0.7592626392,-0.73006023,0.0292024092,23150
27167,"Wilkin","Minnesota","US","2020-05-24 02:32:43",46.35721532,-96.4684375,11,3,0,8,"Wilkin, Minnesota, US",6207,-37,73,83,-10,-5,-23,-28,1,152,13.332262469,-1.606296683,-0.803148341,-3.694482371,-4.497630712,2704
13319,"Wilkinson","Georgia","US","2020-05-24 02:32:43",32.80291082,-83.17140684,64,4,0,60,"Wilkinson, Georgia, US",8954,-89,104,127,-23,0,-65,-65,-1,180,14.113463355,-2.555981552,0,-7.223426127,-7.223426127,3041
28157,"Wilkinson","Mississippi","US","2020-05-24 02:32:43",31.16078225,-91.31018819,81,9,0,72,"Wilkinson, Mississippi, US",8630,-151,88,122,-34,-1,-116,-117,0,1109,14.014128999,-3.905576934,-0.11486991,-13.32490954,-13.43977945,2482
17197,"Will","Illinois","US","2020-05-24 02:32:43",41.44619267,-87.97862712,5012,257,0,4755,"Will, Illinois, US",690743,-406,7311,4812,2499,171,-3092,-2921,16,8748,6.9643647984,3.616780472,0.247486779,-4.475024097,-4.227537318,248101
48489,"Willacy","Texas","US","2020-05-24 02:32:43",26.47411727,-97.61535848,15,1,0,14,"Willacy, Texas, US",21358,-92,252,183,69,5,-168,-163,2,3320,8.549803775,3.2236965053,0.233601196,-7.849000187,-7.615398991,4510
38105,"Williams","North Dakota","US","2020-05-24 02:32:43",48.34522353,-103.4793387,25,0,0,25,"Williams, North Dakota, US",37589,2120,725,234,491,23,1601,1624,5,498,6.4058693093,13.441375346,0.629636727,43.8281913,44.457828027,25090
39171,"Williams","Ohio","US","2020-05-24 02:32:43",41.56052014,-84.58429552,51,1,0,50,"Williams, Ohio, US",36692,-47,408,393,15,-6,-53,-59,-3,990,10.703926135,0.408546799,-0.16341872,-1.443532023,-1.606950743,17130
45089,"Williamsburg","South Carolina","US","2020-05-24 02:32:43",33.62190129,-79.72767442,207,10,0,197,"Williamsburg, South Carolina, US",30368,-238,302,394,-92,28,-172,-144,-2,987,12.923541181,-3.017679667,0.9184242464,-5.641748942,-4.723324696,9227
51830,"Williamsburg","Virginia","US","2020-05-24 02:32:43",37.28131268,-76.70905141,43,3,0,40,"Williamsburg, Virginia, US",14954,-48,77,74,3,40,-90,-50,-1,4281,4.9405795166,0.2002937642,2.6705835225,-6.008812926,-3.338229403,13901
17199,"Williamson","Illinois","US","2020-05-24 02:32:43",37.73033511,-88.92994027,54,1,0,53,"Williamson, Illinois, US",66597,-385,716,769,-53,28,-359,-331,-1,2001,11.51378585,-0.793537906,0.4192275732,-5.375096385,-4.955868812,28748
47187,"Williamson","Tennessee","US","2020-05-24 02:32:43",35.89099229,-86.89281867,503,10,0,493,"Williamson, Tennessee, US",238412,6434,2357,1325,1032,574,4835,5409,-7,1242,5.6336231638,4.3878483811,2.4405280725,20.557409809,22.997937881,116137
48491,"Williamson","Texas","US","2020-05-24 02:32:43",30.64655664,-97.6004854,541,21,0,520,"Williamson, Texas, US",590551,24088,6685,3009,3676,799,19513,20312,100,4318,5.2013199495,6.3542878479,1.3811414555,33.729928938,35.111070393,167817
20205,"Wilson","Kansas","US","2020-05-24 02:32:43",37.55937174,-95.74323255,1,0,0,1,"Wilson, Kansas, US",8525,-141,107,110,-3,1,-141,-140,2,121,12.797393985,-0.349019836,0.1163399453,-16.40393229,-16.28759234,3898
37195,"Wilson","North Carolina","US","2020-05-24 02:32:43",35.70625477,-77.917978,309,9,0,300,"Wilson, North Carolina, US",81801,409,944,944,0,77,336,413,-4,1540,11.569123676,0,0.9436679269,4.1178236812,5.0614916081,37867
47189,"Wilson","Tennessee","US","2020-05-24 02:32:43",36.15496772,-86.29775884,343,8,0,335,"Wilson, Tennessee, US",144657,3703,1635,1167,468,156,3070,3226,9,1591,8.1719541614,3.2771847023,1.0923949008,21.497771444,22.590166345,43731
48493,"Wilson","Texas","US","2020-05-24 02:32:43",29.1732598,-98.08693082,38,5,0,33,"Wilson, Texas, US",51070,874,534,415,119,17,740,757,-2,498,8.1962356566,2.3502458871,0.3357494124,14.614974424,14.950723836,10372
51840,"Winchester","Virginia","US","2020-05-24 02:32:43",39.17054517,-78.17325058,128,1,0,127,"Winchester, Virginia, US",28078,116,338,256,82,80,-44,36,-2,1079,9.136331192,2.9264810849,2.8551034975,-1.570306924,1.2847965739,25065
9015,"Windham","Connecticut","US","2020-05-24 02:32:43",41.82972709,-71.98182316,354,14,0,340,"Windham, Connecticut, US",116782,-277,1060,1068,-8,117,-384,-267,-2,4662,9.1344118439,-0.068422561,1.0006799492,-3.28428291,-2.283602961,42548
50025,"Windham","Vermont","US","2020-05-24 02:32:43",42.986982,-72.71268875,80,3,0,77,"Windham, Vermont, US",42222,-413,348,426,-78,-2,-334,-336,1,1361,10.040420943,-1.838386933,-0.047138126,-7.872067125,-7.919205251,24515
50027,"Windsor","Vermont","US","2020-05-24 02:32:43",43.58010937,-72.58595157,49,2,0,47,"Windsor, Vermont, US",55062,-142,439,539,-100,21,-59,-38,-4,761,9.7763589865,-1.81379573,0.3808971034,-1.070139481,-0.689242378,25290
48495,"Winkler","Texas","US","2020-05-24 02:32:43",31.85008651,-103.0485163,3,0,0,3,"Winkler, Texas, US",8010,232,127,49,78,21,131,152,2,97,6.2072460096,9.8809222194,2.6602482898,16.594882189,19.255130479,2774
22127,"Winn","Louisiana","US","2020-05-24 02:32:43",31.94449367,-92.63789413,112,2,0,110,"Winn, Louisiana, US",13904,-234,151,215,-64,-2,-169,-171,1,1764,15.334141645,-4.564581699,-0.142643178,-12.05334855,-12.19599173,4414
17201,"Winnebago","Illinois","US","2020-05-24 02:32:43",42.33641854,-89.16085327,1838,49,0,1789,"Winnebago, Illinois, US",282572,-1058,3445,2928,517,329,-1907,-1578,3,4742,10.342598578,1.8262033691,1.1621294167,-6.736111847,-5.57398243,134228
19189,"Winnebago","Iowa","US","2020-05-24 02:32:43",43.37751174,-93.73407298,10,0,0,10,"Winnebago, Iowa, US",10354,-185,95,119,-24,1,-162,-161,0,472,11.391375102,-2.297420189,0.0957258412,-15.50758627,-15.41186043,5574
55139,"Winnebago","Wisconsin","US","2020-05-24 02:32:43",44.06886922,-88.64477096,166,1,0,165,"Winnebago, Wisconsin, US",171907,1029,1783,1497,286,65,683,748,-5,7711,8.7343378503,1.6686844524,0.3792464664,3.9850051782,4.3642516446,95073
19191,"Winneshiek","Iowa","US","2020-05-24 02:32:43",43.29094334,-91.84422722,21,0,0,21,"Winneshiek, Iowa, US",19991,-26,174,187,-13,4,-16,-12,-1,1974,9.3481303739,-0.649870026,0.199960008,-0.799840032,-0.599880024,12426
27169,"Winona","Minnesota","US","2020-05-24 02:32:43",43.98772283,-91.78081305,77,15,0,62,"Winona, Minnesota, US",50484,-251,456,440,16,25,-292,-267,0,3915,8.6940198975,0.3161461781,0.4939784033,-5.76966775,-5.275689347,27665
1133,"Winston","Alabama","US","2020-05-24 02:32:43",34.15030532,-87.37325922,61,0,0,61,"Winston, Alabama, US",23629,-64,243,325,-82,2,17,19,-1,301,13.735683192,-3.465618528,0.0845272812,0.71848189,0.8030091712,8016
28159,"Winston","Mississippi","US","2020-05-24 02:32:43",33.08747908,-89.03391385,98,1,0,97,"Winston, Mississippi, US",17955,-209,190,250,-60,0,-150,-150,1,459,13.843129655,-3.322351117,0,-8.305877793,-8.305877793,5813
54105,"Wirt","West Virginia","US","2020-05-24 02:32:43",39.02775007,-81.37473928,4,0,0,4,"Wirt, West Virginia, US",5821,10,47,54,-7,0,16,16,1,0,9.2847317744,-1.203576341,0,2.7510316369,2.7510316369,834
48497,"Wise","Texas","US","2020-05-24 02:32:43",33.21570665,-97.65460265,42,2,0,40,"Wise, Texas, US",69984,1700,789,635,154,14,1530,1544,2,807,9.1850608962,2.2275580756,0.2025052796,22.130934128,22.333439408,21003
51195,"Wise","Virginia","US","2020-05-24 02:32:43",36.9746148,-82.62410519,24,2,0,22,"Wise, Virginia, US",37383,-492,336,479,-143,-1,-348,-349,0,2906,12.729543703,-3.800260437,-0.026575248,-9.248186239,-9.274761487,17128
21237,"Wolfe","Kentucky","US","2020-05-24 02:32:43",37.73941626,-83.49303612,1,0,0,1,"Wolfe, Kentucky, US",7157,-42,86,101,-15,-4,-24,-28,1,132,14.070771803,-2.089718585,-0.557258289,-3.343549735,-3.900808025,1360
39173,"Wood","Ohio","US","2020-05-24 02:32:43",41.36224827,-83.62285108,269,45,0,224,"Wood, Ohio, US",130817,376,1319,1115,204,83,96,179,-7,6655,8.5356237895,1.5616746664,0.6353872417,0.7349057254,1.3702929671,66097
48499,"Wood","Texas","US","2020-05-24 02:32:43",32.78722382,-95.38236368,22,1,0,21,"Wood, Texas, US",45539,382,403,647,-244,-4,629,625,1,1761,14.267442886,-5.380612155,-0.088206757,13.870512481,13.782305725,12483
54107,"Wood","West Virginia","US","2020-05-24 02:32:43",39.20967886,-81.5162836,48,2,0,46,"Wood, West Virginia, US",83518,-662,869,1078,-209,-24,-429,-453,0,1008,12.856444323,-2.49257594,-0.286228816,-5.116340088,-5.402568904,39333
55141,"Wood","Wisconsin","US","2020-05-24 02:32:43",44.45537896,-90.04158336,9,1,0,8,"Wood, Wisconsin, US",72999,45,798,724,74,17,-42,-25,-4,764,9.9210019664,1.0140250629,0.2329517036,-0.575527738,-0.342576035,39697
19193,"Woodbury","Iowa","US","2020-05-24 02:32:43",42.38979414,-96.0459439,2520,23,0,2497,"Woodbury, Iowa, US",103107,592,1390,900,490,100,7,107,-5,2446,8.753927109,4.7660269815,0.9726585677,0.0680860997,1.0407446674,49899
17203,"Woodford","Illinois","US","2020-05-24 02:32:43",40.78579374,-89.20973757,17,2,0,15,"Woodford, Illinois, US",38459,-68,418,391,27,6,-100,-94,-1,1005,10.157691009,0.7014262333,0.1558724963,-2.597874938,-2.442002442,11228
21239,"Woodford","Kentucky","US","2020-05-24 02:32:43",38.04178222,-84.7417556,25,0,0,25,"Woodford, Kentucky, US",26734,243,280,232,48,1,195,196,-1,495,8.7177078441,1.8036636919,0.0375763269,7.3273837482,7.3649600752,10089
5147,"Woodruff","Arkansas","US","2020-05-24 02:32:43",35.18902527,-91.2439489,1,0,0,1,"Woodruff, Arkansas, US",6320,-146,70,102,-32,0,-112,-112,-2,106,15.954950727,-5.005474738,0,-17.51916158,-17.51916158,2099
40151,"Woods","Oklahoma","US","2020-05-24 02:32:43",36.76705782,-98.86573064,3,0,0,3,"Woods, Oklahoma, US",8793,-100,96,100,-4,6,-103,-97,1,996,11.308379509,-0.45233518,0.6785027706,-11.64763089,-10.96912812,5168
20207,"Woodson","Kansas","US","2020-05-24 02:32:43",37.8865336,-95.74006277,6,0,0,6,"Woodson, Kansas, US",3138,-46,35,40,-5,0,-40,-40,-1,39,12.654223347,-1.581777918,0,-12.65422335,-12.65422335,1006
40153,"Woodward","Oklahoma","US","2020-05-24 02:32:43",36.42316318,-99.26283045,3,0,0,3,"Woodward, Oklahoma, US",20211,-101,247,222,25,22,-148,-126,0,1231,10.956740616,1.2338671865,1.0858031242,-7.304493744,-6.21869062,10149
24047,"Worcester","Maryland","US","2020-05-24 02:32:43",38.21274277,-75.33200012,180,8,0,172,"Worcester, Maryland, US",52276,316,402,676,-274,17,576,593,-3,723,12.970566791,-5.257300741,0.3261828927,11.051843893,11.378026785,25015
25027,"Worcester","Massachusetts","US","2020-05-24 02:32:43",42.35026951,-71.90493363,10251,667,0,9584,"Worcester, Massachusetts, US",830622,1568,8515,7345,1170,2155,-1743,412,-14,28101,8.8511251594,1.4099137422,2.5968924055,-2.10040996,0.496482446,343918
13321,"Worth","Georgia","US","2020-05-24 02:32:43",31.55162306,-83.85090513,204,19,0,185,"Worth, Georgia, US",20247,-55,213,230,-17,0,-38,-38,0,177,11.34429949,-0.838491701,0,-1.874275568,-1.874275568,4069
19195,"Worth","Iowa","US","2020-05-24 02:32:43",43.37750768,-93.26087602,3,0,0,3,"Worth, Iowa, US",7381,-32,77,69,8,0,-40,-40,0,67,9.3281059889,1.0815195349,0,-5.407597675,-5.407597675,2475
29227,"Worth","Missouri","US","2020-05-24 02:32:43",40.47945588,-94.42328751,3,0,0,3,"Worth, Missouri, US",2013,-13,23,18,5,0,-18,-18,0,52,8.9130973013,2.4758603615,0,-8.913097301,-8.913097301,679
19197,"Wright","Iowa","US","2020-05-24 02:32:43",42.73305373,-93.73515113,98,0,0,98,"Wright, Iowa, US",12562,-128,154,161,-7,11,-132,-121,0,199,12.75146523,-0.554411532,0.8712181213,-10.45461746,-9.583399335,6145
27171,"Wright","Minnesota","US","2020-05-24 02:32:43",45.17297924,-93.96234781,231,1,0,230,"Wright, Minnesota, US",138377,2064,1734,832,902,41,1132,1173,-11,1105,6.0577378135,6.5674032546,0.2985183298,8.2420182751,8.5405366049,42595
29229,"Wright","Missouri","US","2020-05-24 02:32:43",37.27029221,-92.46914488,11,0,0,11,"Wright, Missouri, US",18289,102,243,243,0,-7,111,104,-2,195,13.323829367,0,-0.383814015,6.0861936616,5.7023796469,4969
39175,"Wyandot","Ohio","US","2020-05-24 02:32:43",40.84339621,-83.30734173,36,2,0,34,"Wyandot, Ohio, US",21772,-146,221,253,-32,-5,-108,-113,-1,251,11.58159762,-1.464866102,-0.228885328,-4.943923095,-5.172808423,8565
20209,"Wyandotte","Kansas","US","2020-05-24 02:32:43",39.11727348,-94.76378225,1255,71,0,1184,"Wyandotte, Kansas, US",165429,108,2477,1423,1054,500,-1445,-945,-1,1335,8.604686319,6.373393802,3.0234315949,-8.737717309,-5.714285714,84938
36121,"Wyoming","New York","US","2020-05-24 02:32:43",42.70145109,-78.22199579,80,5,0,75,"Wyoming, New York, US",39859,-164,328,345,-17,1,-147,-146,-1,3341,8.6377406675,-0.425627801,0.0250369295,-3.680428632,-3.655391703,15379
42131,"Wyoming","Pennsylvania","US","2020-05-24 02:32:43",41.51955538,-76.01074915,33,7,0,26,"Wyoming, Pennsylvania, US",26794,-293,259,321,-62,3,-234,-231,0,618,11.915146341,-2.301367829,0.1113565079,-8.685807613,-8.574451105,12622
54109,"Wyoming","West Virginia","US","2020-05-24 02:32:43",37.612327,-81.54511071,3,0,0,3,"Wyoming, West Virginia, US",20394,-390,180,346,-166,0,-227,-227,3,56,16.805090097,-8.062557676,0,-11.02530477,-11.02530477,5218
51197,"Wythe","Virginia","US","2020-05-24 02:32:43",36.91582035,-81.07834059,17,1,0,16,"Wythe, Virginia, US",28684,-14,299,397,-98,-7,94,87,-3,260,13.837091771,-3.415705273,-0.243978948,3.2762887317,3.0323097836,13070
37197,"Yadkin","North Carolina","US","2020-05-24 02:32:43",36.16222629,-80.66239436,131,1,0,130,"Yadkin, North Carolina, US",37667,186,379,426,-47,18,218,236,-3,276,11.337627083,-1.25086496,0.4790546655,5.8018842817,6.2809389471,10823
53077,"Yakima","Washington","US","2020-05-24 02:32:43",46.45738486,-120.7380126,2594,83,0,2511,"Yakima, Washington, US",250873,311,3746,2093,1653,-137,-1203,-1340,-2,3504,8.348041122,6.5930778665,-0.546431741,-4.798229083,-5.344660823,98310
28161,"Yalobusha","Mississippi","US","2020-05-24 02:32:43",34.02824175,-89.7076205,82,4,0,78,"Yalobusha, Mississippi, US",12108,-253,145,165,-20,-3,-231,-234,1,151,13.486452246,-1.634721484,-0.245208223,-18.88103314,-19.12624137,3245
41071,"Yamhill","Oregon","US","2020-05-24 02:32:43",45.23330449,-123.3086963,64,7,0,57,"Yamhill, Oregon, US",107100,733,1096,904,192,-45,586,541,0,5438,8.4696932078,1.7988728937,-0.421610834,5.4903099777,5.0686991432,36217
37199,"Yancey","North Carolina","US","2020-05-24 02:32:43",35.90079156,-82.31237181,10,0,0,10,"Yancey, North Carolina, US",18069,196,181,211,-30,-2,227,225,1,152,11.741138501,-1.669356185,-0.111290412,12.6314618,12.520171387,4763
46135,"Yankton","South Dakota","US","2020-05-24 02:32:43",43.00924485,-97.39467635,46,0,0,46,"Yankton, South Dakota, US",22814,55,261,207,54,1,2,3,-2,2291,9.0843262458,2.369824238,0.043885634,0.0877712681,0.1316569021,12651
36123,"Yates","New York","US","2020-05-24 02:32:43",42.63505484,-77.10369919,37,4,0,33,"Yates, New York, US",24913,-38,316,267,49,10,-98,-88,1,1380,10.70912883,1.9653457404,0.4010909674,-3.930691481,-3.529600513,8768
4025,"Yavapai","Arizona","US","2020-05-24 02:32:43",34.59933926,-112.5538588,284,6,0,278,"Yavapai, Arizona, US",235099,3327,1782,3042,-1260,-72,4636,4564,23,4140,13.031436949,-5.397636606,-0.308436378,19.85987564,19.551439263,75612
28163,"Yazoo","Mississippi","US","2020-05-24 02:32:43",32.77890365,-90.39656148,204,2,0,202,"Yazoo, Mississippi, US",29690,597,312,278,34,43,515,558,5,6966,9.4585169182,1.1567970332,1.4630080125,17.522072708,18.985080721,6941
5149,"Yell","Arkansas","US","2020-05-24 02:32:43",35.00292371,-93.41171338,94,1,0,93,"Yell, Arkansas, US",21341,-121,258,244,14,-2,-133,-135,0,323,11.401070018,0.6541597552,-0.093451394,-6.214517674,-6.307969068,6253
27173,"Yellow Medicine","Minnesota","US","2020-05-24 02:32:43",44.71710183,-95.86842453,5,0,0,5,"Yellow Medicine, Minnesota, US",9709,-90,108,95,13,2,-104,-102,-1,290,9.7395940127,1.3327865491,0.2050440845,-10.66229239,-10.45724831,4645
30111,"Yellowstone","Montana","US","2020-05-24 02:32:43",45.93955949,-108.2691486,88,2,0,86,"Yellowstone, Montana, US",161300,1271,1857,1485,372,43,858,901,-2,3694,9.2428632336,2.3153839212,0.267638464,5.3403209794,5.6079594434,79761
48501,"Yoakum","Texas","US","2020-05-24 02:32:43",33.17320212,-102.8276433,3,0,0,3,"Yoakum, Texas, US",8713,123,151,52,99,48,-24,24,0,54,6.0105184072,11.443102352,5.5481708374,-2.774085419,2.7740854187,3950
6113,"Yolo","California","US","2020-05-24 02:32:43",38.68278902,-121.9018288,190,22,0,168,"Yolo, California, US",220500,382,2215,1386,829,857,-1312,-455,8,10389,6.2911637745,3.7628966588,3.8899908765,-5.955271914,-2.065281037,104169
23031,"York","Maine","US","2020-05-24 02:32:43",43.47808377,-70.71052375,337,8,0,329,"York, Maine, US",207641,1772,1805,2083,-278,5,2047,2052,-2,3585,10.074726125,-1.344586588,0.024183212,9.9006069986,9.9247902106,72315
31185,"York","Nebraska","US","2020-05-24 02:32:43",40.87272618,-97.59710186,35,0,0,35,"York, Nebraska, US",13679,-69,170,135,35,1,-104,-103,-1,779,9.8443139972,2.5522295548,0.0729208444,-7.58376782,-7.510846976,8200
42133,"York","Pennsylvania","US","2020-05-24 02:32:43",39.9210089,-76.73040131,904,22,0,882,"York, Pennsylvania, US",449058,1211,4868,4121,747,200,291,491,-27,8620,9.1893790312,1.6657282544,0.4459781136,0.6488981553,1.0948762689,178610
45091,"York","South Carolina","US","2020-05-24 02:32:43",34.97281497,-81.18085944,339,6,0,333,"York, South Carolina, US",280979,7197,2965,2227,738,188,6252,6440,19,3435,8.0286826219,2.6606051976,0.6777693457,22.539435901,23.217205247,91828
51199,"York","Virginia","US","2020-05-24 02:32:43",37.24374789,-76.54412815,67,3,0,64,"York, Virginia, US",68280,304,596,523,73,67,171,238,-7,647,7.6767261625,1.0715124472,0.983442931,2.5099812118,3.4934241428,24639
48503,"Young","Texas","US","2020-05-24 02:32:43",33.17659707,-98.68790885,4,1,0,3,"Young, Texas, US",18010,24,198,234,-36,9,52,61,-1,254,13.001444605,-2.000222247,0.5000555617,2.8892099122,3.3892654739,8155
6115,"Yuba","California","US","2020-05-24 02:32:43",39.26255932,-121.3535644,28,1,0,27,"Yuba, California, US",78668,1111,1149,583,566,0,542,542,3,1113,7.4635941751,7.2459593535,0,6.9387101936,6.9387101936,23818
2290,"Yukon-Koyukuk","Alaska","US","2020-05-24 02:32:43",65.50815459,-151.3907387,1,0,0,1,"Yukon-Koyukuk, Alaska, US",5230,-129,76,69,7,2,-139,-137,1,31,13.032392105,1.3221267353,0.3777504958,-26.25365946,-25.87590896,2119
4027,"Yuma","Arizona","US","2020-05-24 02:32:43",32.76895712,-113.9066674,604,10,0,594,"Yuma, Arizona, US",213787,2175,2991,1713,1278,546,357,903,-6,9459,8.0536155468,6.0084767477,2.567001803,1.6784242558,4.2454260588,71353
8125,"Yuma","Colorado","US","2020-05-24 02:32:43",40.00346839,-102.4258673,15,0,0,15,"Yuma, Colorado, US",10019,72,135,93,42,47,-17,30,0,196,9.3158369228,4.2071521587,4.7080036061,-1.702894921,3.0051086848,5030
48505,"Zapata","Texas","US","2020-05-24 02:32:43",27.00156391,-99.16987152,8,0,0,8,"Zapata, Texas, US",14179,30,214,110,104,-9,-66,-75,1,30,7.7661677492,7.3425585993,-0.635413725,-4.65970065,-5.295114374,4534
48507,"Zavala","Texas","US","2020-05-24 02:32:43",28.86617238,-99.76050829,11,0,0,11,"Zavala, Texas, US",11840,-129,153,104,49,-2,-175,-177,-1,413,8.7361921962,4.116090554,-0.168003696,-14.70032341,-14.8683271,3650
46137,"Ziebach","South Dakota","US","2020-05-24 02:32:43",44.97881876,-101.6654622,1,0,0,1,"Ziebach, South Dakota, US",2756,12,23,25,-2,0,14,14,0,0,9.0909090909,-0.727272727,0,5.0909090909,5.0909090909,660
