"FIPS","County","State","Lat","Long","Confirmed","Deaths","Recovered","Active","Name","POPESTIMATE2019","NPOPCHG_2019","BIRTHS2019","DEATHS2019","NATURALINC2019","INTERNATIONALMIG2019","DOMESTICMIG2019","NETMIG2019","CommutingIn","TotEmp","QPayroll","APayroll","Establishments"
45001,"Abbeville","South Carolina",34.22333378,-82.46170658,35,0,0,35,"Abbeville, South Carolina, US",24527,-60,231,275,-44,-11,-3,-14,5673,14027,110246,453424,1641
22001,"Acadia","Louisiana",30.2950649,-92.41419698,289,15,0,274,"Acadia, Louisiana, US",62045,-169,816,690,126,17,-312,-295,15643,66211,501682,2053533,6199
51001,"Accomack","Virginia",37.76707161,-75.63234615,722,11,0,711,"Accomack, Virginia, US",32316,-265,384,489,-105,30,-186,-156,13136,43546,295760,1282316,4050
16001,"Ada","Idaho",43.4526575,-116.2415516,794,23,0,771,"Ada, Idaho, US",481587,12823,4980,3055,1925,26,10815,10841,215983,1122200,12019270,50981403,81943
19001,"Adair","Iowa",41.33075609,-94.47105874,7,0,0,7,"Adair, Iowa, US",7152,78,84,77,7,2,71,73,2968,6739,43614,188457,900
21001,"Adair","Kentucky",37.10459774,-85.28129668,96,18,0,78,"Adair, Kentucky, US",19202,3,184,216,-32,-1,38,37,5504,13387,90240,369764,1403
29001,"Adair","Missouri",40.19058551,-92.60078167,38,0,0,38,"Adair, Missouri, US",25343,-133,267,193,74,99,-307,-208,11712,30806,222055,910414,3224
40001,"Adair","Oklahoma",35.88494195,-94.65859267,82,3,0,79,"Adair, Oklahoma, US",22194,-30,309,285,24,3,-58,-55,6280,10073,69566,282175,992
8001,"Adams","Colorado",39.87432092,-104.3362578,2856,112,0,2744,"Adams, Colorado, US",517421,6067,6777,3208,3569,1204,1283,2487,175518,990924,11496335,48226456,59774
16003,"Adams","Idaho",44.89333571,-116.4545247,3,0,0,3,"Adams, Idaho, US",4294,60,31,27,4,1,56,57,1216,1613,10765,51357,415
17001,"Adams","Illinois",39.98815591,-91.18786813,44,1,0,43,"Adams, Illinois, US",65435,-188,776,850,-74,18,-131,-113,34891,152486,1438722,6099616,10287
18001,"Adams","Indiana",40.7457653,-84.93671406,12,1,0,11,"Adams, Indiana, US",35777,182,676,261,415,8,-239,-231,14115,48421,379368,1615465,3913
19003,"Adams","Iowa",41.02903567,-94.69932645,4,0,0,4,"Adams, Iowa, US",3602,-42,29,38,-9,0,-35,-35,1587,2914,27028,110738,385
28001,"Adams","Mississippi",31.47669768,-91.35326037,181,15,0,166,"Adams, Mississippi, US",30693,-351,340,429,-89,151,-414,-263,11415,47990,370646,1475754,4324
31001,"Adams","Nebraska",40.5244942,-98.50117804,264,11,0,253,"Adams, Nebraska, US",31363,-151,391,316,75,59,-286,-227,15253,60292,478464,2086539,5224
39001,"Adams","Ohio",38.84541072,-83.4718964,8,1,0,7,"Adams, Ohio, US",27698,4,346,326,20,5,-21,-16,7109,17492,125579,539207,1983
42001,"Adams","Pennsylvania",39.87140411,-77.21610347,222,6,0,216,"Adams, Pennsylvania, US",103009,-53,960,1013,-53,54,-50,4,34853,140341,1165943,4973107,11171
53001,"Adams","Washington",46.98299757,-118.5601734,50,0,0,50,"Adams, Washington, US",19983,247,388,100,288,24,-65,-41,7733,19756,175192,831246,1835
55001,"Adams","Wisconsin",43.96974651,-89.76782777,4,1,0,3,"Adams, Wisconsin, US",20220,-121,123,252,-129,8,1,9,4373,11786,72517,344400,1590
50001,"Addison","Vermont",44.03217337,-73.14130877,62,2,0,60,"Addison, Vermont, US",36777,-96,299,341,-42,20,-72,-52,16116,49739,460533,2018090,6421
45003,"Aiken","South Carolina",33.54338026,-81.63645384,169,7,0,162,"Aiken, South Carolina, US",170872,1423,1830,1824,6,140,1272,1412,64571,220632,2055833,8518964,16220
27001,"Aitkin","Minnesota",46.60962049,-93.4116826,6,0,0,6,"Aitkin, Minnesota, US",15886,-1,124,207,-83,-1,84,83,4961,13372,85311,385889,1961
12001,"Alachua","Florida",29.67866525,-82.35928158,355,7,0,348,"Alachua, Florida, US",269043,192,2775,2081,694,798,-1302,-504,130130,543796,5520716,22645857,36606
37001,"Alamance","North Carolina",36.0434701,-79.39976137,268,20,0,248,"Alamance, North Carolina, US",169509,2995,1976,1646,330,67,2588,2655,61254,297306,2577319,10804701,19270
6001,"Alameda","California",37.64629437,-121.8929271,2760,92,0,2668,"Alameda, California, US",1671329,4573,18628,10944,7684,8540,-11626,-3086,699741,4017517,69562656,284035628,240019
8003,"Alamosa","Colorado",37.57250606,-105.7885451,55,2,0,53,"Alamosa, Colorado, US",16233,-15,198,115,83,-4,-93,-97,8340,24584,199796,815535,2607
36001,"Albany","New York",42.60060306,-73.97723916,1770,76,0,1694,"Albany, New York, US",305506,-1079,3024,2776,248,546,-1872,-1326,221934,1036064,12703765,51441941,56653
56001,"Albany","Wyoming",41.65498705,-105.7235415,14,0,0,14,"Albany, Wyoming, US",38880,152,341,198,143,259,-253,6,19737,46713,362738,1529387,5696
51003,"Albemarle","Virginia",38.02080697,-78.55481085,143,5,0,138,"Albemarle, Virginia, US",109330,953,1061,894,167,133,656,789,55872,218549,2468502,9982727,16314
26001,"Alcona","Michigan",44.6846864,-83.59507875,10,1,0,9,"Alcona, Michigan, US",10405,45,57,167,-110,3,150,153,2021,4600,33237,149942,786
28003,"Alcorn","Mississippi",34.88084463,-88.57996173,15,1,0,14,"Alcorn, Mississippi, US",36953,143,411,457,-46,-7,197,190,14949,53223,407812,1704498,4129
17003,"Alexander","Illinois",37.18049267,-89.32910838,8,0,0,8,"Alexander, Illinois, US",5761,-280,54,72,-18,0,-263,-263,1780,2146,17977,71844,307
37003,"Alexander","North Carolina",35.9223796,-81.17751948,27,0,0,27,"Alexander, North Carolina, US",37497,166,363,399,-36,0,203,203,10362,37984,294839,1227043,2901
51510,"Alexandria","Virginia",38.814003,-77.08183073,1703,38,0,1665,"Alexandria, Virginia, US",159428,359,2566,782,1784,1208,-2615,-1407,99181,469373,7450151,29696460,27467
40003,"Alfalfa","Oklahoma",36.73090616,-98.32408495,1,0,0,1,"Alfalfa, Oklahoma, US",5702,-63,47,54,-7,6,-62,-56,2335,3441,29534,124983,575
19005,"Allamakee","Iowa",43.28383218,-91.37860922,118,4,0,114,"Allamakee, Iowa, US",13687,-165,192,178,14,16,-194,-178,5310,14852,112009,507199,1936
26005,"Allegan","Michigan",42.59147037,-85.89102866,202,7,0,195,"Allegan, Michigan, US",118081,908,1285,925,360,49,504,553,41136,182345,1867184,8146257,13648
24001,"Allegany","Maryland",39.62357628,-78.69280486,168,14,0,154,"Allegany, Maryland, US",70416,-525,640,874,-234,42,-332,-290,32388,111362,860775,3656611,8709
36003,"Allegany","New York",42.25748406,-78.02750466,44,0,0,44,"Allegany, New York, US",46091,-241,445,460,-15,28,-254,-226,16746,46440,306233,1344282,4057
37005,"Alleghany","North Carolina",36.49360862,-81.12857041,13,0,0,13,"Alleghany, North Carolina, US",11137,-1,99,133,-34,5,29,34,4016,8444,53605,238150,1124
51005,"Alleghany","Virginia",37.78636074,-80.00222498,13,2,0,11,"Alleghany, Virginia, US",14860,-126,121,238,-117,-5,-3,-8,6499,10291,70686,285834,1132
42003,"Allegheny","Pennsylvania",40.46809875,-79.98167747,1753,158,0,1595,"Allegheny, Pennsylvania, US",1216045,-1236,12668,13695,-1027,2392,-2543,-151,688112,4215800,57256354,222864369,202097
18003,"Allen","Indiana",41.09194313,-85.06800636,1213,65,0,1148,"Allen, Indiana, US",379299,4220,5155,3162,1993,747,1492,2239,180250,1007583,10546603,42231527,54565
20001,"Allen","Kansas",37.88582951,-95.30030847,1,0,0,1,"Allen, Kansas, US",12369,-132,138,161,-23,8,-115,-107,6518,15144,118703,472406,1842
21003,"Allen","Kentucky",36.75197631,-86.19457544,47,2,0,45,"Allen, Kentucky, US",21315,193,239,242,-3,1,195,196,5652,10358,72262,300550,1034
22003,"Allen","Louisiana",30.65385745,-92.82442028,182,10,0,172,"Allen, Louisiana, US",25627,60,315,242,73,-3,-9,-12,8103,13515,93744,380133,1482
39003,"Allen","Ohio",40.77285242,-84.10802343,184,31,0,153,"Allen, Ohio, US",102351,-374,1214,1079,135,-8,-501,-509,52798,240472,2309523,9272144,13708
45005,"Allendale","South Carolina",32.98837386,-81.35321066,34,3,0,31,"Allendale, South Carolina, US",8688,-236,81,102,-21,9,-226,-217,3003,4540,49791,187821,496
26007,"Alpena","Michigan",45.03477666,-83.62212411,94,9,0,85,"Alpena, Michigan, US",28405,21,280,342,-62,8,76,84,12933,44586,351624,1524870,4094
6003,"Alpine","California",38.59678594,-119.8223594,2,0,0,2,"Alpine, California, US",1129,40,10,5,5,1,35,36,689,669,3825,12308,85
6005,"Amador","California",38.44583082,-120.65696,10,0,0,10,"Amador, California, US",39752,347,307,427,-120,17,451,468,11906,37380,304423,1294520,4482
51007,"Amelia","Virginia",37.34081025,-77.98584649,22,1,0,21,"Amelia, Virginia, US",13145,88,150,150,0,1,88,89,2800,7961,55334,234370,1311
51009,"Amherst","Virginia",37.60308293,-79.14548696,25,0,0,25,"Amherst, Virginia, US",31605,-79,306,382,-76,1,0,1,9477,24245,186472,771082,2958
28005,"Amite","Mississippi",31.17467303,-90.80501621,50,1,0,49,"Amite, Mississippi, US",12297,-30,125,145,-20,-2,-7,-9,2248,5310,42438,171386,787
2020,"Anchorage","Alaska",61.14998174,-149.1426986,206,4,0,202,"Anchorage, Alaska, US",288000,-2521,3923,1847,2076,364,-4972,-4608,166563,835285,12243666,50011883,52133
20003,"Anderson","Kansas",38.21413251,-95.29272815,1,0,0,1,"Anderson, Kansas, US",7858,10,102,96,6,-4,8,4,2312,4819,32914,138687,871
21005,"Anderson","Kentucky",38.00671029,-84.99171713,15,1,0,14,"Anderson, Kentucky, US",22747,106,252,211,41,6,59,65,4961,12889,93796,390730,1574
45007,"Anderson","South Carolina",34.51828081,-82.63959517,218,8,0,210,"Anderson, South Carolina, US",202558,2266,2266,2200,66,67,2133,2200,67805,308936,2774925,11372615,22112
47001,"Anderson","Tennessee",36.12684348,-84.19965764,39,1,0,38,"Anderson, Tennessee, US",76978,691,792,932,-140,51,783,834,46938,181361,2436441,10141552,8834
48001,"Anderson","Texas",31.81534745,-95.65354823,63,0,0,63,"Anderson, Texas, US",57735,-239,588,754,-166,32,-104,-72,19817,50834,419257,1738845,4844
29003,"Andrew","Missouri",39.98492163,-94.80163024,20,0,0,20,"Andrew, Missouri, US",17712,50,190,161,29,-2,24,22,2717,6880,48428,211455,1341
48003,"Andrews","Texas",32.30468633,-102.6376548,22,0,0,22,"Andrews, Texas, US",18705,694,286,189,97,14,583,597,7791,25894,366622,1575514,2084
23001,"Androscoggin","Maine",44.1664747,-70.20380627,227,2,0,225,"Androscoggin, Maine, US",108277,363,1208,1084,124,92,150,242,49061,222457,2104237,8811367,16128
48005,"Angelina","Texas",31.25457347,-94.60901487,168,2,0,166,"Angelina, Texas, US",86715,-95,1071,997,74,6,-173,-167,36651,145545,1186162,4874211,10663
24003,"Anne Arundel","Maryland",39.00670238,-76.60329337,3282,150,0,3132,"Anne Arundel, Maryland, US",579234,3711,6782,4661,2121,436,1162,1598,284090,1355761,18314129,73359000,85481
27003,"Anoka","Minnesota",45.27476015,-93.24604565,1092,55,0,1037,"Anoka, Minnesota, US",356921,3480,4218,2166,2052,234,1216,1450,119433,660969,6980811,29729183,46691
37007,"Anson","North Carolina",34.97403241,-80.09953279,58,0,0,58,"Anson, North Carolina, US",24446,-24,253,272,-19,29,-33,-4,8046,20225,130515,535745,1987
31003,"Antelope","Nebraska",42.17695516,-98.0666283,7,0,0,7,"Antelope, Nebraska, US",6298,-10,80,59,21,4,-35,-31,2794,6221,48483,220580,1080
26009,"Antrim","Michigan",44.99690221,-85.15503082,11,0,0,11,"Antrim, Michigan, US",23324,1,156,276,-120,7,115,122,6394,19313,131215,600474,2875
4001,"Apache","Arizona",35.39465006,-109.4892383,1144,25,0,1119,"Apache, Arizona, US",71887,156,934,702,232,37,-112,-75,16695,31260,260255,1109692,2348
19007,"Appanoose","Iowa",40.74324454,-92.86865906,9,3,0,6,"Appanoose, Iowa, US",12426,25,127,170,-43,0,69,69,5301,13938,96117,396510,1372
13001,"Appling","Georgia",31.74847232,-82.28909114,124,13,0,111,"Appling, Georgia, US",18386,-140,225,213,12,2,-154,-152,7462,23115,212279,811133,1784
51011,"Appomattox","Virginia",37.37569884,-78.81340003,26,0,0,26,"Appomattox, Virginia, US",15911,30,184,186,-2,9,24,33,3520,9801,58782,243428,1375
48007,"Aransas","Texas",28.10556197,-96.9995047,5,0,0,5,"Aransas, Texas, US",23510,64,193,365,-172,-11,247,236,7052,21210,143966,565996,2651
8005,"Arapahoe","Colorado",39.64977461,-104.3353617,4027,278,0,3749,"Arapahoe, Colorado, US",656590,4793,7605,4149,3456,2507,-1165,1342,298038,1716672,27682979,102865199,113574
48009,"Archer","Texas",33.61569967,-98.68754589,1,0,0,1,"Archer, Texas, US",8553,-147,70,144,-74,0,-72,-72,2089,5024,44274,186814,1015
8007,"Archuleta","Colorado",37.19474156,-107.0476867,8,0,0,8,"Archuleta, Colorado, US",14029,299,127,93,34,9,255,264,4950,16152,107928,451167,2653
26011,"Arenac","Michigan",44.0636262,-83.89277559,32,1,0,31,"Arenac, Michigan, US",14883,-125,110,206,-96,0,-28,-28,4821,12438,98320,445810,1609
5001,"Arkansas","Arkansas",34.29145151,-91.37277296,2,0,0,2,"Arkansas, Arkansas, US",17486,-240,206,216,-10,-3,-229,-232,9409,33707,291205,1300187,2593
51013,"Arlington","Virginia",38.8767675,-77.10139853,1804,95,0,1709,"Arlington, Virginia, US",236842,817,2887,1020,1867,1057,-2110,-1053,190029,806554,17174713,65194197,37872
42005,"Armstrong","Pennsylvania",40.81665618,-79.46290811,58,3,0,55,"Armstrong, Pennsylvania, US",64735,-617,643,881,-238,0,-378,-378,19549,68887,569415,2383414,7211
48011,"Armstrong","Texas",34.96507426,-101.3574874,2,0,0,2,"Armstrong, Texas, US",1887,8,19,20,-1,0,10,10,499,641,5063,23656,119
23003,"Aroostook","Maine",46.65926321,-68.59841248,8,1,0,7,"Aroostook, Maine, US",67055,-263,613,865,-252,39,-45,-6,29421,113825,967861,3983427,11107
31005,"Arthur","Nebraska",41.56896142,-101.6959559,0,0,0,0,"Arthur, Nebraska, US",463,1,3,3,0,0,3,3,155,62,509,2007,13
22005,"Ascension","Louisiana",30.20406249,-90.9132841,785,52,0,733,"Ascension, Louisiana, US",126604,1746,1683,927,756,38,955,993,40645,210580,2795154,10723162,13153
37009,"Ashe","North Carolina",36.43296207,-81.49862729,33,0,0,33,"Ashe, North Carolina, US",27203,104,216,350,-134,-13,251,238,9157,23742,168111,712921,2787
39005,"Ashland","Ohio",40.84772277,-82.27280781,17,0,0,17,"Ashland, Ohio, US",53484,-222,586,580,6,56,-285,-229,19703,79258,653300,2736480,5750
55003,"Ashland","Wisconsin",46.31956891,-90.67837132,2,0,0,2,"Ashland, Wisconsin, US",15562,-25,179,167,12,3,-40,-37,8452,24707,213657,929622,2458
5003,"Ashley","Arkansas",33.19153461,-91.7698471,19,0,0,19,"Ashley, Arkansas, US",19657,-355,213,251,-38,-4,-313,-317,7581,21603,208283,825752,1871
39007,"Ashtabula","Ohio",41.70860332,-80.74830218,274,31,0,243,"Ashtabula, Ohio, US",97241,-346,1111,1143,-32,-6,-307,-313,32599,125123,1014405,4199139,10798
53003,"Asotin","Washington",46.18894415,-117.2022851,18,2,0,16,"Asotin, Washington, US",22582,-34,223,266,-43,-27,38,11,6231,22405,181510,810169,2227
22007,"Assumption","Louisiana",29.89946234,-91.06461642,238,11,0,227,"Assumption, Louisiana, US",21891,-388,238,233,5,-2,-393,-395,3732,10664,102374,425733,1164
48013,"Atascosa","Texas",28.89333001,-98.52730485,35,1,0,34,"Atascosa, Texas, US",51153,831,710,435,275,8,551,559,16182,54787,619900,2668976,4377
20005,"Atchison","Kansas",39.53185661,-95.30870026,19,0,0,19,"Atchison, Kansas, US",16073,-100,162,170,-8,-2,-90,-92,7050,18831,142127,604567,1681
29005,"Atchison","Missouri",40.43238737,-95.42970639,3,0,0,3,"Atchison, Missouri, US",5143,-40,41,72,-31,2,-11,-9,2145,5084,41071,155635,891
39009,"Athens","Ohio",39.33425634,-82.04278644,13,1,0,12,"Athens, Ohio, US",65327,-192,477,494,-17,128,-305,-177,26880,66264,495067,2000980,5819
13003,"Atkinson","Georgia",31.29633502,-82.87545866,26,2,0,24,"Atkinson, Georgia, US",8165,-97,122,61,61,-1,-156,-157,2232,3295,25391,106026,280
34001,"Atlantic","New Jersey",39.47538693,-74.65848483,1936,143,0,1793,"Atlantic, New Jersey, US",263670,-319,2718,2793,-75,271,-507,-236,129557,582301,5298921,22719964,36787
40005,"Atoka","Oklahoma",34.37366573,-96.03802487,1,0,0,1,"Atoka, Oklahoma, US",13758,-37,153,130,23,3,-61,-58,3675,8328,53494,214578,1264
28007,"Attala","Mississippi",33.08658803,-89.57838564,270,12,0,258,"Attala, Mississippi, US",18174,-154,221,233,-12,0,-141,-141,4928,14561,110455,461790,1659
29007,"Audrain","Missouri",39.215877,-91.84242683,34,0,0,34,"Audrain, Missouri, US",25388,-35,309,272,37,4,-76,-72,10340,26282,214219,874316,2737
19009,"Audubon","Iowa",41.6844628,-94.90581859,11,1,0,10,"Audubon, Iowa, US",5496,25,60,63,-3,1,29,30,2283,4224,33959,145751,861
39011,"Auglaize","Ohio",40.55998859,-84.2242143,58,3,0,55,"Auglaize, Ohio, US",45656,-80,559,493,66,18,-165,-147,20340,85697,771952,3263616,5273
51015,"Augusta","Virginia",38.16404586,-79.12461614,89,1,0,88,"Augusta, Virginia, US",75558,23,534,759,-225,24,228,252,28326,88995,828984,3554547,7903
46003,"Aurora","South Dakota",43.71757685,-98.56050467,22,0,0,22,"Aurora, South Dakota, US",2751,-34,39,24,15,2,-52,-50,1247,1741,17348,64589,305
48015,"Austin","Texas",29.88548725,-96.27736949,21,0,0,21,"Austin, Texas, US",30032,67,328,274,54,2,13,15,10362,33060,310815,1338603,3455
1001,"Autauga","Alabama",32.53952745,-86.64408227,155,3,0,152,"Autauga, Alabama, US",55869,336,624,541,83,-16,270,254,13221,53823,373904,1551714,4695
37011,"Avery","North Carolina",36.07569796,-81.92308483,2,0,0,2,"Avery, North Carolina, US",17557,29,130,215,-85,10,106,116,7608,22188,140909,622370,2529
22009,"Avoyelles","Louisiana",31.07796211,-92.00079449,101,9,0,92,"Avoyelles, Louisiana, US",40144,-258,510,452,58,5,-320,-315,11218,41639,313558,1214832,3790
8009,"Baca","Colorado",37.31940883,-102.5603223,12,0,0,12,"Baca, Colorado, US",3581,-3,37,46,-9,3,3,6,1650,1280,9848,38864,295
13005,"Bacon","Georgia",31.55456473,-82.45936528,76,2,0,74,"Bacon, Georgia, US",11164,32,158,108,50,-5,-14,-19,4430,10360,73704,313832,1058
48017,"Bailey","Texas",34.06854817,-102.8299707,10,0,0,10,"Bailey, Texas, US",7000,-15,124,39,85,23,-123,-100,2642,4716,35418,147369,638
12003,"Baker","Florida",30.33060121,-82.28467476,27,3,0,24,"Baker, Florida, US",29210,857,322,273,49,5,802,807,6373,17531,125013,509242,1879
13007,"Baker","Georgia",31.32669878,-84.44218806,33,2,0,31,"Baker, Georgia, US",3038,-48,30,22,8,-1,-55,-56,669,346,3221,12426,53
41001,"Baker","Oregon",44.70915557,-117.6749883,1,0,0,1,"Baker, Oregon, US",16124,90,153,211,-58,10,139,149,5965,16894,121302,515743,2542
1003,"Baldwin","Alabama",30.72774991,-87.72207058,273,9,0,264,"Baldwin, Alabama, US",223234,5379,2304,2326,-22,80,5297,5377,68396,341138,2622732,11228256,31722
13009,"Baldwin","Georgia",33.06882326,-83.24701748,329,24,0,305,"Baldwin, Georgia, US",44890,-3,411,480,-69,27,42,69,16454,57883,415778,1730041,4290
21007,"Ballard","Kentucky",37.05842757,-88.99427697,9,0,0,9,"Ballard, Kentucky, US",7888,-104,76,98,-22,0,-82,-82,2732,3238,34011,135494,504
24005,"Baltimore","Maryland",39.45784712,-76.62911955,5290,299,0,4991,"Baltimore, Maryland, US",827370,-489,9598,8601,997,1727,-3211,-1484,351234,1915323,23875931,95742426,119979
24510,"Baltimore City","Maryland",39.30211911,-76.61151012,4673,229,0,4444,"Baltimore City, Maryland, US",593490,-8953,7555,6873,682,1290,-10919,-9629,371992,1709011,25390508,103967322,74033
45009,"Bamberg","South Carolina",33.21927586,-81.05659969,20,0,0,20,"Bamberg, South Carolina, US",14066,-206,124,196,-72,0,-133,-133,4717,11511,80245,317471,1293
48019,"Bandera","Texas",29.74619598,-99.24598147,6,0,0,6,"Bandera, Texas, US",23112,320,185,239,-54,3,370,373,4873,13271,89473,372016,2019
13011,"Banks","Georgia",34.35607081,-83.49644388,73,0,0,73,"Banks, Georgia, US",19234,262,219,158,61,11,191,202,4485,13667,81802,367296,1377
16005,"Bannock","Idaho",42.67002716,-112.2233311,17,0,0,17,"Bannock, Idaho, US",87808,1134,1170,709,461,66,606,672,34280,128560,981668,4145100,11914
26013,"Baraga","Michigan",46.6720582,-88.36363591,1,0,0,1,"Baraga, Michigan, US",8209,-115,62,117,-55,4,-63,-59,2789,6217,50761,212920,817
20007,"Barber","Kansas",37.2288586,-98.68460053,1,0,0,1,"Barber, Kansas, US",4427,-38,50,48,2,1,-41,-40,2254,4566,38463,156783,941
1005,"Barbour","Alabama",31.868263,-85.3871286,105,1,0,104,"Barbour, Alabama, US",24686,-186,256,312,-56,13,-141,-128,8437,26314,213662,860516,2299
54001,"Barbour","West Virginia",39.1307219,-80.00350858,7,1,0,6,"Barbour, West Virginia, US",16441,-46,169,207,-38,-4,-3,-7,3511,8710,54490,232415,971
38003,"Barnes","North Dakota",46.93579637,-98.06605978,4,0,0,4,"Barnes, North Dakota, US",10415,-112,90,126,-36,-6,-69,-75,5449,14793,113567,464086,1758
25001,"Barnstable","Massachusetts",41.72980578,-70.28854339,1264,107,0,1157,"Barnstable, Massachusetts, US",212990,-481,1524,2917,-1393,317,616,933,97409,440532,4264742,19809542,51524
45011,"Barnwell","South Carolina",33.26679302,-81.43584352,43,1,0,42,"Barnwell, South Carolina, US",20866,-255,234,286,-52,1,-204,-203,6884,17491,122922,498501,1659
21009,"Barren","Kentucky",36.96469836,-85.93338945,42,1,0,41,"Barren, Kentucky, US",44249,134,557,519,38,0,98,98,18434,68111,523589,2119446,4599
55005,"Barron","Wisconsin",45.42372701,-91.84833627,12,0,0,12,"Barron, Wisconsin, US",45244,94,486,470,16,11,69,80,21887,83781,704901,3015473,7395
13013,"Barrow","Georgia",33.99148694,-83.71436292,283,11,0,272,"Barrow, Georgia, US",83240,2406,1062,659,403,44,1949,1993,17663,76974,636755,2628812,6816
26015,"Barry","Michigan",42.59513984,-85.30834519,59,2,0,57,"Barry, Michigan, US",61550,319,625,581,44,20,258,278,13716,44553,375340,1565943,4879
29009,"Barry","Missouri",36.70978521,-93.82919888,8,0,0,8,"Barry, Missouri, US",35789,77,410,403,7,7,65,72,15733,52289,409845,1812787,3882
18005,"Bartholomew","Indiana",39.20744865,-85.89558181,467,33,0,434,"Bartholomew, Indiana, US",83779,1057,1015,734,281,629,151,780,48100,208649,2150999,8683960,10656
20009,"Barton","Kansas",38.47889676,-98.75636726,36,1,0,35,"Barton, Kansas, US",25779,-278,271,304,-33,5,-250,-245,12907,49041,409977,1727895,5244
13015,"Bartow","Georgia",34.23732119,-84.83887523,444,36,0,408,"Bartow, Georgia, US",107738,1360,1268,982,286,20,1050,1070,37146,160754,1491414,6159658,12066
48021,"Bastrop","Texas",30.10370699,-97.31206354,161,2,0,159,"Bastrop, Texas, US",88723,2128,1093,727,366,-48,1809,1761,18184,70488,539186,2273095,7520
29013,"Bates","Missouri",38.25271289,-94.34113157,7,1,0,6,"Bates, Missouri, US",16172,-132,181,171,10,-1,-140,-141,4545,11698,73804,314157,1670
21011,"Bath","Kentucky",38.14735938,-83.74588932,8,1,0,7,"Bath, Kentucky, US",12500,56,194,161,33,-2,26,24,2265,3853,29895,129745,510
51017,"Bath","Virginia",38.05852573,-79.73912095,0,0,0,0,"Bath, Virginia, US",4147,-106,30,62,-32,-1,-73,-74,2064,5228,42179,178686,533
5005,"Baxter","Arkansas",36.28784385,-92.33782872,6,0,0,6,"Baxter, Arkansas, US",41932,308,349,695,-346,-1,656,655,15469,59482,453882,1951216,5691
12005,"Bay","Florida",30.26548745,-85.62122584,94,3,0,91,"Bay, Florida, US",174705,-11535,2222,1989,233,277,-12080,-11803,80424,353863,2946351,12180276,27648
26017,"Bay","Michigan",43.70639106,-83.98731479,276,19,0,257,"Bay, Michigan, US",103126,-576,981,1163,-182,-5,-384,-389,35976,152469,1423923,5677967,12270
55007,"Bayfield","Wisconsin",46.52868768,-91.19716729,3,1,0,2,"Bayfield, Wisconsin, US",15036,10,128,211,-83,2,91,93,4675,10020,59215,291080,2152
46005,"Beadle","South Dakota",44.41464384,-98.27858469,118,2,0,116,"Beadle, South Dakota, US",18453,30,285,182,103,52,-124,-72,9144,27163,235531,955864,2872
37013,"Beaufort","North Carolina",35.48531943,-76.84325809,35,0,0,35,"Beaufort, North Carolina, US",46994,-62,439,628,-189,3,128,131,18050,60372,480261,1928913,5971
45013,"Beaufort","South Carolina",32.39226291,-80.72619758,332,12,0,320,"Beaufort, South Carolina, US",192122,3246,1923,1741,182,187,2862,3049,78166,319768,2657550,11207080,31571
22011,"Beauregard","Louisiana",30.64836518,-93.34173616,56,4,0,52,"Beauregard, Louisiana, US",37497,128,531,412,119,11,1,12,9972,28152,240197,952354,3233
40007,"Beaver","Oklahoma",36.7496847,-100.4758872,24,0,0,24,"Beaver, Oklahoma, US",5311,-7,52,46,6,12,-25,-13,2161,4365,47238,197298,655
42007,"Beaver","Pennsylvania",40.6825484,-80.34921611,552,72,0,480,"Beaver, Pennsylvania, US",163929,-653,1506,2071,-565,9,-86,-77,59225,245504,2207152,9227792,19819
30001,"Beaverhead","Montana",45.13434354,-112.8984694,1,0,0,1,"Beaverhead, Montana, US",9453,41,77,99,-22,13,49,62,4298,10338,66589,284013,1914
27005,"Becker","Minnesota",46.93479392,-95.67158144,32,0,0,32,"Becker, Minnesota, US",34423,34,413,373,40,26,-31,-5,14063,43938,337744,1551482,5095
40009,"Beckham","Oklahoma",35.26862449,-99.68128023,6,0,0,6,"Beckham, Oklahoma, US",21859,139,294,238,56,3,80,83,12096,42130,446312,2023660,4168
42009,"Bedford","Pennsylvania",40.00522157,-78.48998442,37,2,0,35,"Bedford, Pennsylvania, US",47888,-206,447,553,-106,4,-103,-99,17488,57037,407130,1744607,5902
47003,"Bedford","Tennessee",35.51123746,-86.45549096,264,4,0,260,"Bedford, Tennessee, US",49713,567,678,482,196,88,283,371,16957,61922,565359,2319576,4191
51019,"Bedford","Virginia",37.3080028,-79.5281964,41,2,0,39,"Bedford, Virginia, US",78997,115,679,867,-188,19,289,308,19427,77350,667879,2770879,9692
48025,"Bee","Texas",28.41761668,-97.74215593,8,0,0,8,"Bee, Texas, US",32565,98,318,234,84,-5,18,13,9959,21054,169289,694579,2405
33001,"Belknap","New Hampshire",43.51637314,-71.41684235,55,0,0,55,"Belknap, New Hampshire, US",61303,158,478,775,-297,28,432,460,25236,106615,941631,4339618,10421
21013,"Bell","Kentucky",36.73355174,-83.67766671,1,0,0,1,"Bell, Kentucky, US",26032,-455,316,379,-63,5,-398,-393,9250,28672,199781,803033,2349
48027,"Bell","Texas",31.03736027,-97.4785025,282,3,0,279,"Bell, Texas, US",362924,7527,5940,2304,3636,115,3745,3860,157780,503638,4723877,19354390,30534
39013,"Belmont","Ohio",40.01625942,-80.9924051,381,12,0,369,"Belmont, Ohio, US",67006,-527,608,856,-248,-12,-264,-276,23623,101673,861655,3604394,8052
27007,"Beltrami","Minnesota",47.97373527,-94.93732139,12,0,0,12,"Beltrami, Minnesota, US",47188,453,638,433,205,29,219,248,20570,68827,503040,2252640,6604
13017,"Ben Hill","Georgia",31.76095874,-83.22145359,56,1,0,55,"Ben Hill, Georgia, US",16700,-122,197,225,-28,6,-100,-94,6106,15595,119009,485758,1421
50003,"Bennington","Vermont",43.03519828,-73.09048868,60,1,0,59,"Bennington, Vermont, US",35470,-50,323,447,-124,15,60,75,19391,71553,623794,2632939,7626
38005,"Benson","North Dakota",48.0683985,-99.35916363,1,0,0,1,"Benson, North Dakota, US",6832,-126,139,69,70,1,-197,-196,2488,1961,17185,74997,330
8011,"Bent","Colorado",37.95474293,-103.0720195,2,0,0,2,"Bent, Colorado, US",5577,-231,36,57,-21,2,-215,-213,1329,1193,8820,37269,163
5007,"Benton","Arkansas",36.33644656,-94.25680817,237,0,0,237,"Benton, Arkansas, US",279141,6875,3744,1820,1924,107,4823,4930,116389,571763,6927232,25426408,37951
18007,"Benton","Indiana",40.60626947,-87.31093999,24,0,0,24,"Benton, Indiana, US",8748,95,103,81,22,1,73,74,2532,4862,38773,170036,694
19011,"Benton","Iowa",42.08011739,-92.06463573,37,1,0,36,"Benton, Iowa, US",25645,20,280,263,17,6,-1,5,6443,19602,153497,672292,2934
27009,"Benton","Minnesota",45.69804958,-93.99514135,161,2,0,159,"Benton, Minnesota, US",40889,379,538,330,208,50,123,173,15884,73139,663393,2872095,4853
28009,"Benton","Mississippi",34.81681228,-89.18945516,14,0,0,14,"Benton, Mississippi, US",8259,16,88,92,-4,-3,23,20,1098,1818,12320,51719,188
29015,"Benton","Missouri",38.29503305,-93.28756116,10,0,0,10,"Benton, Missouri, US",19443,146,174,305,-131,-3,279,276,4398,10234,53314,229813,1900
41003,"Benton","Oregon",44.49167306,-123.4316987,55,5,0,50,"Benton, Oregon, US",93053,611,701,584,117,331,168,499,40304,143411,1516461,6356623,12300
47005,"Benton","Tennessee",36.07110411,-88.06849355,7,1,0,6,"Benton, Tennessee, US",16160,-86,166,259,-93,1,6,7,4684,13663,94409,389648,1437
53005,"Benton","Washington",46.23946995,-119.5120834,674,59,0,615,"Benton, Washington, US",204390,3104,2578,1467,1111,256,1740,1996,83688,362623,4112356,17660654,26653
26019,"Benzie","Michigan",44.63899297,-86.01608482,4,0,0,4,"Benzie, Michigan, US",17766,5,154,213,-59,-4,70,66,4880,16748,102838,494596,2341
34003,"Bergen","New Jersey",40.96010917,-74.07164325,17668,1521,0,16147,"Bergen, New Jersey, US",932202,-614,9153,7248,1905,1909,-4439,-2530,428068,2578717,39812941,156923859,190976
45015,"Berkeley","South Carolina",33.20222596,-79.94654523,214,15,0,199,"Berkeley, South Carolina, US",227907,6725,2774,1647,1127,285,5291,5576,59012,247628,2682644,10899010,18669
54003,"Berkeley","West Virginia",39.46704621,-78.02414609,256,6,0,250,"Berkeley, West Virginia, US",119171,1935,1372,1057,315,-94,1709,1615,32288,113121,968416,4045923,9355
42011,"Berks","Pennsylvania",40.41570541,-75.92457766,3845,292,0,3553,"Berks, Pennsylvania, US",421164,635,4708,3885,823,694,-871,-177,175026,792919,8572219,35151616,50022
25003,"Berkshire","Massachusetts",42.37428441,-73.20524838,515,38,0,477,"Berkshire, Massachusetts, US",124944,-957,993,1460,-467,175,-662,-487,63219,274683,2694508,11267121,22618
35001,"Bernalillo","New Mexico",35.05163625,-106.6703554,1313,66,0,1247,"Bernalillo, New Mexico, US",679121,1087,7130,5949,1181,773,-824,-51,334503,1574024,16866521,67941997,95287
13019,"Berrien","Georgia",31.27590016,-83.2252992,34,0,0,34,"Berrien, Georgia, US",19397,131,236,237,-1,12,120,132,3900,10278,73866,285005,1114
26021,"Berrien","Michigan",41.95447397,-86.4131308,584,42,0,542,"Berrien, Michigan, US",153401,-389,1696,1688,8,216,-608,-392,67318,261215,2346593,9936359,20608
37015,"Bertie","North Carolina",36.0688473,-76.96545943,109,3,0,106,"Bertie, North Carolina, US",18947,-159,167,268,-101,31,-89,-58,6057,16504,113180,456743,1457
2050,"Bethel","Alaska",60.90980451,-159.8561831,2,0,0,2,"Bethel, Alaska, US",18386,167,403,150,253,2,-88,-86,6167,9756,80957,335382,1264
48029,"Bexar","Texas",29.44928723,-98.52019748,2392,66,0,2326,"Bexar, Texas, US",2003554,22367,26736,14216,12520,2339,7493,9832,872913,4408814,50730742,197376570,217886
1007,"Bibb","Alabama",32.99642064,-87.1251146,58,1,0,57,"Bibb, Alabama, US",22394,27,240,252,-12,10,31,41,4746,12277,109942,431209,1361
13021,"Bibb","Georgia",32.80904227,-83.70489165,432,24,0,408,"Bibb, Georgia, US",153159,256,2074,1745,329,130,-193,-63,81338,398785,3974534,15876701,24306
22013,"Bienville","Louisiana",32.34569994,-93.05398492,136,21,0,115,"Bienville, Louisiana, US",13241,-102,142,207,-65,3,-39,-36,4625,10915,97816,412832,1035
30003,"Big Horn","Montana",45.42335905,-107.492347,8,0,0,8,"Big Horn, Montana, US",13319,-46,244,132,112,12,-170,-158,5081,9667,139729,511743,868
56003,"Big Horn","Wyoming",44.52405055,-107.9960365,3,0,0,3,"Big Horn, Wyoming, US",11790,-87,131,120,11,2,-100,-98,5019,9607,87428,382393,1458
27011,"Big Stone","Minnesota",45.42712824,-96.41403739,3,0,0,3,"Big Stone, Minnesota, US",4991,1,70,70,0,1,1,2,2171,4952,33219,164500,893
16011,"Bingham","Idaho",43.2167288,-112.3978437,6,0,0,6,"Bingham, Idaho, US",46811,682,593,377,216,8,461,469,15453,41809,338653,1477407,4706
19013,"Black Hawk","Iowa",42.4704581,-92.30524729,1669,38,0,1631,"Black Hawk, Iowa, US",131228,-495,1660,1212,448,188,-1129,-941,75339,321350,3083831,12649523,18576
18009,"Blackford","Indiana",40.47388153,-85.32499702,19,1,0,18,"Blackford, Indiana, US",11758,-166,115,163,-48,10,-128,-118,3814,10575,80875,349574,1149
37017,"Bladen","North Carolina",34.61296243,-78.56180059,92,2,0,90,"Bladen, North Carolina, US",32722,-429,337,468,-131,21,-316,-295,13909,32467,251349,978114,2609
16013,"Blaine","Idaho",43.4085812,-113.9752658,510,5,0,505,"Blaine, Idaho, US",23021,250,192,106,86,119,45,164,12614,61963,557305,2447512,8244
40011,"Blaine","Oklahoma",35.87518314,-98.43307003,4,0,0,4,"Blaine, Oklahoma, US",9429,-25,116,104,12,16,-52,-36,3586,8476,66607,290040,1284
42013,"Blair","Pennsylvania",40.47961444,-78.34917412,46,1,0,45,"Blair, Pennsylvania, US",121829,-674,1146,1619,-473,30,-225,-195,61536,284261,2494323,10510710,18463
48031,"Blanco","Texas",30.26640707,-98.3999852,7,0,0,7,"Blanco, Texas, US",11931,283,75,131,-56,4,333,337,3810,9460,81132,367747,1498
51021,"Bland","Virginia",37.13128068,-81.13599391,0,0,0,0,"Bland, Virginia, US",6280,-23,39,79,-40,-2,19,17,1929,2942,33574,133366,233
13023,"Bleckley","Georgia",32.43829035,-83.33035166,38,0,0,38,"Bleckley, Georgia, US",12873,52,129,110,19,5,28,33,2704,6200,35651,151999,714
47007,"Bledsoe","Tennessee",35.59942968,-85.20611967,607,1,0,606,"Bledsoe, Tennessee, US",15064,181,116,154,-38,22,196,218,2961,2405,14430,63880,414
1009,"Blount","Alabama",33.98210918,-86.56790593,49,1,0,48,"Blount, Alabama, US",57826,55,651,657,-6,6,59,65,9521,29874,214792,927769,3717
47009,"Blount","Tennessee",35.68938198,-83.92847788,81,3,0,78,"Blount, Tennessee, US",133088,1757,1255,1414,-159,71,1842,1913,46876,204185,2042047,8571880,13507
27013,"Blue Earth","Minnesota",44.03554215,-94.06699781,110,1,0,109,"Blue Earth, Minnesota, US",67653,275,715,470,245,103,-72,31,40052,184159,1540354,6510016,11342
28011,"Bolivar","Mississippi",33.79696941,-90.87372121,136,10,0,126,"Bolivar, Mississippi, US",30628,-487,405,398,7,23,-519,-496,11813,39074,283482,1163775,3810
29017,"Bollinger","Missouri",37.32449052,-90.02725304,6,0,0,6,"Bollinger, Missouri, US",12133,-56,127,138,-11,0,-46,-46,2132,4796,33256,138957,863
46009,"Bon Homme","South Dakota",42.98914167,-97.88592746,6,0,0,6,"Bon Homme, South Dakota, US",6901,-9,69,62,7,-2,-13,-15,2169,3283,23691,95632,662
17005,"Bond","Illinois",38.88829622,-89.43534887,10,1,0,9,"Bond, Illinois, US",16426,-211,146,157,-11,4,-206,-202,5763,12004,90219,377437,1542
16017,"Bonner","Idaho",48.29996017,-116.6017932,4,0,0,4,"Bonner, Idaho, US",45739,1034,426,438,-12,-13,1057,1044,14673,58744,434295,1914046,8754
16019,"Bonneville","Idaho",43.38713372,-111.6161537,32,0,0,32,"Bonneville, Idaho, US",119062,2618,1876,863,1013,-33,1633,1600,51840,249303,2489589,9982375,20575
5009,"Boone","Arkansas",36.3084504,-93.09374925,6,0,0,6,"Boone, Arkansas, US",37432,47,407,460,-53,-11,114,103,16182,53179,423909,1803294,4720
17007,"Boone","Illinois",42.32359279,-88.82345779,389,16,0,373,"Boone, Illinois, US",53544,64,564,417,147,2,-84,-82,17237,54381,629525,2530266,4463
18011,"Boone","Indiana",40.0509304,-86.46841646,279,35,0,244,"Boone, Indiana, US",67843,913,764,469,295,72,546,618,23691,116126,1019187,4440436,8463
19015,"Boone","Iowa",42.03657094,-93.9313999,53,0,0,53,"Boone, Iowa, US",26234,-78,268,290,-22,-15,-40,-55,10398,28312,243738,1000048,2912
21015,"Boone","Kentucky",38.97065142,-84.72615357,387,11,0,376,"Boone, Kentucky, US",133581,1680,1680,939,741,0,943,943,81375,417821,4178108,17179242,17929
29019,"Boone","Missouri",38.99186229,-92.30723575,115,1,0,114,"Boone, Missouri, US",180463,1402,2015,1156,859,522,22,544,93378,443721,4125756,16802873,27421
31011,"Boone","Nebraska",41.70759415,-98.06737183,3,0,0,3,"Boone, Nebraska, US",5192,-49,56,62,-6,2,-46,-44,2773,5627,45050,188420,871
54005,"Boone","West Virginia",38.01974191,-81.69888019,9,0,0,9,"Boone, West Virginia, US",21457,-496,225,297,-72,0,-423,-423,8352,17742,157802,653414,1317
48035,"Bosque","Texas",31.89978581,-97.63613524,6,0,0,6,"Bosque, Texas, US",18685,56,182,250,-68,3,120,123,4307,10040,78652,328967,1306
22015,"Bossier","Louisiana",32.67932307,-93.60460152,380,24,0,356,"Bossier, Louisiana, US",127039,17,1570,1119,451,41,-477,-436,51866,204230,1645931,6721149,14402
51023,"Botetourt","Virginia",37.55531756,-79.80982182,31,4,0,27,"Botetourt, Virginia, US",33419,67,229,359,-130,4,198,202,9859,40677,368485,1610654,3990
38009,"Bottineau","North Dakota",48.79106111,-100.8378166,2,0,0,2,"Bottineau, North Dakota, US",6282,-116,61,90,-29,4,-91,-87,3228,6481,56104,250670,1152
8013,"Boulder","Colorado",40.09313619,-105.3546767,923,61,0,862,"Boulder, Colorado, US",326196,1560,2609,1935,674,938,-42,896,190656,888091,13129152,53260501,74789
16021,"Boundary","Idaho",48.76684761,-116.4630179,0,0,0,0,"Boundary, Idaho, US",12245,229,134,132,2,2,225,227,3435,10841,78875,355410,1812
20011,"Bourbon","Kansas",37.85508555,-94.84865997,7,1,0,6,"Bourbon, Kansas, US",14534,-8,175,146,29,9,-46,-37,6373,18678,138647,573995,1664
21017,"Bourbon","Kentucky",38.2054607,-84.21827874,9,1,0,8,"Bourbon, Kentucky, US",19788,-328,208,235,-27,-3,-299,-302,7648,18792,161600,672429,1882
48037,"Bowie","Texas",33.44626922,-94.41834132,176,5,0,171,"Bowie, Texas, US",93245,-443,1117,1046,71,17,-531,-514,41842,179130,1420985,6086300,12785
38011,"Bowman","North Dakota",46.11285362,-103.5203343,1,0,0,1,"Bowman, North Dakota, US",3024,-43,35,34,1,0,-45,-45,1712,4325,40086,181854,625
31013,"Box Butte","Nebraska",42.22079243,-103.0878834,1,0,0,1,"Box Butte, Nebraska, US",10783,50,124,97,27,2,23,25,5877,11668,86585,361590,1482
21019,"Boyd","Kentucky",38.36176608,-82.68652187,39,3,0,36,"Boyd, Kentucky, US",46718,-574,493,597,-104,-11,-460,-471,26568,98912,962473,3940028,6835
21021,"Boyle","Kentucky",37.62680923,-84.8633779,20,0,0,20,"Boyle, Kentucky, US",30060,-22,310,317,-7,-2,-14,-16,15357,53987,411676,1704263,3911
21023,"Bracken","Kentucky",38.69158994,-84.08532444,11,0,0,11,"Bracken, Kentucky, US",8303,25,97,100,-3,2,28,30,1498,2359,15625,66023,344
12007,"Bradford","Florida",29.95079741,-82.16611613,50,2,0,48,"Bradford, Florida, US",28201,449,285,349,-64,2,507,509,6319,17987,126395,517127,2160
42015,"Bradford","Pennsylvania",41.78869215,-76.51570822,44,3,0,41,"Bradford, Pennsylvania, US",60323,-471,632,725,-93,16,-393,-377,27755,79176,729863,3049543,7515
5011,"Bradley","Arkansas",33.46755808,-92.15980837,16,1,0,15,"Bradley, Arkansas, US",10763,-75,116,130,-14,-5,-56,-61,3810,9301,70718,281691,1203
47011,"Bradley","Tennessee",35.15739424,-84.857186,91,1,0,90,"Bradley, Tennessee, US",108110,1060,1240,1113,127,168,769,937,42002,183896,1709776,7050795,10866
26023,"Branch","Michigan",41.91600556,-85.05929476,100,2,0,98,"Branch, Michigan, US",43517,-49,515,419,96,29,-172,-143,15611,46883,422526,1676274,4285
13025,"Brantley","Georgia",31.19576557,-81.97743999,50,2,0,48,"Brantley, Georgia, US",19109,124,221,216,5,1,118,119,2885,4558,30283,126675,839
54007,"Braxton","West Virginia",38.70036159,-80.72011184,2,0,0,2,"Braxton, West Virginia, US",13957,-119,127,177,-50,-1,-67,-68,4534,10464,76784,308071,1155
48039,"Brazoria","Texas",29.18757369,-95.44563172,825,11,0,814,"Brazoria, Texas, US",374264,5377,4681,2498,2183,171,3025,3196,106291,499458,5884151,23675072,33472
48041,"Brazos","Texas",30.6636448,-96.30205577,362,18,0,344,"Brazos, Texas, US",229211,3430,2621,1142,1479,1023,931,1954,100127,384784,3305031,14010861,25711
21025,"Breathitt","Kentucky",37.52333168,-83.31959161,3,0,0,3,"Breathitt, Kentucky, US",12630,-157,161,205,-44,0,-113,-113,3497,8985,66776,259853,847
21027,"Breckinridge","Kentucky",37.77377239,-86.42885017,16,2,0,14,"Breckinridge, Kentucky, US",20477,168,230,214,16,9,143,152,4614,10539,76563,321626,1331
19017,"Bremer","Iowa",42.77461496,-92.31795937,67,5,0,62,"Bremer, Iowa, US",25062,121,271,218,53,23,48,71,11948,39414,381050,1508030,3223
12009,"Brevard","Florida",28.29409504,-80.73091022,389,11,0,378,"Brevard, Florida, US",601942,6739,5258,7468,-2210,429,8509,8938,217770,1066545,11637961,47320204,84961
48043,"Brewster","Texas",29.81008251,-103.2520326,1,0,0,1,"Brewster, Texas, US",9203,-69,87,70,17,2,-87,-85,4336,12310,71151,290690,1369
48045,"Briscoe","Texas",34.53026962,-101.2084947,1,0,0,1,"Briscoe, Texas, US",1546,34,12,9,3,1,29,30,568,206,1469,6651,72
25005,"Bristol","Massachusetts",41.79228404,-71.10872211,6426,362,0,6064,"Bristol, Massachusetts, US",565217,1125,5701,5387,314,810,30,840,215879,1181709,13457038,53237505,76828
44001,"Bristol","Rhode Island",41.71018079,-71.28652315,213,0,0,213,"Bristol, Rhode Island, US",48479,-158,337,517,-180,21,6,27,15028,67373,549748,2277405,7029
51520,"Bristol","Virginia",36.6163024,-82.16359122,4,0,0,4,"Bristol, Virginia, US",16762,77,126,235,-109,-8,194,186,11159,37683,263160,1065475,2987
30007,"Broadwater","Montana",46.33277565,-111.4955813,4,0,0,4,"Broadwater, Montana, US",6237,165,60,51,9,-1,155,154,1872,2786,17176,75243,636
54009,"Brooke","West Virginia",40.27367263,-80.57915332,3,0,0,3,"Brooke, West Virginia, US",21939,-190,198,302,-104,-11,-73,-84,8131,27723,271702,1048940,1903
46011,"Brookings","South Dakota",44.36974375,-96.79079945,15,0,0,15,"Brookings, South Dakota, US",35077,0,443,204,239,69,-310,-241,19371,53263,476621,1865876,4872
13027,"Brooks","Georgia",30.83922642,-83.58303423,66,9,0,57,"Brooks, Georgia, US",15457,-22,149,199,-50,12,17,29,3033,7280,49807,208893,942
48047,"Brooks","Texas",27.03103197,-98.21808402,1,0,0,1,"Brooks, Texas, US",7093,-6,102,78,24,41,-72,-31,2714,4469,26134,105394,467
36007,"Broome","New York",42.15903158,-75.81326086,485,32,0,453,"Broome, New York, US",190488,-1437,1920,2113,-193,248,-1498,-1250,93287,370997,3424028,14219126,24665
8014,"Broomfield","Colorado",39.95998787,-105.0566324,220,25,0,195,"Broomfield, Colorado, US",70465,1141,651,413,238,105,791,896,36980,239261,4179789,15648474,12380
12011,"Broward","Florida",26.15184651,-80.48725556,6649,292,0,6357,"Broward, Florida, US",1952778,6671,21829,16032,5797,13055,-12153,902,798239,4178657,50147178,198501075,365671
17009,"Brown","Illinois",39.96209138,-90.75068024,10,0,0,10,"Brown, Illinois, US",6578,15,56,56,0,5,10,15,4260,5804,63965,250410,386
18013,"Brown","Indiana",39.19605589,-86.22868909,33,1,0,32,"Brown, Indiana, US",15092,-138,117,153,-36,-3,-98,-101,3333,9895,47490,224169,1668
20013,"Brown","Kansas",39.82652589,-95.56421698,6,0,0,6,"Brown, Kansas, US",9564,-46,125,121,4,-1,-49,-50,4949,11843,107043,451266,1272
27015,"Brown","Minnesota",44.24205652,-94.72562874,11,2,0,9,"Brown, Minnesota, US",25008,-117,276,275,1,8,-125,-117,15254,64888,583436,2391020,4232
39015,"Brown","Ohio",38.93416837,-83.86788395,24,1,0,23,"Brown, Ohio, US",43432,-138,490,518,-28,-8,-102,-110,9547,28397,173528,694565,2795
46013,"Brown","South Dakota",45.58994323,-98.35165355,244,0,0,244,"Brown, South Dakota, US",38839,-306,501,353,148,19,-473,-454,21681,85567,747372,3106569,7040
48049,"Brown","Texas",31.77430356,-98.99907113,55,7,0,48,"Brown, Texas, US",37864,44,382,440,-58,13,91,104,15275,59290,423108,1725909,4797
55009,"Brown","Wisconsin",44.4526553,-88.00411844,2238,32,0,2206,"Brown, Wisconsin, US",264542,1377,3194,1817,1377,138,-132,6,147929,815568,9443050,38425511,38970
46015,"Brule","South Dakota",43.71756379,-99.08118954,0,0,0,0,"Brule, South Dakota, US",5297,67,69,41,28,-1,41,40,2632,6514,44379,197948,1080
37019,"Brunswick","North Carolina",34.070565,-78.22814204,74,2,0,72,"Brunswick, North Carolina, US",142820,5940,1027,1738,-711,-36,6629,6593,34868,133831,993773,4317801,14558
51025,"Brunswick","Virginia",36.76366949,-77.8593436,21,1,0,20,"Brunswick, Virginia, US",16231,-105,139,222,-83,5,-26,-21,4199,8726,72887,311950,1164
13029,"Bryan","Georgia",32.00979311,-81.44002948,69,5,0,64,"Bryan, Georgia, US",39627,1568,541,258,283,-3,1289,1286,6932,29191,196061,813340,3578
40013,"Bryan","Oklahoma",33.96472458,-96.25903472,21,1,0,20,"Bryan, Oklahoma, US",47995,804,589,542,47,14,739,753,17018,46202,345784,1424440,4105
19019,"Buchanan","Iowa",42.4709188,-91.83510825,30,0,0,30,"Buchanan, Iowa, US",21175,-3,267,199,68,4,-74,-70,7474,21208,169859,727165,2429
29021,"Buchanan","Missouri",39.65816401,-94.80138942,609,2,0,607,"Buchanan, Missouri, US",87364,-799,1068,893,175,163,-1137,-974,50795,201864,1942908,8002055,12213
51027,"Buchanan","Virginia",37.26818323,-82.03749726,18,0,0,18,"Buchanan, Virginia, US",21004,-365,184,309,-125,12,-253,-241,7553,23971,318748,1160194,2067
51029,"Buckingham","Virginia",37.57242268,-78.52518834,443,2,0,441,"Buckingham, Virginia, US",17148,105,126,157,-31,1,135,136,4034,7343,55526,234325,1201
42017,"Bucks","Pennsylvania",40.33682119,-75.10836643,4839,460,0,4379,"Bucks, Pennsylvania, US",628270,458,5694,6111,-417,536,383,919,261596,1486082,16700436,69380034,115593
19021,"Buena Vista","Iowa",42.73545875,-95.15100162,227,0,0,227,"Buena Vista, Iowa, US",19620,-206,286,148,138,40,-385,-345,11599,30561,254922,1079130,2938
51530,"Buena Vista","Virginia",37.73484642,-79.35296097,12,0,0,12,"Buena Vista, Virginia, US",6478,-16,91,74,17,-5,-27,-32,1983,4939,38703,144630,389
31019,"Buffalo","Nebraska",40.85486962,-99.07500296,140,1,0,139,"Buffalo, Nebraska, US",49659,307,632,369,263,38,8,46,27885,115138,954452,3989384,9622
46017,"Buffalo","South Dakota",44.07657829,-99.20814467,9,0,0,9,"Buffalo, South Dakota, US",1962,-65,35,37,-2,0,-64,-64,646,204,1296,5732,19
55011,"Buffalo","Wisconsin",44.37835084,-91.75332578,5,1,0,4,"Buffalo, Wisconsin, US",13031,-83,129,126,3,9,-95,-86,4342,12204,93867,394059,1442
21029,"Bullitt","Kentucky",37.97162523,-85.68955617,104,4,0,100,"Bullitt, Kentucky, US",81676,667,777,653,124,-8,553,545,21997,87620,697260,2955219,6410
13031,"Bulloch","Georgia",32.39577406,-81.74811421,52,2,0,50,"Bulloch, Georgia, US",79608,2366,890,561,329,84,1935,2019,28684,87960,607895,2542585,8241
1011,"Bullock","Alabama",32.10030533,-85.71265535,105,1,0,104,"Bullock, Alabama, US",10101,-73,109,109,0,-1,-72,-73,3287,4581,31362,135334,401
37021,"Buncombe","North Carolina",35.61113393,-82.53305,251,8,0,243,"Buncombe, North Carolina, US",261191,1932,2413,2700,-287,108,2102,2210,130104,661081,6099698,25392136,50718
17011,"Bureau","Illinois",41.40385234,-89.5283051,15,1,0,14,"Bureau, Illinois, US",32628,-331,314,383,-69,18,-281,-263,13149,39258,359155,1536539,3857
13033,"Burke","Georgia",33.05917989,-81.99928721,120,4,0,116,"Burke, Georgia, US",22383,-56,290,247,43,-2,-96,-98,9355,19502,277803,1071971,1605
37023,"Burke","North Carolina",35.74989637,-81.70755735,266,14,0,252,"Burke, North Carolina, US",90485,80,883,1034,-151,66,171,237,31130,112745,875699,3684060,7981
38013,"Burke","North Dakota",48.79094471,-102.5182117,5,0,0,5,"Burke, North Dakota, US",2115,21,26,17,9,0,12,12,924,1496,11897,55536,318
38015,"Burleigh","North Dakota",46.97847375,-100.4645214,129,0,0,129,"Burleigh, North Dakota, US",95626,350,1180,759,421,131,-201,-70,51277,236006,2492765,10282254,17473
48051,"Burleson","Texas",30.49273808,-96.62158484,20,0,0,20,"Burleson, Texas, US",18443,108,209,218,-9,28,87,115,4647,12564,105149,474488,1577
34005,"Burlington","New Jersey",39.87681124,-74.66927768,4252,266,0,3986,"Burlington, New Jersey, US",445349,604,4333,4022,311,120,199,319,203587,1028549,13221535,53179719,62103
48053,"Burnet","Texas",30.78801353,-98.181887,29,0,0,29,"Burnet, Texas, US",48155,811,468,490,-22,-22,854,832,15582,59273,518488,2231594,7042
55013,"Burnett","Wisconsin",45.86303537,-92.36711412,1,1,0,0,"Burnett, Wisconsin, US",15414,40,123,167,-44,1,83,84,5193,13548,95363,418425,2018
31021,"Burt","Nebraska",41.85056773,-96.32605633,8,0,0,8,"Burt, Nebraska, US",6459,-27,64,98,-34,1,7,8,2317,4205,31371,128814,913
1013,"Butler","Alabama",31.75300095,-86.68057478,335,11,0,324,"Butler, Alabama, US",19448,-183,213,272,-59,18,-141,-123,6900,22890,159845,659300,2097
19023,"Butler","Iowa",42.73172833,-92.79015971,15,0,0,15,"Butler, Iowa, US",14439,-86,134,172,-38,6,-53,-47,4372,10552,74155,321797,1677
20015,"Butler","Kansas",37.78134351,-96.83878537,25,0,0,25,"Butler, Kansas, US",66911,78,731,637,94,20,-34,-14,20396,65371,503434,2184332,7434
21031,"Butler","Kentucky",37.20946153,-86.68748787,218,6,0,212,"Butler, Kentucky, US",12879,136,154,143,11,0,126,126,3398,5836,39899,158951,727
29023,"Butler","Missouri",36.71462476,-90.40421163,28,0,0,28,"Butler, Missouri, US",42478,-109,498,566,-68,3,-42,-39,20467,70404,531091,2227588,6369
31023,"Butler","Nebraska",41.22703692,-97.13106306,45,0,0,45,"Butler, Nebraska, US",8016,-27,87,85,2,0,-28,-28,3026,6200,56034,223478,960
39017,"Butler","Ohio",39.44012838,-84.57388716,750,25,0,725,"Butler, Ohio, US",383134,1134,4455,3467,988,313,-156,157,151228,757037,8011033,31694026,43003
42019,"Butler","Pennsylvania",40.91152759,-79.91351055,216,12,0,204,"Butler, Pennsylvania, US",187853,215,1714,1976,-262,58,431,489,90383,460427,5108564,20831840,28841
6007,"Butte","California",39.66727762,-121.6005252,34,0,0,34,"Butte, California, US",219186,-11153,2422,2527,-105,103,-11249,-11146,87044,350027,3236550,13800549,27688
46019,"Butte","South Dakota",44.90608745,-103.5079318,0,0,0,0,"Butte, South Dakota, US",10429,176,135,98,37,0,142,142,3530,9911,72264,300406,1622
13035,"Butts","Georgia",33.2830945,-83.9543504,208,20,0,188,"Butts, Georgia, US",24936,744,291,278,13,-3,727,724,6743,18035,132983,583477,1809
37025,"Cabarrus","North Carolina",35.3877799,-80.55267168,428,22,0,406,"Cabarrus, North Carolina, US",216453,4856,2600,1688,912,185,3756,3941,71145,361393,3157760,13199716,25838
54011,"Cabell","West Virginia",38.42424062,-82.23855912,57,0,0,57,"Cabell, West Virginia, US",91945,-1090,1009,1086,-77,-23,-990,-1013,51935,228678,2054233,8435163,13799
22017,"Caddo","Louisiana",32.57991587,-93.88375652,2293,156,0,2137,"Caddo, Louisiana, US",240204,-2629,3032,2739,293,19,-2938,-2919,123352,555039,5682447,23411045,37215
40015,"Caddo","Oklahoma",35.17364557,-98.37534464,136,10,0,126,"Caddo, Oklahoma, US",28762,-266,374,390,-16,46,-297,-251,8676,20840,166877,697294,2386
6009,"Calaveras","California",38.20537103,-120.552913,13,0,0,13,"Calaveras, California, US",45905,207,397,528,-131,15,323,338,10876,32600,239620,1088230,5086
22019,"Calcasieu","Louisiana",30.22931235,-93.35400434,567,42,0,525,"Calcasieu, Louisiana, US",203436,259,2897,2050,847,58,-644,-586,90083,446514,4892778,19589472,27526
21033,"Caldwell","Kentucky",37.14749129,-87.86948214,12,0,0,12,"Caldwell, Kentucky, US",12747,31,139,164,-25,-1,58,57,4781,13315,87653,362359,1402
22021,"Caldwell","Louisiana",32.0902519,-92.11752148,51,0,0,51,"Caldwell, Louisiana, US",9918,-46,123,120,3,-2,-45,-47,2873,6715,45842,180466,762
29025,"Caldwell","Missouri",39.65620858,-93.98308093,5,0,0,5,"Caldwell, Missouri, US",9020,-51,91,100,-9,2,-43,-41,1977,4549,29858,131905,703
37027,"Caldwell","North Carolina",35.95204977,-81.54799522,105,2,0,103,"Caldwell, North Carolina, US",82178,152,774,969,-195,57,294,351,26048,103693,847076,3386802,7451
48055,"Caldwell","Texas",29.83668859,-97.61814775,41,0,0,41,"Caldwell, Texas, US",43664,503,552,366,186,21,297,318,9680,26638,218356,892765,3196
50005,"Caledonia","Vermont",44.46548598,-72.10314651,14,0,0,14,"Caledonia, Vermont, US",29993,-243,272,278,-6,-6,-232,-238,12648,41177,340069,1484083,4858
1015,"Calhoun","Alabama",33.77483727,-85.82630386,138,3,0,135,"Calhoun, Alabama, US",113605,-726,1269,1532,-263,14,-475,-461,47539,181327,1442935,5930874,13272
12013,"Calhoun","Florida",30.40666734,-85.19394153,52,3,0,49,"Calhoun, Florida, US",14105,-438,133,165,-32,0,-409,-409,3208,6098,41703,164672,817
13037,"Calhoun","Georgia",31.53169785,-84.62725131,126,5,0,121,"Calhoun, Georgia, US",6189,-164,53,49,4,2,-171,-169,2011,1624,12329,55162,241
17013,"Calhoun","Illinois",39.16840183,-90.66330078,1,0,0,1,"Calhoun, Illinois, US",4739,-90,39,56,-17,1,-74,-73,1075,1548,7496,30949,295
19025,"Calhoun","Iowa",42.38521079,-94.64046046,2,0,0,2,"Calhoun, Iowa, US",9668,-43,102,124,-22,4,-25,-21,3188,9327,71094,295636,1372
26025,"Calhoun","Michigan",42.24633834,-85.00493569,339,21,0,318,"Calhoun, Michigan, US",134159,110,1497,1395,102,198,-184,14,61859,259131,2767843,11008318,14523
28013,"Calhoun","Mississippi",33.93683395,-89.33686647,60,4,0,56,"Calhoun, Mississippi, US",14361,-71,165,167,-2,7,-75,-68,3979,8918,59586,250893,1272
45017,"Calhoun","South Carolina",33.66926881,-80.77722168,9,1,0,8,"Calhoun, South Carolina, US",14553,-10,134,187,-53,2,43,45,3013,9839,94744,398201,995
48057,"Calhoun","Texas",28.47048236,-96.61633945,37,3,0,34,"Calhoun, Texas, US",21290,-214,262,218,44,8,-267,-259,12279,31074,425836,1747484,2160
54013,"Calhoun","West Virginia",38.84315422,-81.11934872,2,0,0,2,"Calhoun, West Virginia, US",7109,-108,49,85,-36,-2,-69,-71,1774,3132,31484,160738,372
48059,"Callahan","Texas",32.29760619,-99.37326312,8,1,0,7,"Callahan, Texas, US",13943,-47,143,173,-30,5,-21,-16,2606,5729,43904,195428,978
29027,"Callaway","Missouri",38.83674754,-91.92186505,24,1,0,23,"Callaway, Missouri, US",44743,-211,470,436,34,14,-260,-246,14972,40717,334602,1362913,3888
21035,"Calloway","Kentucky",36.62093411,-88.2731593,49,1,0,48,"Calloway, Kentucky, US",39001,37,359,407,-48,14,71,85,17677,53318,354144,1493562,4553
55015,"Calumet","Wisconsin",44.0816316,-88.21780273,69,1,0,68,"Calumet, Wisconsin, US",50089,-43,477,356,121,13,-175,-162,15006,53989,472754,2036660,4765
24009,"Calvert","Maryland",38.53961642,-76.56820632,298,15,0,283,"Calvert, Maryland, US",92525,460,892,722,170,26,272,298,23790,94993,909186,3868263,9926
16025,"Camas","Idaho",43.46665742,-114.8065892,1,0,0,1,"Camas, Idaho, US",1106,-15,10,6,4,0,-18,-18,403,443,2238,10062,82
42021,"Cambria","Pennsylvania",40.49527404,-78.71377428,56,2,0,54,"Cambria, Pennsylvania, US",130192,-1257,1218,1727,-509,29,-774,-745,53759,231086,1848949,7687610,18295
13039,"Camden","Georgia",30.92951916,-81.66601818,53,1,0,52,"Camden, Georgia, US",54666,1015,768,372,396,-29,645,616,20526,42147,274461,1165662,4267
29029,"Camden","Missouri",38.02199522,-92.76083747,36,1,0,35,"Camden, Missouri, US",46305,392,381,535,-154,-12,558,546,18193,67069,466640,2136434,8327
34007,"Camden","New Jersey",39.80343818,-74.96388753,5953,303,0,5650,"Camden, New Jersey, US",506471,118,5923,4741,1182,556,-1610,-1054,196841,1056316,12250766,51956048,68536
37029,"Camden","North Carolina",36.33804939,-76.15568396,3,0,0,3,"Camden, North Carolina, US",10867,191,96,63,33,11,148,159,1320,2185,14510,60981,489
22023,"Cameron","Louisiana",29.87592238,-93.19310676,3,0,0,3,"Cameron, Louisiana, US",6973,-40,86,66,20,-4,-57,-61,4466,5178,75898,520133,638
42023,"Cameron","Pennsylvania",41.43625568,-78.20376845,2,0,0,2,"Cameron, Pennsylvania, US",4447,-54,37,70,-33,8,-28,-20,2245,6382,58916,242466,436
48061,"Cameron","Texas",26.14524221,-97.48140372,698,32,0,666,"Cameron, Texas, US",423163,1024,6202,2788,3414,11,-2407,-2396,142401,610339,3949775,16489406,37722
48063,"Camp","Texas",32.97195142,-94.97790104,32,0,0,32,"Camp, Texas, US",13094,111,178,131,47,20,45,65,3679,8121,80665,309461,911
21037,"Campbell","Kentucky",38.94384345,-84.37875208,146,11,0,135,"Campbell, Kentucky, US",93584,120,1141,887,254,-1,-130,-131,30151,122710,1068265,4268349,9433
47013,"Campbell","Tennessee",36.40355516,-84.1510856,17,1,0,16,"Campbell, Tennessee, US",39842,47,438,581,-143,23,169,192,9984,32621,228620,992470,3051
51031,"Campbell","Virginia",37.20553386,-79.09678609,13,1,0,12,"Campbell, Virginia, US",54885,-252,478,577,-99,33,-185,-152,20000,68030,646753,2541101,6377
56005,"Campbell","Wyoming",44.24886082,-105.5474404,30,0,0,30,"Campbell, Wyoming, US",46341,42,597,323,274,33,-268,-235,29594,108605,1517183,6218368,8303
40017,"Canadian","Oklahoma",35.5426055,-97.98465569,124,3,0,121,"Canadian, Oklahoma, US",148306,3880,1829,1092,737,57,3078,3135,34791,144435,1288645,5448175,15829
13043,"Candler","Georgia",32.40209349,-82.07702563,13,0,0,13,"Candler, Georgia, US",10803,-24,130,125,5,2,-30,-28,3108,9036,60282,243264,979
47015,"Cannon","Tennessee",35.80990797,-86.05738983,16,0,0,16,"Cannon, Tennessee, US",14678,238,180,155,25,7,206,213,2380,6089,42192,182458,921
16027,"Canyon","Idaho",43.61970148,-116.7095499,284,6,0,278,"Canyon, Idaho, US",229849,6613,3099,1547,1552,-96,5132,5036,61763,274749,2134809,9233828,24565
29031,"Cape Girardeau","Missouri",37.38489388,-89.6843587,58,2,0,56,"Cape Girardeau, Missouri, US",78871,233,899,738,161,128,-53,75,42702,186351,1607086,6657361,13502
34009,"Cape May","New Jersey",39.15008829,-74.80170244,558,48,0,510,"Cape May, New Jersey, US",92039,-407,734,1299,-565,-15,181,166,41980,145903,1112427,5964546,22594
30009,"Carbon","Montana",45.22850116,-109.0274047,6,0,0,6,"Carbon, Montana, US",10725,34,73,86,-13,2,46,48,3386,9693,59097,259334,1976
42025,"Carbon","Pennsylvania",40.91545395,-75.7068525,227,22,0,205,"Carbon, Pennsylvania, US",64182,7,589,801,-212,6,219,225,17088,61487,434145,1787549,6312
56007,"Carbon","Wyoming",41.69357844,-106.9326084,16,0,0,16,"Carbon, Wyoming, US",14800,-79,176,119,57,8,-144,-136,7431,18286,171046,684853,2716
16029,"Caribou","Idaho",42.77149116,-111.5597683,1,0,0,1,"Caribou, Idaho, US",7155,118,98,60,38,7,73,80,3655,6424,81048,363485,791
21039,"Carlisle","Kentucky",36.85372876,-88.9669222,5,1,0,4,"Carlisle, Kentucky, US",4760,21,53,48,5,0,17,17,1130,2252,13310,56275,365
27017,"Carlton","Minnesota",46.59180601,-92.67601019,71,0,0,71,"Carlton, Minnesota, US",35871,49,368,368,0,2,50,52,14266,34032,273644,1192545,3606
24011,"Caroline","Maryland",38.87172293,-75.82904158,231,0,0,231,"Caroline, Maryland, US",33406,100,397,349,48,43,9,52,8719,28419,249118,1055615,3179
51033,"Caroline","Virginia",38.02679129,-77.34901405,46,2,0,44,"Caroline, Virginia, US",30725,-26,343,289,54,5,-84,-79,6509,16573,124796,524654,1992
5015,"Carroll","Arkansas",36.3403856,-93.54270261,10,0,0,10,"Carroll, Arkansas, US",28380,283,301,305,-4,25,265,290,10858,34146,252634,1059988,3744
13045,"Carroll","Georgia",33.58138199,-85.07976677,440,24,0,416,"Carroll, Georgia, US",119992,1995,1535,1093,442,55,1494,1549,41898,163724,1478329,6164236,11912
17015,"Carroll","Illinois",42.06823429,-89.93395545,13,2,0,11,"Carroll, Illinois, US",14305,-9,131,192,-61,2,51,53,5124,13654,107461,461256,1906
18015,"Carroll","Indiana",40.5807832,-86.56198812,88,2,0,86,"Carroll, Indiana, US",20257,69,232,191,41,16,13,29,5497,13218,98740,416137,1998
19027,"Carroll","Iowa",42.03617207,-94.86032705,8,0,0,8,"Carroll, Iowa, US",20165,12,237,224,13,7,-8,-1,11502,43291,370732,1507737,4795
21041,"Carroll","Kentucky",38.66599534,-85.12601074,7,0,0,7,"Carroll, Kentucky, US",10631,-81,141,125,16,0,-98,-98,7149,16332,218093,805880,1065
24013,"Carroll","Maryland",39.56453592,-77.02373735,765,76,0,689,"Carroll, Maryland, US",168447,180,1663,1615,48,21,120,141,56874,270927,2469601,10441795,24642
28015,"Carroll","Mississippi",33.44834567,-89.91994479,113,9,0,104,"Carroll, Mississippi, US",9947,27,84,101,-17,-2,46,44,1075,2200,15454,59750,479
29033,"Carroll","Missouri",39.42762566,-93.50626255,7,0,0,7,"Carroll, Missouri, US",8679,-47,84,114,-30,-2,-14,-16,2948,6365,45194,189653,1026
33003,"Carroll","New Hampshire",43.87498583,-71.20430216,46,0,0,46,"Carroll, New Hampshire, US",48910,156,325,582,-257,10,402,412,21589,90983,681781,3072497,10684
39019,"Carroll","Ohio",40.5789686,-81.09178213,28,2,0,26,"Carroll, Ohio, US",26914,-168,269,303,-34,-2,-132,-134,7723,28250,226612,930918,2424
47017,"Carroll","Tennessee",35.97366108,-88.45189331,27,1,0,26,"Carroll, Tennessee, US",27767,-208,296,394,-98,0,-112,-112,7927,24607,173844,692916,2171
51035,"Carroll","Virginia",36.73066666,-80.73455942,66,1,0,65,"Carroll, Virginia, US",29791,50,199,383,-184,16,220,236,8888,16517,96660,420607,2052
48065,"Carson","Texas",35.40365929,-101.3542669,6,0,0,6,"Carson, Texas, US",5926,-81,43,55,-12,0,-68,-68,2162,2672,16902,89847,502
32510,"Carson City","Nevada",39.15509045,-119.7480219,83,4,0,79,"Carson City, Nevada, US",55916,714,598,637,-39,-43,795,752,29879,106031,1032676,4548541,10656
21043,"Carter","Kentucky",38.31690743,-83.05092385,9,0,0,9,"Carter, Kentucky, US",26797,-243,310,336,-26,3,-221,-218,6827,19665,114888,481067,2041
29035,"Carter","Missouri",36.94160441,-90.96051322,4,1,0,3,"Carter, Missouri, US",5982,-101,72,89,-17,-1,-84,-85,2040,3813,20215,87487,645
40019,"Carter","Oklahoma",34.25103751,-97.28552485,22,1,0,21,"Carter, Oklahoma, US",48111,-102,630,614,16,4,-120,-116,23887,94640,843871,3494103,9167
47019,"Carter","Tennessee",36.28969086,-82.12588974,19,1,0,18,"Carter, Tennessee, US",56391,-26,473,760,-287,6,256,262,12595,38093,261680,1112804,3705
37031,"Carteret","North Carolina",34.8932941,-76.54120135,36,9,0,27,"Carteret, North Carolina, US",69473,35,531,894,-363,22,378,400,27062,103199,731601,3198426,11634
27019,"Carver","Minnesota",44.82017001,-93.8009918,154,2,0,152,"Carver, Minnesota, US",105089,1556,1157,549,608,47,905,952,40156,189259,2269824,9772632,14595
30013,"Cascade","Montana",47.30797024,-111.3467922,17,2,0,15,"Cascade, Montana, US",81366,-322,1054,785,269,6,-595,-589,39296,154475,1357445,5739872,14191
21045,"Casey","Kentucky",37.32533118,-84.92726209,2,0,0,2,"Casey, Kentucky, US",16159,233,185,202,-17,-2,254,252,3910,12058,76153,297340,1063
17017,"Cass","Illinois",39.96991073,-90.24734436,67,0,0,67,"Cass, Illinois, US",12147,-165,167,130,37,44,-247,-203,5728,11153,106186,408998,1145
18017,"Cass","Indiana",40.76135835,-86.34830753,1579,6,0,1573,"Cass, Indiana, US",37689,-206,452,415,37,112,-354,-242,15610,52411,394026,1639769,3555
19029,"Cass","Iowa",41.33149454,-94.92792482,10,0,0,10,"Cass, Iowa, US",12836,-112,141,182,-41,7,-77,-70,6539,21181,155779,684305,2373
26027,"Cass","Michigan",41.91522292,-85.99405727,76,2,0,74,"Cass, Michigan, US",51787,62,496,529,-33,-5,104,99,12352,35198,264896,1187200,3917
27021,"Cass","Minnesota",46.95043611,-94.32603968,11,3,0,8,"Cass, Minnesota, US",29779,268,284,329,-45,7,304,311,10659,31021,204923,992171,4625
29037,"Cass","Missouri",38.64789422,-94.353399,77,8,0,69,"Cass, Missouri, US",105780,1011,1128,993,135,4,876,880,26392,109928,804515,3442291,11342
31025,"Cass","Nebraska",40.90899107,-96.13971217,34,0,0,34,"Cass, Nebraska, US",26248,59,267,232,35,7,17,24,6490,20166,165354,696933,2993
38017,"Cass","North Dakota",46.93201724,-97.2444719,1487,35,0,1452,"Cass, North Dakota, US",181923,1629,2511,1116,1395,416,-174,242,108110,596897,6924350,28526206,32923
48067,"Cass","Texas",33.07499881,-94.34646905,21,0,0,21,"Cass, Texas, US",30026,-80,302,405,-103,6,18,24,9074,23107,182369,750992,2582
16031,"Cassia","Idaho",42.28347888,-113.6012409,22,1,0,21,"Cassia, Idaho, US",24030,239,391,185,206,3,31,34,10582,34513,270330,1129317,3495
48069,"Castro","Texas",34.53016752,-102.2617243,29,1,0,28,"Castro, Texas, US",7530,-58,104,57,47,24,-129,-105,2771,4393,37041,165010,739
37033,"Caswell","North Carolina",36.39312665,-79.33353281,52,1,0,51,"Caswell, North Carolina, US",22604,-30,210,245,-35,13,-5,8,3190,7112,42132,185630,1166
22025,"Catahoula","Louisiana",31.66778967,-91.84526385,112,3,0,109,"Catahoula, Louisiana, US",9494,-112,106,115,-9,11,-114,-103,2482,4755,31306,128973,692
37035,"Catawba","North Carolina",35.66211129,-81.2132617,143,3,0,140,"Catawba, North Carolina, US",159551,864,1671,1713,-42,233,679,912,82101,433343,4363585,17022629,24411
13047,"Catoosa","Georgia",34.89872298,-85.13757014,97,0,0,97,"Catoosa, Georgia, US",67580,200,674,676,-2,2,204,206,16241,58168,427484,1772266,5078
35003,"Catron","New Mexico",33.91514144,-108.4046587,2,1,0,1,"Catron, New Mexico, US",3527,-27,10,28,-18,0,-9,-9,955,1131,5662,24159,188
36009,"Cattaraugus","New York",42.24778241,-78.67923096,78,0,0,78,"Cattaraugus, New York, US",76117,-609,801,848,-47,5,-565,-560,30632,102217,795470,3294543,9046
36011,"Cayuga","New York",42.91261714,-76.55731592,76,1,0,75,"Cayuga, New York, US",76576,-545,741,711,30,26,-602,-576,28353,92919,784263,3335786,8983
24015,"Cecil","Maryland",39.56647682,-75.94627411,342,20,0,322,"Cecil, Maryland, US",102855,211,1130,1004,126,-12,102,90,33776,113594,1025456,4547886,10006
19031,"Cedar","Iowa",41.77233777,-91.13246684,44,1,0,43,"Cedar, Iowa, US",18627,63,194,171,23,0,42,42,5809,19046,145322,631268,2412
29039,"Cedar","Missouri",37.72391475,-93.85445441,9,0,0,9,"Cedar, Missouri, US",14349,213,186,207,-21,-3,239,236,3881,8924,51785,217104,1278
31027,"Cedar","Nebraska",42.5988851,-97.25311951,7,0,0,7,"Cedar, Nebraska, US",8402,-51,103,93,10,1,-62,-61,3650,8541,62495,272895,1489
42027,"Centre","Pennsylvania",40.92058903,-77.82200624,143,6,0,137,"Centre, Pennsylvania, US",162385,-216,1147,1105,42,835,-1101,-266,81057,248210,2225777,9326512,19576
19033,"Cerro Gordo","Iowa",43.08177563,-93.2612239,21,1,0,20,"Cerro Gordo, Iowa, US",42450,-192,442,495,-53,15,-153,-138,24692,94697,830157,3480052,8011
8015,"Chaffee","Colorado",38.74745778,-106.1926573,70,18,0,52,"Chaffee, Colorado, US",20356,315,131,175,-44,9,351,360,8182,30299,213325,988932,5199
1017,"Chambers","Alabama",32.91360079,-85.39072749,330,23,0,307,"Chambers, Alabama, US",33254,-346,354,441,-87,6,-265,-259,8353,30485,213617,878741,2918
48071,"Chambers","Texas",29.70972016,-94.67154501,58,0,0,58,"Chambers, Texas, US",43837,1610,561,275,286,35,1290,1325,13662,56003,901704,3343091,3466
17019,"Champaign","Illinois",40.13919438,-88.20046615,537,7,0,530,"Champaign, Illinois, US",209689,-229,2232,1389,843,1608,-2697,-1089,109471,354112,3464294,14202616,25082
39021,"Champaign","Ohio",40.13923427,-83.76875242,26,1,0,25,"Champaign, Ohio, US",38885,100,412,398,14,3,87,90,11996,40584,331174,1347410,2956
29041,"Chariton","Missouri",39.51499357,-92.9629191,6,0,0,6,"Chariton, Missouri, US",7426,-31,82,98,-16,0,-14,-14,2201,5257,38568,159213,853
24017,"Charles","Maryland",38.51092331,-76.98580666,969,69,0,900,"Charles, Maryland, US",163257,1781,1847,1164,683,65,1043,1108,42905,182220,1605329,6832245,15256
51036,"Charles City","Virginia",37.35358063,-77.05634116,27,1,0,26,"Charles City, Virginia, US",6963,-37,52,92,-40,1,3,4,1724,5187,51046,219464,599
46023,"Charles Mix","South Dakota",43.20660134,-98.58856175,12,0,0,12,"Charles Mix, South Dakota, US",9292,-39,157,106,51,-1,-90,-91,4105,9547,56720,248748,1331
45019,"Charleston","South Carolina",32.82487866,-79.96512315,550,11,0,539,"Charleston, South Carolina, US",411406,5184,4763,3629,1134,423,3601,4024,241776,1187346,12804224,52408879,82906
26029,"Charlevoix","Michigan",45.37790017,-85.19614053,14,1,0,13,"Charlevoix, Michigan, US",26143,-44,218,292,-74,20,12,32,10745,34327,311127,1379619,4184
12015,"Charlotte","Florida",26.90131002,-81.92949121,417,56,0,361,"Charlotte, Florida, US",188910,4061,1047,2841,-1794,160,5674,5834,49005,213978,1695748,6949317,23511
51037,"Charlotte","Virginia",37.01909701,-78.66314092,19,0,0,19,"Charlotte, Virginia, US",11880,-64,115,158,-43,4,-25,-21,3004,7780,57932,233966,1076
51540,"Charlottesville","Virginia",38.03527919,-78.48569588,74,3,0,71,"Charlottesville, Virginia, US",47266,-240,568,312,256,184,-681,-497,37578,156663,1942698,7848067,11546
13049,"Charlton","Georgia",30.78371028,-82.13951596,29,1,0,28,"Charlton, Georgia, US",13392,473,109,107,2,85,383,468,2723,4891,35399,145015,638
20017,"Chase","Kansas",38.30292938,-96.59563862,4,0,0,4,"Chase, Kansas, US",2648,48,18,14,4,0,44,44,812,1264,9462,39925,200
13051,"Chatham","Georgia",32.00043026,-81.12489526,435,21,0,414,"Chatham, Georgia, US",289430,264,3549,2570,979,304,-994,-690,152259,762801,7193595,30068424,46447
37037,"Chatham","North Carolina",35.70394416,-79.25541492,573,26,0,547,"Chatham, North Carolina, US",74470,1343,667,770,-103,-8,1448,1440,17373,69166,556226,2288642,8108
13053,"Chattahoochee","Georgia",32.34341231,-84.78809239,22,0,0,22,"Chattahoochee, Georgia, US",10907,307,239,24,215,38,53,91,14985,8374,139118,440210,457
13055,"Chattooga","Georgia",34.47197698,-85.34535662,24,2,0,22,"Chattooga, Georgia, US",24789,7,299,310,-11,5,13,18,7018,15806,111312,462077,1435
20019,"Chautauqua","Kansas",37.14994405,-96.2454192,4,0,0,4,"Chautauqua, Kansas, US",3250,-54,28,40,-12,0,-42,-42,1076,1328,7480,29917,217
36013,"Chautauqua","New York",42.2276921,-79.36691763,72,4,0,68,"Chautauqua, New York, US",126903,-569,1282,1398,-116,21,-471,-450,55959,211519,1684631,6938569,16564
35005,"Chaves","New Mexico",33.36406072,-104.4665365,35,2,0,33,"Chaves, New Mexico, US",64615,61,819,635,184,26,-148,-122,23320,81540,654706,2761956,7734
47021,"Cheatham","Tennessee",36.26136216,-87.08903581,103,0,0,103,"Cheatham, Tennessee, US",40667,165,451,403,48,-1,119,118,8963,27140,223443,955892,3235
26031,"Cheboygan","Michigan",45.44787015,-84.50122149,21,1,0,20,"Cheboygan, Michigan, US",25276,-228,219,370,-151,-1,-74,-75,7568,21160,142706,767151,3920
53007,"Chelan","Washington",47.87046092,-120.6173956,204,6,0,198,"Chelan, Washington, US",77200,448,851,687,164,7,279,286,37202,161008,1524600,6706768,15037
36015,"Chemung","New York",42.13891056,-76.7638805,136,1,0,135,"Chemung, New York, US",83456,-479,859,943,-84,17,-411,-394,38709,141269,1268443,5244404,9877
36017,"Chenango","New York",42.49430041,-75.60887553,118,0,0,118,"Chenango, New York, US",47207,-238,470,535,-65,-2,-169,-171,18747,50014,537327,1975249,4899
1019,"Cherokee","Alabama",34.17805983,-85.60638968,33,2,0,31,"Cherokee, Alabama, US",26196,182,222,343,-121,-3,306,303,6037,15739,103111,426324,1771
13057,"Cherokee","Georgia",34.24393976,-84.47431861,807,29,0,778,"Cherokee, Georgia, US",258773,4859,2721,1656,1065,217,3561,3778,63572,293379,2560591,10756629,31958
19035,"Cherokee","Iowa",42.73538914,-95.62389402,14,0,0,14,"Cherokee, Iowa, US",11235,-60,112,163,-51,3,-11,-8,5409,14917,114001,475527,1650
20021,"Cherokee","Kansas",37.16928494,-94.8462897,9,0,0,9,"Cherokee, Kansas, US",19939,-96,212,264,-52,10,-54,-44,6654,15428,129520,556454,1536
37039,"Cherokee","North Carolina",35.1349263,-84.05970864,30,1,0,29,"Cherokee, North Carolina, US",28612,243,250,380,-130,-14,386,372,9513,29869,202226,865126,3031
40021,"Cherokee","Oklahoma",35.90692775,-94.99980896,28,1,0,27,"Cherokee, Oklahoma, US",48657,50,556,534,22,42,-11,31,16784,39762,266968,1086178,4019
45021,"Cherokee","South Carolina",35.05122251,-81.61828622,27,2,0,25,"Cherokee, South Carolina, US",57300,231,652,624,28,-9,214,205,18651,85475,672071,2768616,5068
48073,"Cherokee","Texas",31.837258,-95.16559897,44,2,0,42,"Cherokee, Texas, US",52646,265,722,553,169,3,94,97,16116,47501,378621,1531629,3986
31031,"Cherry","Nebraska",42.54502621,-101.1244332,1,0,0,1,"Cherry, Nebraska, US",5689,-74,77,57,20,-2,-92,-94,3493,6298,38674,173668,1061
51550,"Chesapeake","Virginia",36.67670048,-76.30545744,426,13,0,413,"Chesapeake, Virginia, US",244835,2476,2865,1920,945,94,1458,1552,95905,516509,5254855,21450654,32185
33005,"Cheshire","New Hampshire",42.92015988,-72.25311043,51,2,0,49,"Cheshire, New Hampshire, US",76085,184,636,718,-82,52,217,269,36235,133154,1340788,5719212,10833
42029,"Chester","Pennsylvania",39.97291773,-75.74768357,2364,245,0,2119,"Chester, Pennsylvania, US",524989,2903,5292,4194,1098,895,948,1843,248658,1443379,26390837,101176494,87057
45023,"Chester","South Carolina",34.69249168,-81.1583216,46,0,0,46,"Chester, South Carolina, US",32244,-60,358,424,-66,4,5,9,8510,28650,261859,1085247,2755
47023,"Chester","Tennessee",35.42527478,-88.6095842,12,0,0,12,"Chester, Tennessee, US",17297,52,181,159,22,7,25,32,4847,10945,68852,301094,1105
45025,"Chesterfield","South Carolina",34.64137396,-80.1564014,129,2,0,127,"Chesterfield, South Carolina, US",45650,-231,496,571,-75,13,-168,-155,16611,52986,450464,1845073,3688
51041,"Chesterfield","Virginia",37.37373208,-77.5868014,1193,29,0,1164,"Chesterfield, Virginia, US",352802,4521,3868,2622,1246,257,3032,3289,119988,634563,6368593,26533765,44221
8017,"Cheyenne","Colorado",38.82777431,-102.6032558,5,0,0,5,"Cheyenne, Colorado, US",1831,-28,17,13,4,6,-38,-32,1170,1992,33486,115938,209
20023,"Cheyenne","Kansas",39.78580976,-101.7318201,2,0,0,2,"Cheyenne, Kansas, US",2657,12,28,43,-15,2,24,26,1177,2300,16557,69888,411
31033,"Cheyenne","Nebraska",41.21999357,-102.9941693,9,0,0,9,"Cheyenne, Nebraska, US",8910,-372,86,84,2,-3,-371,-374,6398,12730,155502,541813,1390
19037,"Chickasaw","Iowa",43.06001295,-92.31773347,8,0,0,8,"Chickasaw, Iowa, US",11933,-19,145,111,34,6,-59,-53,5050,15421,126637,568427,1988
28017,"Chickasaw","Mississippi",33.91983202,-88.9481545,125,12,0,113,"Chickasaw, Mississippi, US",17103,3,231,200,31,19,-45,-26,6149,28648,195189,785869,1576
5017,"Chicot","Arkansas",33.26458973,-91.29539209,12,0,0,12,"Chicot, Arkansas, US",10118,-324,111,150,-39,-2,-283,-285,3668,6623,48499,209726,969
48075,"Childress","Texas",34.5293041,-100.2077916,2,0,0,2,"Childress, Texas, US",7306,-9,66,49,17,4,-30,-26,2759,4339,29905,121602,678
1021,"Chilton","Alabama",32.85044126,-86.7173256,86,1,0,85,"Chilton, Alabama, US",44428,265,551,503,48,35,184,219,10819,34241,259346,1081733,4045
26033,"Chippewa","Michigan",46.29552653,-84.54353449,2,0,0,2,"Chippewa, Michigan, US",37349,-112,318,374,-56,3,-57,-54,14594,39099,281164,1204547,4197
27023,"Chippewa","Minnesota",45.02343421,-95.56403693,39,0,0,39,"Chippewa, Minnesota, US",11800,-101,164,138,26,21,-148,-127,6029,19542,159096,665751,1988
55017,"Chippewa","Wisconsin",45.06939744,-91.28068855,48,0,0,48,"Chippewa, Wisconsin, US",64658,549,654,576,78,-1,474,473,25969,105460,919207,3945774,9017
27025,"Chisago","Minnesota",45.5021011,-92.90861945,44,1,0,43,"Chisago, Minnesota, US",56579,607,600,401,199,20,391,411,16695,67590,619665,2758674,7092
50007,"Chittenden","Vermont",44.46322849,-73.08359212,440,38,0,402,"Chittenden, Vermont, US",163774,203,1450,1151,299,317,-410,-93,101282,482544,5360802,22347207,33607
1023,"Choctaw","Alabama",32.02227341,-88.2656443,139,4,0,135,"Choctaw, Alabama, US",12589,-244,133,176,-43,-2,-199,-201,3477,9073,87669,358945,1247
28019,"Choctaw","Mississippi",33.34598242,-89.24809382,29,2,0,27,"Choctaw, Mississippi, US",8210,-55,80,106,-26,1,-28,-27,1954,3760,37293,146071,504
40023,"Choctaw","Oklahoma",34.02807439,-95.54771129,14,0,0,14,"Choctaw, Oklahoma, US",14672,-26,193,204,-11,0,-14,-14,5031,14641,98825,413348,1403
37041,"Chowan","North Carolina",36.12908077,-76.60118385,15,0,0,15,"Chowan, North Carolina, US",13943,-122,136,191,-55,0,-66,-66,4594,13971,115225,488488,1690
17021,"Christian","Illinois",39.54581621,-89.27780482,33,4,0,29,"Christian, Illinois, US",32304,-349,324,396,-72,-1,-275,-276,11332,35636,262260,1073387,3752
21047,"Christian","Kentucky",36.89267803,-87.49055367,103,3,0,100,"Christian, Kentucky, US",70461,-251,1466,627,839,-62,-1026,-1088,53635,110550,930082,3874902,7417
29043,"Christian","Missouri",36.9711783,-93.18537118,21,0,0,21,"Christian, Missouri, US",88595,1551,1025,664,361,10,1178,1188,18237,75924,532127,2298110,10269
32001,"Churchill","Nevada",39.58105744,-118.3394607,6,0,0,6,"Churchill, Nevada, US",24909,403,327,260,67,-5,341,336,9743,20594,182545,761125,2361
35006,"Cibola","New Mexico",34.91131525,-107.998876,122,4,0,118,"Cibola, New Mexico, US",26675,-91,306,263,43,9,-143,-134,9317,19624,139114,565291,1493
40025,"Cimarron","Oklahoma",36.74817177,-102.5173885,1,0,0,1,"Cimarron, Oklahoma, US",2137,-28,22,9,13,2,-42,-40,1001,1004,6086,25085,253
12017,"Citrus","Florida",28.84804315,-82.47614748,119,12,0,107,"Citrus, Florida, US",149657,1975,1066,2706,-1640,-18,3619,3601,36145,156064,1296931,5247016,16137
41005,"Clackamas","Oregon",45.18787398,-122.2179634,290,9,0,281,"Clackamas, Oregon, US",418187,2771,3987,3559,428,23,2340,2363,149407,846970,9908523,41276678,72054
22027,"Claiborne","Louisiana",32.82308512,-92.99526883,58,10,0,48,"Claiborne, Louisiana, US",15670,-225,134,200,-66,0,-160,-160,4387,9704,85896,369564,1129
28021,"Claiborne","Mississippi",31.97061673,-90.90702196,57,1,0,56,"Claiborne, Mississippi, US",8988,-84,113,101,12,1,-98,-97,2728,4384,45639,181428,377
47025,"Claiborne","Tennessee",36.48319149,-83.65947309,8,0,0,8,"Claiborne, Tennessee, US",31959,109,333,427,-94,22,183,205,9156,25671,196473,821893,2189
53009,"Clallam","Washington",48.04754642,-123.9226319,25,0,0,25,"Clallam, Washington, US",77331,780,632,1061,-429,44,1162,1206,26436,91334,760476,3247698,11956
26035,"Clare","Michigan",43.98794227,-84.8481986,17,2,0,15,"Clare, Michigan, US",30950,215,324,400,-76,6,286,292,8113,24286,172189,770076,2873
45027,"Clarendon","South Carolina",33.66610974,-80.21647898,289,37,0,252,"Clarendon, South Carolina, US",33745,3,302,408,-106,-1,113,112,8088,23253,136008,578211,2450
42031,"Clarion","Pennsylvania",41.19265812,-79.42413524,28,2,0,26,"Clarion, Pennsylvania, US",38438,-234,370,440,-70,11,-175,-164,14697,52425,370409,1626680,5135
5019,"Clark","Arkansas",34.04613432,-93.17484713,36,0,0,36,"Clark, Arkansas, US",22320,7,233,241,-8,2,14,16,9167,29026,219286,876184,2593
17023,"Clark","Illinois",39.33425789,-87.78705622,10,0,0,10,"Clark, Illinois, US",15441,-159,168,199,-31,-3,-125,-128,5196,13869,108582,443348,1581
18019,"Clark","Indiana",38.48015445,-85.70510334,450,38,0,412,"Clark, Indiana, US",118302,1022,1436,1197,239,64,719,783,46769,244712,2176871,8935940,14324
20025,"Clark","Kansas",37.23577007,-99.81883015,31,1,0,30,"Clark, Kansas, US",1994,0,23,22,1,0,-1,-1,824,993,10555,44833,215
21049,"Clark","Kentucky",37.9689263,-84.14615986,37,0,0,37,"Clark, Kentucky, US",36263,83,426,414,12,-10,82,72,13667,55796,471938,1928493,3934
29045,"Clark","Missouri",40.41040752,-91.73661677,1,0,0,1,"Clark, Missouri, US",6797,-36,72,67,5,4,-45,-41,1845,4338,24516,104190,637
32003,"Clark","Nevada",36.21458855,-115.0130241,5815,322,0,5493,"Clark, Nevada, US",2266715,40600,27048,17919,9129,-360,31643,31283,918012,5113722,53053580,213313420,274448
39023,"Clark","Ohio",39.91592258,-83.78498252,195,6,0,189,"Clark, Ohio, US",134083,-445,1554,1661,-107,23,-355,-332,48388,210545,1779297,7371465,12790
46025,"Clark","South Dakota",44.85834507,-97.72925109,4,0,0,4,"Clark, South Dakota, US",3736,10,64,30,34,1,-26,-25,1650,2128,16315,68590,496
53011,"Clark","Washington",45.77568046,-122.4829204,399,22,0,377,"Clark, Washington, US",488241,6814,5574,3766,1808,139,4847,4986,151638,799958,9390175,39334791,66070
55019,"Clark","Wisconsin",44.73483377,-90.61207486,28,4,0,24,"Clark, Wisconsin, US",34774,69,568,313,255,14,-200,-186,12998,41987,357309,1507988,4117
1025,"Clarke","Alabama",31.68099859,-87.83548597,97,2,0,95,"Clarke, Alabama, US",23622,-296,266,324,-58,-5,-232,-237,8313,30143,238739,964943,3181
13059,"Clarke","Georgia",33.95436462,-83.37124007,222,13,0,209,"Clarke, Georgia, US",128331,1063,1339,806,533,326,205,531,70897,239472,2036826,8576335,17608
19039,"Clarke","Iowa",41.02868181,-93.78499767,30,0,0,30,"Clarke, Iowa, US",9395,-107,124,106,18,19,-142,-123,4384,9945,77780,326222,776
28023,"Clarke","Mississippi",32.04158545,-88.6889622,124,16,0,108,"Clarke, Mississippi, US",15541,-44,199,202,-3,0,-40,-40,3864,8257,63604,266944,1051
51043,"Clarke","Virginia",39.11271747,-77.99199425,21,0,0,21,"Clarke, Virginia, US",14619,108,122,142,-20,-1,130,129,4119,10259,97885,409862,1703
41007,"Clatsop","Oregon",45.99712889,-123.660711,45,0,0,45,"Clatsop, Oregon, US",40224,513,377,398,-21,-12,542,530,18133,74607,543893,2441246,8584
1027,"Clay","Alabama",33.26984193,-85.85836077,27,2,0,25,"Clay, Alabama, US",13235,-59,143,187,-44,-2,-12,-14,4083,15631,129807,521343,844
5021,"Clay","Arkansas",36.36826212,-90.4148172,4,0,0,4,"Clay, Arkansas, US",14551,-212,155,197,-42,0,-170,-170,4905,10489,67376,295158,1430
12019,"Clay","Florida",29.98319144,-81.85609986,354,27,0,327,"Clay, Florida, US",219252,3344,2183,1877,306,170,2875,3045,49196,235025,1896276,7935335,22815
13061,"Clay","Georgia",31.62221166,-84.97713865,35,2,0,33,"Clay, Georgia, US",2834,-50,22,35,-13,-2,-34,-36,545,437,2218,9545,92
17025,"Clay","Illinois",38.75388572,-88.48914513,2,0,0,2,"Clay, Illinois, US",13184,-82,144,173,-29,1,-53,-52,5699,22954,215586,878798,1752
18021,"Clay","Indiana",39.39561833,-87.11723506,38,1,0,37,"Clay, Indiana, US",26225,50,307,288,19,1,32,33,7470,22223,154225,633951,2378
19041,"Clay","Iowa",43.08247182,-95.15096481,10,0,0,10,"Clay, Iowa, US",16016,-90,201,163,38,4,-133,-129,9013,31209,256780,1092766,3167
20027,"Clay","Kansas",39.34948772,-97.16518128,5,1,0,4,"Clay, Kansas, US",8002,-1,92,106,-14,1,13,14,3880,8086,54793,222432,1157
21051,"Clay","Kentucky",37.16451126,-83.712575,4,0,0,4,"Clay, Kentucky, US",19901,-187,239,245,-6,-3,-178,-181,3947,10491,73413,277237,1091
27027,"Clay","Minnesota",46.89289518,-96.48761922,361,23,0,338,"Clay, Minnesota, US",64222,205,851,453,398,100,-294,-194,22205,84484,686855,2887113,7501
28025,"Clay","Mississippi",33.65358105,-88.77784255,96,3,0,93,"Clay, Mississippi, US",19316,-88,209,230,-21,4,-70,-66,6086,17684,128053,518537,1718
29047,"Clay","Missouri",39.31132056,-94.41850862,141,2,0,139,"Clay, Missouri, US",249948,3588,3051,1803,1248,109,2231,2340,94337,520986,6058619,24713384,30272
31035,"Clay","Nebraska",40.52439441,-98.05126296,22,0,0,22,"Clay, Nebraska, US",6203,1,80,69,11,-1,-8,-9,2499,4409,31547,142279,930
37043,"Clay","North Carolina",35.05704275,-83.74353633,8,0,0,8,"Clay, North Carolina, US",11231,107,87,163,-76,-8,189,181,2459,6234,40807,173790,954
46027,"Clay","South Dakota",42.91296147,-96.97656917,15,0,0,15,"Clay, South Dakota, US",14070,87,131,80,51,-1,38,37,6695,13596,76065,319117,1464
47027,"Clay","Tennessee",36.55151008,-85.53930419,6,0,0,6,"Clay, Tennessee, US",7615,-62,64,101,-37,2,-29,-27,2077,3525,20971,90530,445
48077,"Clay","Texas",33.78686685,-98.20771198,3,0,0,3,"Clay, Texas, US",10471,23,75,122,-47,7,63,70,1899,2404,16233,68557,560
54015,"Clay","West Virginia",38.46231092,-81.07652217,2,0,0,2,"Clay, West Virginia, US",8508,-131,88,109,-21,0,-110,-110,1729,2193,12689,55155,338
13063,"Clayton","Georgia",33.54187245,-84.35594188,1089,43,0,1046,"Clayton, Georgia, US",292256,3059,4074,1852,2222,423,408,831,95093,376463,3597886,14596022,22147
19043,"Clayton","Iowa",42.84443388,-91.34133693,30,3,0,27,"Clayton, Iowa, US",17549,9,178,188,-10,9,11,20,7600,22241,163079,779952,2895
8019,"Clear Creek","Colorado",39.68864463,-105.6463118,16,1,0,15,"Clear Creek, Colorado, US",9700,96,73,57,16,23,56,79,3409,11960,82082,334804,1737
42033,"Clearfield","Pennsylvania",41.00110782,-78.47592663,34,0,0,34,"Clearfield, Pennsylvania, US",79255,-317,732,943,-211,59,-161,-102,32438,125861,989658,4131173,11183
27029,"Clearwater","Minnesota",47.57992111,-95.37790562,2,0,0,2,"Clearwater, Minnesota, US",8818,3,110,74,36,5,-38,-33,2982,8861,75198,342278,976
1029,"Cleburne","Alabama",33.67679204,-85.52005899,13,1,0,12,"Cleburne, Alabama, US",14910,-100,187,189,-2,-11,-86,-97,2763,5518,43761,186449,758
5023,"Cleburne","Arkansas",35.53864922,-92.02640019,73,4,0,69,"Cleburne, Arkansas, US",24919,-75,227,385,-158,-6,90,84,8723,23667,159149,684790,2975
39025,"Clermont","Ohio",39.04847534,-84.15375786,177,5,0,172,"Clermont, Ohio, US",206428,902,2283,1833,450,38,422,460,60171,265512,2482386,10354239,20935
5025,"Cleveland","Arkansas",33.89723187,-92.18537045,18,0,0,18,"Cleveland, Arkansas, US",7956,-39,75,88,-13,-1,-25,-26,1233,1905,16145,65160,303
37045,"Cleveland","North Carolina",35.33553364,-81.55204486,67,2,0,65,"Cleveland, North Carolina, US",97947,428,1102,1219,-117,44,504,548,35332,140130,1162502,4853681,10952
40027,"Cleveland","Oklahoma",35.20413532,-97.32519562,487,37,0,450,"Cleveland, Oklahoma, US",284014,2848,2735,2105,630,369,1852,2221,89075,390363,3115698,13248210,34604
13065,"Clinch","Georgia",30.91395822,-82.70432472,47,1,0,46,"Clinch, Georgia, US",6618,15,83,57,26,8,-18,-10,2302,3901,28437,109250,523
17027,"Clinton","Illinois",38.60704876,-89.42385254,176,16,0,160,"Clinton, Illinois, US",37562,-135,413,367,46,-2,-180,-182,12251,44767,320868,1424928,4747
18023,"Clinton","Indiana",40.30319754,-86.47277257,204,1,0,203,"Clinton, Indiana, US",32399,207,422,320,102,20,87,107,11908,40237,336501,1372121,3165
19045,"Clinton","Iowa",41.89981633,-90.53275096,61,1,0,60,"Clinton, Iowa, US",46429,-8,508,518,-10,12,-9,3,23152,79624,702302,2827188,6411
21053,"Clinton","Kentucky",36.72581156,-85.13377529,3,0,0,3,"Clinton, Kentucky, US",10218,66,121,109,12,-2,55,53,4158,8757,57078,237758,809
26037,"Clinton","Michigan",42.94400871,-84.60145248,137,10,0,127,"Clinton, Michigan, US",79595,376,780,594,186,47,149,196,20440,81852,698129,3032276,7324
29049,"Clinton","Missouri",39.6013098,-94.40465394,18,0,0,18,"Clinton, Missouri, US",20387,-48,219,238,-19,-2,-25,-27,4740,12070,89358,365371,1767
36019,"Clinton","New York",44.74530905,-73.67875352,95,4,0,91,"Clinton, New York, US",80485,-194,756,744,12,49,-253,-204,34201,115509,974179,4157300,10292
39027,"Clinton","Ohio",39.41485808,-83.80852286,43,0,0,43,"Clinton, Ohio, US",41968,-117,470,458,12,3,-129,-126,18329,60709,627328,2478129,3881
42035,"Clinton","Pennsylvania",41.23255967,-77.63785995,49,1,0,48,"Clinton, Pennsylvania, US",38632,-64,368,396,-28,8,-41,-33,15713,47925,420405,1698013,4020
20029,"Cloud","Kansas",39.48028352,-97.64925343,4,0,0,4,"Cloud, Kansas, US",8786,52,98,124,-26,5,74,79,4360,11731,79099,322099,1374
28027,"Coahoma","Mississippi",34.22772299,-90.60415045,96,3,0,93,"Coahoma, Mississippi, US",22124,-481,355,282,73,-7,-548,-555,8953,25709,202209,828017,2692
40029,"Coal","Oklahoma",34.58840127,-96.29798747,1,0,0,1,"Coal, Oklahoma, US",5495,-25,68,69,-1,0,-23,-23,1660,2379,23227,91278,302
13067,"Cobb","Georgia",33.94243204,-84.5761255,2661,141,0,2520,"Cobb, Georgia, US",760141,4071,9155,4719,4436,1754,-2114,-360,339971,1945777,28027348,107455009,122874
4003,"Cochise","Arizona",31.87934684,-109.7516088,58,1,0,57,"Cochise, Arizona, US",125922,-489,1348,1312,36,66,-595,-529,48158,138526,1212698,4953198,12578
48079,"Cochran","Texas",33.60425307,-102.8284499,1,0,0,1,"Cochran, Texas, US",2853,22,41,10,31,14,-23,-9,1003,590,3702,16124,135
47029,"Cocke","Tennessee",35.9278914,-83.11828725,20,0,0,20,"Cocke, Tennessee, US",36004,146,361,496,-135,-10,292,282,9672,24901,168445,731371,2453
4005,"Coconino","Arizona",35.83883429,-111.7707178,1000,72,0,928,"Coconino, Arizona, US",143476,953,1513,901,612,25,313,338,63547,272391,2171073,9347920,21900
46029,"Codington","South Dakota",44.97788119,-97.18827677,29,0,0,29,"Codington, South Dakota, US",28009,-24,316,235,81,4,-108,-104,16315,62564,509923,2123353,6085
1031,"Coffee","Alabama",31.39932826,-85.98901039,196,1,0,195,"Coffee, Alabama, US",52342,392,599,570,29,34,334,368,18383,63525,470632,1956579,5397
13069,"Coffee","Georgia",31.54892966,-82.8549206,227,13,0,214,"Coffee, Georgia, US",43273,218,592,411,181,-1,37,36,16278,57481,445730,1875740,4404
47031,"Coffee","Tennessee",35.49090731,-86.07311784,65,0,0,65,"Coffee, Tennessee, US",56520,643,700,658,42,-20,623,603,24511,89366,792571,3278672,6931
20031,"Coffey","Kansas",38.2365018,-95.73379515,50,8,0,42,"Coffey, Kansas, US",8179,-53,96,84,12,1,-67,-66,4701,8218,98127,344279,1056
48081,"Coke","Texas",31.88911733,-100.5297533,1,0,0,1,"Coke, Texas, US",3387,32,35,46,-11,-1,45,44,970,747,4321,18018,172
1033,"Colbert","Alabama",34.69847452,-87.80168544,125,2,0,123,"Colbert, Alabama, US",55241,237,630,719,-89,73,256,329,22500,99646,880699,3638304,6716
29051,"Cole","Missouri",38.50455671,-92.27860244,59,1,0,58,"Cole, Missouri, US",76745,25,863,684,179,57,-210,-153,49080,184315,1726034,7207467,12622
48083,"Coleman","Texas",31.76736834,-99.45240766,2,0,0,2,"Coleman, Texas, US",8175,-192,83,118,-35,3,-160,-157,2520,5430,34580,144116,897
17029,"Coles","Illinois",39.51949084,-88.22358557,98,7,0,91,"Coles, Illinois, US",50621,-208,452,500,-48,51,-210,-159,26497,88111,716554,2957244,6443
31037,"Colfax","Nebraska",41.57486951,-97.0868542,592,2,0,590,"Colfax, Nebraska, US",10709,-25,193,72,121,120,-267,-147,5185,9824,80476,350615,1279
35007,"Colfax","New Mexico",36.60569702,-104.6472674,5,0,0,5,"Colfax, New Mexico, US",11941,-130,110,124,-14,-3,-112,-115,4996,16414,100819,401221,2021
45029,"Colleton","South Carolina",32.87582989,-80.67641292,69,8,0,61,"Colleton, South Carolina, US",37677,1,449,570,-121,-21,148,127,11893,37826,264479,1124732,3951
12021,"Collier","Florida",26.11091986,-81.34687065,1195,45,0,1150,"Collier, Florida, US",384902,6701,3160,3867,-707,1906,5485,7391,146846,748986,7857231,31090869,71935
48085,"Collin","Texas",33.18820114,-96.57264368,1132,31,0,1101,"Collin, Texas, US",1034730,30423,11299,4956,6343,4100,19952,24052,389810,2469267,41437942,155696725,144137
48087,"Collingsworth","Texas",34.96489496,-100.2700111,4,0,0,4,"Collingsworth, Texas, US",2920,-22,29,34,-5,-2,-14,-16,1033,1221,8056,32132,186
51570,"Colonial Heights","Virginia",37.26420587,-77.39609676,83,8,0,75,"Colonial Heights, Virginia, US",17370,-134,281,210,71,7,-212,-205,9908,50048,308935,1256912,3642
48089,"Colorado","Texas",29.622098,-96.5273805,19,0,0,19,"Colorado, Texas, US",21493,188,257,247,10,62,116,178,8631,27325,243232,1018576,2799
13071,"Colquitt","Georgia",31.18810588,-83.7677946,289,14,0,275,"Colquitt, Georgia, US",45600,145,605,471,134,-18,29,11,16588,45819,347101,1437907,4735
5027,"Columbia","Arkansas",33.21230701,-93.22642793,20,2,0,18,"Columbia, Arkansas, US",23457,-129,262,279,-17,9,-120,-111,10045,30073,262109,1051911,2815
12023,"Columbia","Florida",30.22509788,-82.62160164,125,2,0,123,"Columbia, Florida, US",71686,1018,804,863,-59,4,1065,1069,25142,93726,875885,3567861,7556
13073,"Columbia","Georgia",33.54534185,-82.263524,223,6,0,217,"Columbia, Georgia, US",156714,2637,1770,1035,735,75,1833,1908,31281,166971,1420588,5694658,13895
36021,"Columbia","New York",42.24819348,-73.63089095,359,32,0,327,"Columbia, New York, US",59461,-324,489,676,-187,43,-178,-135,24704,82071,684603,2960855,10143
41009,"Columbia","Oregon",45.94464254,-123.0890898,16,0,0,16,"Columbia, Oregon, US",52354,109,499,503,-4,-8,122,114,10859,41320,322430,1328135,5106
42037,"Columbia","Pennsylvania",41.04821986,-76.40565017,342,29,0,313,"Columbia, Pennsylvania, US",64964,-251,515,730,-215,-4,-27,-31,27865,101434,804275,3412591,7971
53013,"Columbia","Washington",46.29442881,-117.9051983,1,0,0,1,"Columbia, Washington, US",3985,-54,38,44,-6,15,-64,-49,1562,2209,17802,83454,449
55021,"Columbia","Wisconsin",43.46492199,-89.33589004,37,1,0,36,"Columbia, Wisconsin, US",57532,199,602,519,83,8,107,115,21350,100845,831308,3555041,8019
39029,"Columbiana","Ohio",40.76932373,-80.78094576,477,50,0,427,"Columbiana, Ohio, US",101883,-590,982,1186,-204,-1,-382,-383,32795,136854,1056348,4455328,11311
37047,"Columbus","North Carolina",34.26744084,-78.65801424,289,21,0,268,"Columbus, North Carolina, US",55508,-311,558,761,-203,18,-124,-106,17827,55330,411077,1777906,5457
6011,"Colusa","California",39.17881957,-122.2331726,5,0,0,5,"Colusa, California, US",21547,129,282,129,153,-33,10,-23,8964,17489,166901,772210,1852
48091,"Comal","Texas",29.80811278,-98.27647225,78,6,0,72,"Comal, Texas, US",156209,8068,1589,1242,347,85,7600,7685,51288,259053,2462115,10268107,21438
20033,"Comanche","Kansas",37.1911452,-99.27113247,1,0,0,1,"Comanche, Kansas, US",1700,-36,20,15,5,-1,-40,-41,970,1109,7052,29815,232
40031,"Comanche","Oklahoma",34.65973764,-98.47195055,270,3,0,267,"Comanche, Oklahoma, US",120749,221,1630,1095,535,56,-369,-313,60654,166041,1398241,5592053,12363
48093,"Comanche","Texas",31.94854689,-98.55876441,5,1,0,4,"Comanche, Texas, US",13635,95,139,182,-43,7,131,138,3897,10071,80385,311319,1099
48095,"Concho","Texas",31.32635934,-99.86473038,1,0,0,1,"Concho, Texas, US",2726,43,24,29,-5,26,22,48,1142,1260,9171,29366,124
22029,"Concordia","Louisiana",31.44817835,-91.63814433,69,5,0,64,"Concordia, Louisiana, US",19259,-327,254,239,15,-8,-335,-343,6292,14761,121705,488977,1782
1035,"Conecuh","Alabama",31.43401703,-86.99320044,25,1,0,24,"Conecuh, Alabama, US",12067,-225,123,182,-59,1,-167,-166,3296,9158,65217,270244,843
8021,"Conejos","Colorado",37.201606,-106.1917488,1,0,0,1,"Conejos, Colorado, US",8205,24,86,73,13,3,10,13,1958,2398,16981,74137,441
6013,"Contra Costa","California",37.91923498,-121.9289527,1296,36,0,1260,"Contra Costa, California, US",1153526,3007,12070,8478,3592,2916,-3497,-581,372702,1953477,33318893,129551268,143107
56009,"Converse","Wyoming",42.97272268,-105.5081848,24,0,0,24,"Converse, Wyoming, US",13822,164,154,111,43,5,118,123,7166,17700,218819,910110,2143
5029,"Conway","Arkansas",35.26205537,-92.70506566,14,1,0,13,"Conway, Arkansas, US",20846,21,227,213,14,-5,14,9,7552,17881,144989,625359,1899
13075,"Cook","Georgia",31.16068491,-83.42947229,44,2,0,42,"Cook, Georgia, US",17270,99,205,203,2,0,97,97,4873,13056,81849,350124,1483
17031,"Cook","Illinois",41.84144849,-87.81658794,70417,3246,0,67171,"Cook, Illinois, US",5150233,-21727,61822,42432,19390,11637,-52810,-41173,2584653,14368570,243292180,895529987,801549
48097,"Cooke","Texas",33.63979567,-97.21240912,13,0,0,13,"Cooke, Texas, US",41257,753,530,417,113,23,616,639,16423,61539,590408,2501583,4886
29053,"Cooper","Missouri",38.844478,-92.80896081,9,0,0,9,"Cooper, Missouri, US",17709,83,202,184,18,12,56,68,6087,15064,96212,419334,1994
33007,"Coos","New Hampshire",44.69063265,-71.30633239,4,0,0,4,"Coos, New Hampshire, US",31563,77,225,419,-194,-2,274,272,13485,47396,392758,1608253,4535
41011,"Coos","Oregon",43.17406868,-124.0594514,31,0,0,31,"Coos, Oregon, US",64487,215,599,937,-338,-15,568,553,23136,96760,837118,3595767,8858
1037,"Coosa","Alabama",32.93690146,-86.24847739,33,1,0,32,"Coosa, Alabama, US",10663,20,89,122,-33,13,42,55,1419,2255,20463,80481,395
28029,"Copiah","Mississippi",31.86977774,-90.44565118,273,4,0,269,"Copiah, Mississippi, US",28065,-335,339,309,30,11,-374,-363,7404,20799,146297,601758,2235
46031,"Corson","South Dakota",45.70889983,-101.1970473,4,0,0,4,"Corson, South Dakota, US",4086,-92,91,58,33,1,-126,-125,1135,395,2688,11894,101
36023,"Cortland","New York",42.59509207,-76.07048931,38,0,0,38,"Cortland, New York, US",47581,-141,472,422,50,19,-210,-191,22175,68337,516861,2176197,5600
48099,"Coryell","Texas",31.39078397,-97.79936155,226,2,0,224,"Coryell, Texas, US",75951,1210,895,468,427,9,769,778,20367,41245,276856,1141672,3990
39031,"Coshocton","Ohio",40.30096166,-81.91729018,24,0,0,24,"Coshocton, Ohio, US",36600,4,460,408,52,4,-50,-46,13054,37563,295562,1153834,3271
8023,"Costilla","Colorado",37.27732493,-105.4276548,3,0,0,3,"Costilla, Colorado, US",3887,75,37,34,3,10,63,73,999,896,3889,18557,158
48101,"Cottle","Texas",34.07783319,-100.2785062,4,1,0,3,"Cottle, Texas, US",1398,16,13,12,1,0,16,16,568,258,1341,5373,54
40033,"Cotton","Oklahoma",34.28845626,-98.37053567,5,2,0,3,"Cotton, Oklahoma, US",5666,-154,63,75,-12,0,-141,-141,1844,2099,14530,63203,250
27033,"Cottonwood","Minnesota",44.00715262,-95.18138802,62,0,0,62,"Cottonwood, Minnesota, US",11196,-63,144,134,10,-4,-69,-73,5624,16239,125953,522722,1612
1039,"Covington","Alabama",31.2477854,-86.45050893,63,1,0,62,"Covington, Alabama, US",37049,96,413,543,-130,-5,235,230,12903,43132,326667,1341425,4336
28031,"Covington","Mississippi",31.63225413,-89.55389939,127,1,0,126,"Covington, Mississippi, US",18636,-189,237,232,5,5,-201,-196,5158,15271,118750,498821,1611
51580,"Covington","Virginia",37.7824656,-79.98631446,3,0,0,3,"Covington, Virginia, US",5538,-40,67,73,-6,6,-39,-33,2027,8968,83285,333644,890
13077,"Coweta","Georgia",33.35334302,-84.76129976,316,8,0,308,"Coweta, Georgia, US",148509,2511,1680,1096,584,110,1811,1921,39158,167266,1406480,5792625,14307
20035,"Cowley","Kansas",37.23781842,-96.83776647,4,1,0,3,"Cowley, Kansas, US",34908,-241,393,413,-20,19,-240,-221,14165,47259,396976,1622857,3965
53015,"Cowlitz","Washington",46.19074721,-122.6782231,71,0,0,71,"Cowlitz, Washington, US",110593,1841,1287,1134,153,22,1664,1686,38281,166865,1830937,7392380,12647
40035,"Craig","Oklahoma",36.76268118,-95.20916602,15,0,0,15,"Craig, Oklahoma, US",14142,-158,128,205,-77,0,-81,-81,6055,15418,137387,565832,1667
51045,"Craig","Virginia",37.48133648,-80.21072274,5,0,0,5,"Craig, Virginia, US",5131,29,39,62,-23,-1,52,51,558,1495,6897,26452,168
5031,"Craighead","Arkansas",35.83018283,-90.63235729,181,0,0,181,"Craighead, Arkansas, US",110332,1516,1456,1030,426,47,1044,1091,49190,213350,1915866,7827230,14603
48103,"Crane","Texas",31.43052248,-102.5143314,3,0,0,3,"Crane, Texas, US",4797,42,59,23,36,7,0,7,1969,3275,55571,202818,331
37049,"Craven","North Carolina",35.11833364,-77.08398081,177,4,0,173,"Craven, North Carolina, US",102139,-199,1340,1035,305,20,-514,-494,48681,137388,1132281,4828739,12424
5033,"Crawford","Arkansas",35.58928601,-94.2446814,13,0,0,13,"Crawford, Arkansas, US",63257,-122,758,658,100,5,-227,-222,18071,79831,646279,2649132,5827
13079,"Crawford","Georgia",32.71391813,-83.98061238,25,0,0,25,"Crawford, Georgia, US",12404,70,91,133,-42,7,106,113,1736,2030,15649,63291,399
17033,"Crawford","Illinois",39.0032229,-87.75954624,11,0,0,11,"Crawford, Illinois, US",18667,-163,196,217,-21,-2,-140,-142,8287,19528,207734,813217,2083
18025,"Crawford","Indiana",38.28814402,-86.44518825,23,0,0,23,"Crawford, Indiana, US",10577,-17,117,121,-4,0,-12,-12,2276,3366,21394,89650,622
19047,"Crawford","Iowa",42.03718237,-95.3819718,460,2,0,458,"Crawford, Iowa, US",16820,-269,228,151,77,38,-386,-348,7794,21951,189378,786903,2224
20037,"Crawford","Kansas",37.50675523,-94.85245778,8,1,0,7,"Crawford, Kansas, US",38818,-93,448,361,87,85,-268,-183,18799,66400,509366,2024749,4992
26039,"Crawford","Michigan",44.68255561,-84.61006219,58,5,0,53,"Crawford, Michigan, US",14029,124,132,169,-37,6,156,162,4522,11900,92964,406799,1350
29055,"Crawford","Missouri",37.97663738,-91.30528104,9,0,0,9,"Crawford, Missouri, US",23920,-48,250,296,-46,-4,3,-1,6544,23542,200704,777932,2447
39033,"Crawford","Ohio",40.85065156,-82.91989099,104,3,0,101,"Crawford, Ohio, US",41494,10,455,498,-43,13,41,54,14400,53529,426134,1703079,4312
42039,"Crawford","Pennsylvania",41.68447709,-80.10760592,21,0,0,21,"Crawford, Pennsylvania, US",84629,-481,908,961,-53,22,-447,-425,33930,133152,1114154,4545148,11328
55023,"Crawford","Wisconsin",43.23870316,-90.93073686,25,0,0,25,"Crawford, Wisconsin, US",16131,-134,151,181,-30,3,-107,-104,7563,20595,150719,627576,1818
40037,"Creek","Oklahoma",35.90230551,-96.37086028,89,7,0,82,"Creek, Oklahoma, US",71522,-208,791,872,-81,49,-170,-121,20332,77386,733035,3059736,7437
1041,"Crenshaw","Alabama",31.72941803,-86.31593104,58,2,0,56,"Crenshaw, Alabama, US",13772,-53,137,179,-42,3,-14,-11,3936,10140,77496,334865,981
13081,"Crisp","Georgia",31.92289565,-83.76811843,211,7,0,204,"Crisp, Georgia, US",22372,-245,256,289,-33,11,-224,-213,9030,29017,218593,910845,2496
5035,"Crittenden","Arkansas",35.21247318,-90.30839406,280,9,0,271,"Crittenden, Arkansas, US",47955,-408,722,534,188,-7,-591,-598,15771,63092,483579,2008317,4503
21055,"Crittenden","Kentucky",37.35839237,-88.0882609,5,1,0,4,"Crittenden, Kentucky, US",8806,-90,88,108,-20,-2,-68,-70,2577,5901,35246,139375,661
47033,"Crockett","Tennessee",35.81830662,-89.14916269,14,1,0,13,"Crockett, Tennessee, US",14230,-66,148,180,-32,6,-40,-34,4221,7119,57129,230730,1056
41013,"Crook","Oregon",44.14230227,-120.356297,4,0,0,4,"Crook, Oregon, US",24404,579,259,266,-7,-11,596,585,6711,18729,170824,699310,2781
56011,"Crook","Wyoming",44.58855102,-104.5697705,5,0,0,5,"Crook, Wyoming, US",7584,139,103,70,33,20,87,107,2803,5999,55727,253048,1179
48107,"Crosby","Texas",33.61431553,-101.3000364,3,1,0,2,"Crosby, Texas, US",5737,-27,61,62,-1,1,-27,-26,1721,1543,16233,57119,354
5037,"Cross","Arkansas",35.29631396,-90.77185818,42,0,0,42,"Cross, Arkansas, US",16419,-211,194,207,-13,2,-202,-200,6065,16121,113238,473218,1737
27035,"Crow Wing","Minnesota",46.48096553,-94.06755609,42,1,0,41,"Crow Wing, Minnesota, US",65055,261,648,687,-39,6,294,300,30645,137750,1147087,5076411,12676
8025,"Crowley","Colorado",38.32608609,-103.7844965,57,1,0,56,"Crowley, Colorado, US",6061,104,30,35,-5,0,109,109,1533,831,6430,27612,81
1043,"Cullman","Alabama",34.13020303,-86.86888037,74,0,0,74,"Cullman, Alabama, US",83768,350,990,1050,-60,34,380,414,27551,122437,1042322,4276691,9888
51047,"Culpeper","Virginia",38.48199985,-77.9563087,574,5,0,569,"Culpeper, Virginia, US",52605,810,659,467,192,48,570,618,16340,57405,519828,2106082,5559
17035,"Cumberland","Illinois",39.27432424,-88.2401158,10,0,0,10,"Cumberland, Illinois, US",10766,-38,119,109,10,0,-48,-48,2475,6412,37623,163920,814
21057,"Cumberland","Kentucky",36.78926125,-85.39050034,5,0,0,5,"Cumberland, Kentucky, US",6614,-79,67,104,-37,0,-41,-41,2046,3044,19209,83422,365
23005,"Cumberland","Maine",43.8370751,-70.37226999,1009,40,0,969,"Cumberland, Maine, US",295003,1330,2716,2708,8,456,872,1328,177601,989144,12300029,49450629,68809
34011,"Cumberland","New Jersey",39.37199394,-75.10712559,1924,62,0,1862,"Cumberland, New Jersey, US",149527,-1108,1757,1435,322,74,-1509,-1435,61733,248255,2247216,9547657,16217
37051,"Cumberland","North Carolina",35.04762133,-78.82623165,569,16,0,553,"Cumberland, North Carolina, US",335509,2079,5376,2644,2732,330,-978,-648,170689,520024,4293717,17619943,33607
42041,"Cumberland","Pennsylvania",40.1625372,-77.26130755,584,46,0,538,"Cumberland, Pennsylvania, US",253370,2239,2585,2323,262,354,1634,1988,128975,702095,7900068,31499743,36242
47035,"Cumberland","Tennessee",35.95271721,-84.99840585,107,1,0,106,"Cumberland, Tennessee, US",60520,782,512,843,-331,20,1087,1107,20030,66714,495312,2136953,5761
51049,"Cumberland","Virginia",37.51328851,-78.24398086,26,0,0,26,"Cumberland, Virginia, US",9932,75,72,107,-35,0,110,110,1463,2986,20721,88910,625
31039,"Cuming","Nebraska",41.91637624,-96.78730772,32,0,0,32,"Cuming, Nebraska, US",8846,-89,105,83,22,-2,-108,-110,4312,11528,92562,408257,1835
37053,"Currituck","North Carolina",36.36123664,-75.95876401,11,0,0,11,"Currituck, North Carolina, US",27763,747,268,243,25,-13,733,720,6496,21112,146696,731093,3516
35009,"Curry","New Mexico",34.57421077,-103.3468876,45,0,0,45,"Curry, New Mexico, US",48954,-384,824,378,446,-8,-821,-829,23644,64419,487045,1927391,5697
41015,"Curry","Oregon",42.45911325,-124.157282,6,0,0,6,"Curry, Oregon, US",22925,130,166,345,-179,-24,332,308,7641,25077,172254,750034,3851
8027,"Custer","Colorado",38.10883162,-105.3683478,2,0,0,2,"Custer, Colorado, US",5068,134,33,40,-7,-1,141,140,1140,2041,13714,61792,593
16037,"Custer","Idaho",44.24186819,-114.2855494,2,0,0,2,"Custer, Idaho, US",4315,65,33,38,-5,0,69,69,1523,3304,15146,86251,763
31041,"Custer","Nebraska",41.39374521,-99.72805369,30,4,0,26,"Custer, Nebraska, US",10777,-53,125,128,-3,-2,-48,-50,5476,12394,87296,373107,1922
40039,"Custer","Oklahoma",35.63853802,-99.00170785,12,0,0,12,"Custer, Oklahoma, US",29003,8,398,277,121,55,-168,-113,14370,47906,446923,1954886,5020
39035,"Cuyahoga","Ohio",41.424119,-81.65918339,3851,207,0,3644,"Cuyahoga, Ohio, US",1235072,-6646,14022,13527,495,1220,-8342,-7122,700052,3899081,53166041,210202807,195687
13083,"Dade","Georgia",34.8549167,-85.50490424,27,1,0,26,"Dade, Georgia, US",16116,-111,151,183,-32,-7,-73,-80,4765,10061,65042,268989,946
27037,"Dakota","Minnesota",44.67172617,-93.06299363,999,33,0,966,"Dakota, Minnesota, US",429021,3981,5108,2688,2420,427,1160,1587,180320,1027031,12416568,49311690,63696
31043,"Dakota","Nebraska",42.39040144,-96.56656425,1575,15,0,1560,"Dakota, Nebraska, US",20026,24,361,129,232,0,-208,-208,11817,45890,442353,1807298,2247
1045,"Dale","Alabama",31.43037123,-85.61095742,80,0,0,80,"Dale, Alabama, US",49172,29,648,546,102,18,-89,-71,22581,38724,371715,1487530,3963
48111,"Dallam","Texas",36.27787176,-102.6020725,22,1,0,21,"Dallam, Texas, US",7287,-16,151,25,126,53,-194,-141,3907,7012,59634,254659,980
1047,"Dallas","Alabama",32.32688101,-87.1086671,191,3,0,188,"Dallas, Alabama, US",37196,-1098,438,542,-104,5,-1002,-997,13012,40988,338592,1313754,3825
5039,"Dallas","Arkansas",33.97042763,-92.65167437,1,0,0,1,"Dallas, Arkansas, US",7009,-143,73,79,-6,-2,-133,-135,3278,7518,55441,245319,835
19049,"Dallas","Iowa",41.68560356,-94.04127625,836,14,0,822,"Dallas, Iowa, US",93453,3500,1299,507,792,115,2577,2692,29971,186965,2473374,9182746,11773
29059,"Dallas","Missouri",37.6811355,-93.02127031,3,0,0,3,"Dallas, Missouri, US",16878,96,213,207,6,-1,94,93,2654,8370,37787,153353,1298
48113,"Dallas","Texas",32.76670599,-96.7779605,8649,210,0,8439,"Dallas, Texas, US",2635516,6166,38374,17047,21327,9242,-24389,-15147,1492757,8874187,141370286,535971529,399234
55025,"Dane","Wisconsin",43.06601594,-89.41733797,594,26,0,568,"Dane, Wisconsin, US",546695,4747,5772,3375,2397,962,1388,2350,318678,1683427,22781678,90743126,85362
51590,"Danville","Virginia",36.58022376,-79.40395668,46,2,0,44,"Danville, Virginia, US",40044,-605,443,658,-215,21,-410,-389,25177,110565,852262,3444577,7173
37055,"Dare","North Carolina",35.66520691,-75.71767334,22,3,0,19,"Dare, North Carolina, US",37009,402,332,360,-28,40,390,430,20355,80574,547416,2798840,11075
39037,"Darke","Ohio",40.13412966,-84.6194517,147,16,0,131,"Darke, Ohio, US",51113,-186,618,604,14,10,-209,-199,18739,72229,673260,2665855,6263
45031,"Darlington","South Carolina",34.33358335,-79.96027485,244,6,0,238,"Darlington, South Carolina, US",66618,-141,737,840,-103,21,-55,-34,21564,78228,766808,3022051,5882
42043,"Dauphin","Pennsylvania",40.41377078,-76.77993242,1061,62,0,999,"Dauphin, Pennsylvania, US",278299,1435,3352,2577,775,725,-52,673,180406,778076,9827191,38463689,40746
37057,"Davidson","North Carolina",35.79115496,-80.21256572,345,11,0,334,"Davidson, North Carolina, US",167609,1251,1764,1815,-51,-18,1322,1304,45022,200108,1762115,7360627,16126
47037,"Davidson","Tennessee",36.17007426,-86.78646056,4465,54,0,4411,"Davidson, Tennessee, US",694144,3628,9985,5565,4420,3453,-4201,-748,435676,2628555,35857833,144675720,118780
37059,"Davie","North Carolina",35.93099927,-80.54496571,67,2,0,65,"Davie, North Carolina, US",42846,283,385,406,-21,3,303,306,10707,39122,301119,1239730,4414
18027,"Daviess","Indiana",38.70186039,-87.07185406,81,16,0,65,"Daviess, Indiana, US",33351,73,539,327,212,21,-163,-142,12488,48334,374828,1595438,5044
21059,"Daviess","Kentucky",37.73028906,-87.0901948,305,6,0,299,"Daviess, Kentucky, US",101511,628,1302,1044,258,42,332,374,45057,210895,1861807,7492708,13334
29061,"Daviess","Missouri",39.96145298,-93.98519678,4,0,0,4,"Daviess, Missouri, US",8278,-56,117,80,37,0,-92,-92,2066,3498,21015,95467,620
19051,"Davis","Iowa",40.74773536,-92.41005468,18,0,0,18,"Davis, Iowa, US",9000,28,150,84,66,0,-38,-38,3016,5097,41496,165834,740
49011,"Davis","Utah",40.99001837,-112.1139997,407,2,0,405,"Davis, Utah, US",355481,4380,5406,1724,3682,178,532,710,114070,500989,4657504,19805215,43477
46035,"Davison","South Dakota",43.67490933,-98.14458906,9,0,0,9,"Davison, South Dakota, US",19775,-9,244,199,45,-4,-49,-53,11449,44195,349662,1457080,3795
31045,"Dawes","Nebraska",42.71985036,-103.1313774,1,0,0,1,"Dawes, Nebraska, US",8589,-116,77,81,-4,6,-118,-112,4593,8542,52485,224959,1218
13085,"Dawson","Georgia",34.44244079,-84.16964071,101,1,0,100,"Dawson, Georgia, US",26108,981,271,239,32,6,937,943,7897,38633,219317,929219,3579
31047,"Dawson","Nebraska",40.87028216,-99.8201461,816,7,0,809,"Dawson, Nebraska, US",23595,-149,404,196,208,116,-474,-358,11904,37528,299837,1276218,3735
48115,"Dawson","Texas",32.74255572,-101.9477242,39,1,0,38,"Dawson, Texas, US",12728,123,181,127,54,10,60,70,4727,11732,107810,438339,1329
46037,"Day","South Dakota",45.367281,-97.60737498,12,0,0,12,"Day, South Dakota, US",5424,-83,67,84,-17,1,-66,-65,2418,5396,36099,155289,779
35011,"De Baca","New Mexico",34.34274529,-104.4117842,0,0,0,0,"De Baca, New Mexico, US",1748,-31,13,16,-3,1,-28,-27,549,530,2793,11901,120
22031,"De Soto","Louisiana",32.05457447,-93.74130302,236,16,0,220,"De Soto, Louisiana, US",27463,37,318,292,26,-3,14,11,8649,19343,238774,883979,2156
17039,"De Witt","Illinois",40.17514519,-88.90959682,4,0,0,4,"De Witt, Illinois, US",15638,-156,162,205,-43,0,-112,-112,6486,17947,184513,753651,1855
1049,"DeKalb","Alabama",34.45946862,-85.80782906,214,3,0,211,"DeKalb, Alabama, US",71513,106,795,819,-24,44,90,134,23930,81364,645997,2940802,6065
13089,"DeKalb","Georgia",33.76944049,-84.22396017,3146,102,0,3044,"DeKalb, Georgia, US",759297,4391,10825,5028,5797,3831,-5190,-1359,303932,1509330,20273310,77750148,101694
17037,"DeKalb","Illinois",41.89373302,-88.76958483,309,3,0,306,"DeKalb, Illinois, US",104897,548,1107,729,378,198,-26,172,41270,132619,1151015,4920686,11180
18033,"DeKalb","Indiana",41.39804622,-84.99906934,28,1,0,27,"DeKalb, Indiana, US",43475,267,508,406,102,-9,176,167,20696,102354,1047353,4335450,5185
29063,"DeKalb","Missouri",39.89201062,-94.40476508,5,0,0,5,"DeKalb, Missouri, US",12547,32,98,114,-16,-5,54,49,4009,7925,60619,251965,980
47041,"DeKalb","Tennessee",35.97616272,-85.83689361,33,0,0,33,"DeKalb, Tennessee, US",20490,357,219,226,-7,54,310,364,6191,13752,114275,468729,1400
12027,"DeSoto","Florida",27.18677893,-81.80941373,112,8,0,104,"DeSoto, Florida, US",38001,633,389,362,27,154,450,604,12272,22166,162542,656984,2427
28033,"DeSoto","Mississippi",34.87625235,-89.99091418,458,6,0,452,"DeSoto, Mississippi, US",184945,3013,2121,1427,694,66,2257,2323,53721,283355,2152776,9114022,16843
48123,"DeWitt","Texas",29.08101855,-97.3568117,17,1,0,16,"DeWitt, Texas, US",20160,54,229,232,-3,-2,59,57,8667,21542,216571,904628,2280
48117,"Deaf Smith","Texas",34.96522957,-102.6054267,141,7,0,134,"Deaf Smith, Texas, US",18546,-165,320,159,161,-2,-325,-327,8515,21723,222758,869801,1968
18029,"Dearborn","Indiana",39.14647946,-84.97333539,162,21,0,141,"Dearborn, Indiana, US",49458,-24,457,457,0,-15,-6,-21,15428,56947,473197,1915342,5111
13087,"Decatur","Georgia",30.87967778,-84.57619536,145,4,0,141,"Decatur, Georgia, US",26404,-169,361,331,30,-4,-194,-198,9154,27314,216372,877886,2993
18031,"Decatur","Indiana",39.30712658,-85.50087166,221,31,0,190,"Decatur, Indiana, US",26559,-166,320,273,47,17,-232,-215,14658,47637,435630,1710159,3196
19053,"Decatur","Iowa",40.73742757,-93.78645949,1,0,0,1,"Decatur, Iowa, US",7870,-20,98,79,19,3,-42,-39,3084,3959,24175,107850,510
47039,"Decatur","Tennessee",35.60048904,-88.11043779,5,0,0,5,"Decatur, Tennessee, US",11663,-36,108,159,-51,7,7,14,3293,9567,76728,319101,989
30023,"Deer Lodge","Montana",46.05953325,-113.073353,3,0,0,3,"Deer Lodge, Montana, US",9140,11,69,120,-51,-3,65,62,3680,9433,78074,350863,1150
39039,"Defiance","Ohio",41.32398837,-84.49076944,32,2,0,30,"Defiance, Ohio, US",38087,-2,427,390,37,9,-46,-37,16536,58015,562619,2178053,4287
6015,"Del Norte","California",41.74228275,-123.8974063,23,0,0,23,"Del Norte, California, US",27812,72,261,255,6,15,53,68,8634,17027,130796,546282,2092
18035,"Delaware","Indiana",40.22787247,-85.39732772,340,27,0,313,"Delaware, Indiana, US",114135,-162,1081,1187,-106,180,-233,-53,52592,218778,1813050,7520149,14125
19055,"Delaware","Iowa",42.47104597,-91.3664492,14,0,0,14,"Delaware, Iowa, US",17011,-70,196,174,22,5,-98,-93,7423,22045,193093,845231,2487
36025,"Delaware","New York",42.19837623,-74.96709306,74,4,0,70,"Delaware, New York, US",44135,-391,345,571,-226,19,-182,-163,19200,45783,398355,1649160,5860
39041,"Delaware","Ohio",40.27942393,-83.00457058,292,11,0,281,"Delaware, Ohio, US",209177,4086,2099,1237,862,212,3013,3225,75734,402580,4858809,18623432,27039
40041,"Delaware","Oklahoma",36.40823634,-94.80325046,99,16,0,83,"Delaware, Oklahoma, US",43009,195,425,608,-183,8,370,378,11711,35726,240249,1046700,4029
42045,"Delaware","Pennsylvania",39.91680171,-75.40243663,6114,513,0,5601,"Delaware, Pennsylvania, US",566747,1516,6516,5504,1012,1252,-731,521,214001,1208709,16687988,63873845,77043
8029,"Delta","Colorado",38.86246243,-107.8631342,65,1,0,64,"Delta, Colorado, US",31162,278,283,394,-111,2,385,387,9848,29885,208231,881065,4400
26041,"Delta","Michigan",45.9048491,-86.9080745,17,2,0,15,"Delta, Michigan, US",35784,-59,342,434,-92,-3,39,36,14689,53350,410229,1733139,5551
48119,"Delta","Texas",33.38570922,-95.66921122,1,0,0,1,"Delta, Texas, US",5331,-1,65,61,4,0,-5,-5,855,1562,5898,21267,156
48121,"Denton","Texas",33.20521901,-97.11691153,1205,28,0,1177,"Denton, Texas, US",887207,28466,9893,4243,5650,1663,21053,22716,245571,1274960,13967331,56283573,90119
8031,"Denver","Colorado",39.76018276,-104.8725695,5151,299,0,4852,"Denver, Colorado, US",727211,10946,9372,4995,4377,2242,4268,6510,491015,2633098,44025166,166659859,153677
19057,"Des Moines","Iowa",40.92012606,-91.18326592,56,1,0,55,"Des Moines, Iowa, US",38967,-182,437,434,3,-12,-173,-185,21831,86967,763496,3128718,6109
41017,"Deschutes","Oregon",43.91570171,-121.2289121,117,0,0,117,"Deschutes, Oregon, US",197692,5787,1857,1548,309,-52,5498,5446,72860,377547,3457161,15292793,43343
5041,"Desha","Arkansas",33.83011025,-91.25500948,19,0,0,19,"Desha, Arkansas, US",11361,-146,135,172,-37,-1,-108,-109,4933,12063,94400,383369,1478
46039,"Deuel","South Dakota",44.75994309,-96.66943645,1,0,0,1,"Deuel, South Dakota, US",4351,-1,56,44,12,2,-15,-13,2017,2746,24279,118205,550
40043,"Dewey","Oklahoma",35.98772922,-99.00730714,3,0,0,3,"Dewey, Oklahoma, US",4891,-40,59,65,-6,8,-41,-33,1876,4355,49032,208447,644
46041,"Dewey","South Dakota",45.15639647,-100.8709139,0,0,0,0,"Dewey, South Dakota, US",5892,-33,137,71,66,-1,-99,-100,2146,1386,10007,45818,266
48125,"Dickens","Texas",33.61616822,-100.7788855,1,0,0,1,"Dickens, Texas, US",2211,-7,16,20,-4,0,-4,-4,847,532,3075,12949,116
51051,"Dickenson","Virginia",37.12560977,-82.35124171,0,0,0,0,"Dickenson, Virginia, US",14318,-208,123,205,-82,0,-126,-126,3796,8094,57316,240090,970
19059,"Dickinson","Iowa",43.37787725,-95.1510206,8,0,0,8,"Dickinson, Iowa, US",17258,137,147,178,-31,5,163,168,9162,31208,244025,1133413,4251
20041,"Dickinson","Kansas",38.86600962,-97.15532383,4,0,0,4,"Dickinson, Kansas, US",18466,-216,198,199,-1,2,-217,-215,7430,19288,131251,573344,2217
26043,"Dickinson","Michigan",46.00999672,-87.86961634,5,2,0,3,"Dickinson, Michigan, US",25239,-132,238,305,-67,0,-64,-64,12886,50979,522181,2327864,4436
47043,"Dickson","Tennessee",36.14669837,-87.35891709,101,0,0,101,"Dickson, Tennessee, US",53948,502,630,526,104,-10,407,397,16719,63653,471648,2016731,5361
45033,"Dillon","South Carolina",34.39007791,-79.37741872,147,3,0,144,"Dillon, South Carolina, US",30479,-133,413,372,41,42,-215,-173,9712,25462,165029,712566,2449
48127,"Dimmit","Texas",28.42270064,-99.75645095,1,0,0,1,"Dimmit, Texas, US",10124,-71,124,85,39,-2,-108,-110,8809,17880,203388,928956,1098
51053,"Dinwiddie","Virginia",37.07544585,-77.63451754,48,0,0,48,"Dinwiddie, Virginia, US",28544,-89,192,277,-85,4,-7,-3,7314,16527,147295,609675,1734
11001,"District of Columbia","District of Columbia",38.90417773,-77.01655992,7966,427,0,7539,"District of Columbia, District of Columbia, US",705749,4202,9493,5677,3816,2604,-2203,401,817204,3141606,62364916,244187147,141071
38023,"Divide","North Dakota",48.8149387,-103.4873611,1,0,0,1,"Divide, North Dakota, US",2264,0,23,22,1,8,-10,-2,1490,1274,10458,46886,356
12029,"Dixie","Florida",29.60631086,-83.15724673,38,1,0,37,"Dixie, Florida, US",16826,141,141,228,-87,-3,232,229,3947,5733,41821,165106,844
31051,"Dixon","Nebraska",42.49188363,-96.86782408,24,0,0,24,"Dixon, Nebraska, US",5636,-64,76,55,21,8,-93,-85,1779,2418,19348,86263,428
13091,"Dodge","Georgia",32.17265114,-83.16948926,48,2,0,46,"Dodge, Georgia, US",20605,-188,215,240,-25,5,-166,-161,5829,14123,84958,344083,1494
27039,"Dodge","Minnesota",44.02238415,-92.86244324,43,0,0,43,"Dodge, Minnesota, US",20934,167,242,146,96,6,66,72,6482,16167,150223,692519,2034
31053,"Dodge","Nebraska",41.58071748,-96.65598179,351,1,0,350,"Dodge, Nebraska, US",36565,-160,454,400,54,61,-275,-214,17329,72680,594331,2502140,5496
55027,"Dodge","Wisconsin",43.41576662,-88.70928178,149,1,0,148,"Dodge, Wisconsin, US",87839,6,771,874,-103,22,90,112,35978,143735,1400435,5999810,9919
35013,"Dona Ana","New Mexico",32.35275771,-106.8329387,370,2,0,368,"Dona Ana, New Mexico, US",218195,917,2630,1615,1015,128,-224,-96,82181,287499,2196143,9145342,21715
20043,"Doniphan","Kansas",39.79067154,-95.14056866,12,0,0,12,"Doniphan, Kansas, US",7600,-58,69,71,-2,1,-57,-56,2823,4687,40824,177672,691
48129,"Donley","Texas",34.96517499,-100.8140093,26,0,0,26,"Donley, Texas, US",3278,-37,33,39,-6,2,-34,-32,1187,1403,7166,31993,255
13093,"Dooly","Georgia",32.15630737,-83.79746561,165,12,0,153,"Dooly, Georgia, US",13390,-319,88,118,-30,-2,-287,-289,4004,6266,40840,180353,678
55029,"Door","Wisconsin",44.95856458,-87.30002707,37,3,0,34,"Door, Wisconsin, US",27668,79,214,363,-149,0,231,231,12346,49481,365941,1786834,7079
24019,"Dorchester","Maryland",38.45413522,-76.02752426,126,2,0,124,"Dorchester, Maryland, US",31929,-31,340,395,-55,8,19,27,13082,39607,324628,1389311,3525
45035,"Dorchester","South Carolina",33.0794369,-80.40502652,137,3,0,134,"Dorchester, South Carolina, US",162809,2091,1813,1250,563,80,1448,1528,38552,154525,1245481,5301198,13556
13095,"Dougherty","Georgia",31.53328528,-84.21722377,1725,139,0,1586,"Dougherty, Georgia, US",87956,-1244,1255,951,304,48,-1601,-1553,46843,189341,1674168,6831646,12914
8035,"Douglas","Colorado",39.33133796,-104.930001,675,44,0,631,"Douglas, Colorado, US",351154,8165,3472,1493,1979,562,5604,6166,115915,613270,8026014,33704376,55147
13097,"Douglas","Georgia",33.70291126,-84.77026156,487,22,0,465,"Douglas, Georgia, US",146343,1319,1720,1047,673,38,615,653,43879,200696,1655151,6996130,14845
17041,"Douglas","Illinois",39.76768052,-88.21854195,27,0,0,27,"Douglas, Illinois, US",19465,7,246,175,71,-3,-61,-64,8139,28456,220298,946472,3137
20045,"Douglas","Kansas",38.88503636,-95.2925121,63,0,0,63,"Douglas, Kansas, US",122259,1150,1107,687,420,387,342,729,53712,206946,1434948,6011204,15727
27041,"Douglas","Minnesota",45.93348491,-95.45335469,27,0,0,27,"Douglas, Minnesota, US",38141,181,424,430,-6,2,187,189,20219,90100,796126,3470110,7678
31055,"Douglas","Nebraska",41.29518299,-96.15085305,3024,23,0,3001,"Douglas, Nebraska, US",571327,4936,8236,3996,4240,1396,-677,719,326018,1814070,22807781,89880445,94288
32005,"Douglas","Nevada",38.912862,-119.6171333,26,0,0,26,"Douglas, Nevada, US",48905,416,287,549,-262,-16,691,675,18909,89995,820028,3598035,8814
41019,"Douglas","Oregon",43.27941273,-123.167291,25,0,0,25,"Douglas, Oregon, US",110980,866,1065,1473,-408,-35,1309,1274,37688,169916,1724762,7166239,14810
46043,"Douglas","South Dakota",43.38520741,-98.36978007,1,0,0,1,"Douglas, South Dakota, US",2921,-5,41,32,9,3,-18,-15,1443,2658,19659,87871,427
53017,"Douglas","Washington",47.7361335,-119.692937,139,3,0,136,"Douglas, Washington, US",43429,680,542,325,217,41,423,464,11587,36402,275764,1265646,4090
55031,"Douglas","Wisconsin",46.43222285,-91.91595768,17,0,0,17,"Douglas, Wisconsin, US",43150,7,397,430,-33,-13,53,40,17767,68544,598645,2518937,5632
5043,"Drew","Arkansas",33.59035001,-91.71777921,19,1,0,18,"Drew, Arkansas, US",18219,-109,228,198,30,-5,-134,-139,6373,22090,153251,660309,1991
17043,"DuPage","Illinois",41.85116968,-88.08642662,6891,339,0,6552,"DuPage, Illinois, US",922921,-4326,10158,6595,3563,2050,-10009,-7959,570152,3424837,51988664,204443266,203758
18037,"Dubois","Indiana",38.36597551,-86.8792417,171,2,0,169,"Dubois, Indiana, US",42736,62,559,409,150,101,-188,-87,26978,135386,1365658,5628884,7220
19061,"Dubuque","Iowa",42.46815349,-90.88181925,317,16,0,301,"Dubuque, Iowa, US",97311,389,1136,907,229,60,106,166,57751,274455,2739139,11300359,16072
29069,"Dunklin","Missouri",36.27167174,-90.09122243,28,2,0,26,"Dunklin, Missouri, US",29131,-347,357,447,-90,29,-287,-258,10043,31428,193848,814259,3626
38025,"Dunn","North Dakota",47.35423935,-102.6160468,12,0,0,12,"Dunn, North Dakota, US",4424,96,67,17,50,9,37,46,2761,8619,132678,635247,718
55033,"Dunn","Wisconsin",44.94562799,-91.8962481,21,0,0,21,"Dunn, Wisconsin, US",45368,277,430,320,110,16,155,171,18654,63273,521680,2240835,4926
37061,"Duplin","North Carolina",34.93449805,-77.93140529,597,13,0,584,"Duplin, North Carolina, US",58741,-250,664,593,71,121,-442,-321,20917,63358,487023,1891432,4658
37063,"Durham","North Carolina",36.03638492,-78.87608331,1230,44,0,1186,"Durham, North Carolina, US",321488,4509,4186,2235,1951,1376,1176,2552,197066,975773,16044791,63895066,44770
36027,"Dutchess","New York",41.7648606,-73.74356679,3793,133,0,3660,"Dutchess, New York, US",294218,279,2584,2765,-181,232,247,479,118678,528611,5733099,23785070,45107
12031,"Duval","Florida",30.33225875,-81.66976468,1406,41,0,1365,"Duval, Florida, US",957755,9103,13013,8855,4158,2008,2933,4941,490041,2623667,33055660,125991428,153970
48131,"Duval","Texas",27.68184592,-98.50864568,5,0,0,5,"Duval, Texas, US",11157,10,142,124,18,-1,-8,-9,3928,9164,79623,302589,711
47045,"Dyer","Tennessee",36.05931946,-89.41542855,48,0,0,48,"Dyer, Tennessee, US",37159,-127,445,458,-13,-1,-112,-113,16082,57887,464166,1928687,4139
8037,"Eagle","Colorado",39.62754308,-106.6933637,580,8,0,572,"Eagle, Colorado, US",55127,184,559,129,430,118,-364,-246,29722,177515,1812690,7158257,20478
13099,"Early","Georgia",31.32155345,-84.90255207,236,29,0,207,"Early, Georgia, US",10190,-96,128,142,-14,4,-86,-82,3641,9290,89875,356381,931
22033,"East Baton Rouge","Louisiana",30.53842039,-91.09777565,3370,225,0,3145,"East Baton Rouge, Louisiana, US",440059,-1999,5739,3902,1837,640,-4499,-3859,266852,1438838,17301426,68673240,73558
22035,"East Carroll","Louisiana",32.73926954,-91.23425694,62,0,0,62,"East Carroll, Louisiana, US",6861,-133,82,66,16,-3,-146,-149,1884,3461,27156,106186,439
22037,"East Feliciana","Louisiana",30.84425359,-91.04976723,184,27,0,157,"East Feliciana, Louisiana, US",19135,-151,196,233,-37,1,-114,-113,4578,10929,101913,412566,1114
48133,"Eastland","Texas",32.32743996,-98.83243566,5,0,0,5,"Eastland, Texas, US",18360,41,187,245,-58,0,99,99,6614,23334,224006,962183,2203
26045,"Eaton","Michigan",42.59599185,-84.83740035,175,6,0,169,"Eaton, Michigan, US",110268,558,1065,1003,62,103,405,508,46753,196417,2323510,8228856,12135
55035,"Eau Claire","Wisconsin",44.726614,-91.28609183,93,0,0,93,"Eau Claire, Wisconsin, US",104646,291,1154,756,398,96,-199,-103,60179,270870,2823828,12291791,15207
13101,"Echols","Georgia",30.71101099,-82.89687287,61,0,0,61,"Echols, Georgia, US",4006,6,26,12,14,7,-14,-7,361,205,1731,8137,54
48135,"Ector","Texas",31.86898877,-102.5429428,130,4,0,126,"Ector, Texas, US",166223,4263,2915,1228,1687,238,2324,2562,69424,332878,4113201,18117832,21239
35015,"Eddy","New Mexico",32.47167456,-104.3053527,17,1,0,16,"Eddy, New Mexico, US",58460,731,805,550,255,47,428,475,29055,114681,1425524,6020522,8099
38027,"Eddy","North Dakota",47.71701474,-98.90432337,7,0,0,7,"Eddy, North Dakota, US",2287,-22,33,37,-4,0,-18,-18,965,1128,9966,43942,241
17045,"Edgar","Illinois",39.6809186,-87.74759563,0,0,0,0,"Edgar, Illinois, US",17161,-199,170,227,-57,5,-147,-142,7567,23205,192414,788162,1796
37065,"Edgecombe","North Carolina",35.91230639,-77.59436892,184,9,0,175,"Edgecombe, North Carolina, US",51472,-512,589,634,-45,16,-484,-468,17620,42323,294832,1181531,3733
45037,"Edgefield","South Carolina",33.77221995,-81.96231108,48,2,0,46,"Edgefield, South Carolina, US",27260,128,192,301,-109,3,236,239,6943,18405,176595,681394,1561
21061,"Edmonson","Kentucky",37.21218923,-86.23955613,54,9,0,45,"Edmonson, Kentucky, US",12150,-99,112,146,-34,-5,-59,-64,1838,2951,17164,79419,455
17047,"Edwards","Illinois",38.41353228,-88.05720863,2,0,0,2,"Edwards, Illinois, US",6395,8,74,59,15,0,-7,-7,2796,4631,37860,143856,590
20047,"Edwards","Kansas",37.88735543,-99.31263309,5,0,0,5,"Edwards, Kansas, US",2798,-22,25,21,4,2,-28,-26,1154,1479,11852,48420,267
13103,"Effingham","Georgia",32.36616021,-81.34280942,63,1,0,62,"Effingham, Georgia, US",64296,2068,795,478,317,30,1719,1749,11245,32511,277770,1143030,3919
17049,"Effingham","Illinois",39.05935711,-88.58969584,6,1,0,5,"Effingham, Illinois, US",34008,-173,469,375,94,6,-273,-267,21312,95482,827252,3499020,6784
6017,"El Dorado","California",38.77965956,-120.5233166,74,0,0,74,"El Dorado, California, US",192843,2097,1624,1699,-75,75,2110,2185,56007,241005,2493586,10670932,26498
8041,"El Paso","Colorado",38.83240149,-104.5251411,1493,88,0,1405,"El Paso, Colorado, US",720403,8314,9512,4845,4667,526,3099,3625,312224,1420340,15866515,65486038,104744
48141,"El Paso","Texas",31.76980765,-106.2363275,2265,57,0,2208,"El Paso, Texas, US",839238,2413,11617,5552,6065,167,-3818,-3651,337026,1383180,10777062,43937063,86894
8039,"Elbert","Colorado",39.28656773,-104.1358721,48,2,0,46,"Elbert, Colorado, US",26729,426,196,148,48,34,345,379,5477,12929,113957,533203,3325
13105,"Elbert","Georgia",34.11302332,-82.83936148,71,0,0,71,"Elbert, Georgia, US",19194,99,206,266,-60,-2,163,161,6638,21239,167150,694150,2285
20049,"Elk","Kansas",37.45338105,-96.24369667,0,0,0,0,"Elk, Kansas, US",2530,46,23,33,-10,0,58,58,867,772,3740,15309,262
42047,"Elk","Pennsylvania",41.42822061,-78.64524744,6,0,0,6,"Elk, Pennsylvania, US",29910,-200,268,359,-91,1,-109,-108,14323,68100,656189,2699150,4833
18039,"Elkhart","Indiana",41.59761169,-85.85875695,938,27,0,911,"Elkhart, Indiana, US",206341,724,3054,1669,1385,209,-870,-661,113756,744698,8770426,35482095,29113
32007,"Elko","Nevada",41.14531606,-115.3577619,22,1,0,21,"Elko, Nevada, US",52778,239,775,371,404,-45,-120,-165,23971,109935,1522104,5918713,6198
21063,"Elliott","Kentucky",38.11624059,-83.09771563,1,0,0,1,"Elliott, Kentucky, US",7517,18,68,70,-2,0,20,20,1296,1127,6695,27645,158
20051,"Ellis","Kansas",38.91458712,-99.31751551,8,0,0,8,"Ellis, Kansas, US",28553,-93,294,248,46,44,-184,-140,16495,57592,456952,1897675,6148
48139,"Ellis","Texas",32.34894117,-96.79371841,266,12,0,254,"Ellis, Texas, US",184826,5820,2272,1342,930,39,4841,4880,50628,237146,2189116,9224296,17339
20053,"Ellsworth","Kansas",38.69677695,-98.20462799,2,0,0,2,"Ellsworth, Kansas, US",6102,-61,54,68,-14,2,-49,-47,2690,5288,45610,181962,714
1051,"Elmore","Alabama",32.59785413,-86.14415284,254,7,0,247,"Elmore, Alabama, US",81209,198,932,821,111,25,67,92,18047,64318,499605,2037831,6553
16039,"Elmore","Idaho",43.3507101,-115.4701578,31,2,0,29,"Elmore, Idaho, US",27511,149,456,195,261,40,-153,-113,11053,16255,105181,459936,2273
13107,"Emanuel","Georgia",32.59221302,-82.30239915,26,2,0,24,"Emanuel, Georgia, US",22646,39,295,274,21,-2,22,20,7315,19473,150052,572670,1969
19063,"Emmet","Iowa",43.37782951,-94.67858943,7,0,0,7,"Emmet, Iowa, US",9208,-69,104,108,-4,5,-69,-64,4278,11248,89053,373545,1448
26047,"Emmet","Michigan",45.52625509,-84.89083249,21,2,0,19,"Emmet, Michigan, US",33415,190,288,310,-22,5,207,212,18715,75433,649134,3026243,8596
38029,"Emmons","North Dakota",46.28398398,-100.2389766,6,1,0,5,"Emmons, North Dakota, US",3241,-37,32,49,-17,3,-24,-21,1460,2463,19971,84927,530
51595,"Emporia","Virginia",36.69455571,-77.53406129,60,3,0,57,"Emporia, Virginia, US",5346,-17,51,72,-21,-3,9,6,3061,16216,111155,437327,1131
48143,"Erath","Texas",32.23602653,-98.21773417,15,1,0,14,"Erath, Texas, US",42698,475,480,335,145,-7,336,329,18086,57569,446751,1849335,5408
36029,"Erie","New York",42.76249024,-78.73063652,5552,480,0,5072,"Erie, New York, US",918702,-1015,9756,9765,-9,1278,-2264,-986,460674,2459000,27114247,108211285,137081
39043,"Erie","Ohio",41.36796058,-82.62904521,137,4,0,133,"Erie, Ohio, US",74266,-247,778,916,-138,-6,-100,-106,34999,145137,1212663,5079564,10297
42049,"Erie","Pennsylvania",41.99253829,-80.03301954,210,4,0,206,"Erie, Pennsylvania, US",269728,-1816,2855,2801,54,525,-2397,-1872,131205,638770,5650973,23508651,36558
1053,"Escambia","Alabama",31.1256789,-87.15918694,40,3,0,37,"Escambia, Alabama, US",36633,109,420,474,-54,-1,166,165,12408,43639,341813,1385883,4052
12033,"Escambia","Florida",30.67652764,-87.37284571,749,26,0,723,"Escambia, Florida, US",318316,3212,3804,3536,268,204,2726,2930,153405,608335,6216896,24879205,40663
25009,"Essex","Massachusetts",42.6687626,-70.94687179,13334,848,0,12486,"Essex, Massachusetts, US",789034,851,8605,6946,1659,3236,-4047,-811,320641,1732959,22145476,89428130,114011
34013,"Essex","New Jersey",40.78681335,-74.24657979,17160,1589,0,15571,"Essex, New Jersey, US",798975,405,10165,6457,3708,3009,-6340,-3331,364441,1695502,26333273,99950063,112675
36031,"Essex","New York",44.11630765,-73.77297842,36,0,0,36,"Essex, New York, US",36885,-403,308,413,-105,4,-300,-296,17055,49408,404441,1784399,6667
50009,"Essex","Vermont",44.72736416,-71.73579864,3,0,0,3,"Essex, Vermont, US",6163,-71,51,59,-8,1,-64,-63,1387,1677,10832,52228,437
51057,"Essex","Virginia",37.93357639,-76.94230311,41,0,0,41,"Essex, Virginia, US",10953,57,107,117,-10,5,61,66,4352,12428,79955,336594,1466
1055,"Etowah","Alabama",34.04567266,-86.04051873,228,10,0,218,"Etowah, Alabama, US",102268,-343,1175,1487,-312,37,-62,-25,36023,157876,1242590,5183814,11287
32011,"Eureka","Nevada",39.98100864,-116.2683204,0,0,0,0,"Eureka, Nevada, US",2029,31,12,10,2,0,29,29,4509,104,366,1674,89
22039,"Evangeline","Louisiana",30.72985248,-92.39915924,87,1,0,86,"Evangeline, Louisiana, US",33395,-101,447,391,56,60,-217,-157,8167,27778,186941,751836,2727
13109,"Evans","Georgia",32.15328841,-81.8870105,5,0,0,5,"Evans, Georgia, US",10654,-48,127,128,-1,0,-47,-47,4098,12294,80302,353924,993
2090,"Fairbanks North Star","Alaska",64.80726247,-146.5692662,85,2,0,83,"Fairbanks North Star, Alaska, US",96849,-1716,1533,506,1027,16,-2763,-2747,50201,139867,1570524,6880816,14319
51059,"Fairfax","Virginia",38.83677558,-77.27565836,8945,326,0,8619,"Fairfax, Virginia, US",1147532,-931,13769,5708,8061,5146,-14214,-9068,614465,3597567,73114511,284056410,187844
51600,"Fairfax City","Virginia",38.85157547,-77.2977964,52,3,0,49,"Fairfax City, Virginia, US",24019,294,673,203,470,140,-315,-175,36273,144786,1930038,7728021,11460
9001,"Fairfield","Connecticut",41.26809896,-73.3881171,14989,1208,0,13781,"Fairfield, Connecticut, US",943332,-639,9603,6960,2643,4737,-8080,-3343,467601,2509795,58314349,205182675,162678
39045,"Fairfield","Ohio",39.75107189,-82.63088163,233,3,0,230,"Fairfield, Ohio, US",157574,1592,1728,1402,326,118,1160,1278,42131,182468,1417958,6053404,15446
45039,"Fairfield","South Carolina",34.39287073,-81.1195624,158,9,0,149,"Fairfield, South Carolina, US",22347,-29,203,302,-99,20,50,70,7175,15037,190590,768197,1574
46047,"Fall River","South Dakota",43.23929297,-103.5275691,4,0,0,4,"Fall River, South Dakota, US",6713,-27,46,100,-54,0,26,26,3164,6073,51090,235200,901
48145,"Falls","Texas",31.25350609,-96.93630086,6,0,0,6,"Falls, Texas, US",17297,66,186,166,20,-3,50,47,3932,6699,47936,201588,1020
51610,"Falls Church","Virginia",38.88485255,-77.17560759,47,5,0,42,"Falls Church, Virginia, US",14617,150,201,80,121,22,8,30,10799,52515,581626,2568000,4781
13111,"Fannin","Georgia",34.86430205,-84.316964,39,1,0,38,"Fannin, Georgia, US",26188,207,223,349,-126,-5,337,332,7483,26557,166636,719888,3237
48147,"Fannin","Texas",33.59564294,-96.10751083,29,2,0,27,"Fannin, Texas, US",35514,329,321,437,-116,41,405,446,9340,20914,164912,699022,2397
27043,"Faribault","Minnesota",43.67381499,-93.94787458,11,0,0,11,"Faribault, Minnesota, US",13653,-83,146,158,-12,-2,-69,-71,6405,16293,127677,562964,2126
46049,"Faulk","South Dakota",45.07082625,-99.14535601,1,0,0,1,"Faulk, South Dakota, US",2299,-16,35,20,15,0,-31,-31,1152,1113,6559,28495,246
5045,"Faulkner","Arkansas",35.14719007,-92.33717519,100,3,0,97,"Faulkner, Arkansas, US",126007,869,1516,920,596,41,232,273,46903,176615,1484867,6170455,14821
51061,"Fauquier","Virginia",38.73564842,-77.80647472,269,5,0,264,"Fauquier, Virginia, US",71222,580,727,605,122,12,453,465,24316,98423,1026240,4470036,10814
1057,"Fayette","Alabama",33.72076938,-87.73886638,11,0,0,11,"Fayette, Alabama, US",16302,-143,174,225,-51,5,-97,-92,4006,11942,86169,349640,1433
13113,"Fayette","Georgia",33.41357794,-84.49089434,219,11,0,208,"Fayette, Georgia, US",114421,1240,875,897,-22,166,1116,1282,45106,230713,2138132,8724425,20465
17051,"Fayette","Illinois",39.00072038,-89.02452658,20,2,0,18,"Fayette, Illinois, US",21336,-32,228,218,10,-2,-40,-42,7209,21067,140617,593046,2548
18041,"Fayette","Indiana",39.63684962,-85.17797541,50,4,0,46,"Fayette, Indiana, US",23102,26,271,285,-14,15,27,42,7126,21962,161850,656729,2209
19065,"Fayette","Iowa",42.86271799,-91.8441231,26,0,0,26,"Fayette, Iowa, US",19650,-29,214,228,-14,13,-27,-14,8934,22775,158605,693399,2947
21067,"Fayette","Kentucky",38.0368225,-84.45576892,619,13,0,606,"Fayette, Kentucky, US",323152,726,3841,2405,1436,242,-943,-701,184563,920943,9678125,40419247,51855
39047,"Fayette","Ohio",39.56021306,-83.4562016,34,0,0,34,"Fayette, Ohio, US",28525,-128,330,309,21,4,-151,-147,12242,46565,327842,1353092,3134
42051,"Fayette","Pennsylvania",39.92041012,-79.64291195,94,4,0,90,"Fayette, Pennsylvania, US",129274,-1049,1244,1820,-576,7,-476,-469,39786,174921,1379363,5952024,14808
47047,"Fayette","Tennessee",35.19615831,-89.41399032,104,2,0,102,"Fayette, Tennessee, US",41133,577,414,435,-21,23,570,593,8147,28854,250419,1082347,3016
48149,"Fayette","Texas",29.87788372,-96.92076062,31,2,0,29,"Fayette, Texas, US",25346,68,237,291,-54,5,118,123,10526,34289,279162,1201663,4083
54019,"Fayette","West Virginia",38.02974928,-81.08286634,42,3,0,39,"Fayette, West Virginia, US",42406,-576,402,670,-268,5,-311,-306,11670,37490,305460,1287165,3856
47049,"Fentress","Tennessee",36.38128818,-84.92870012,9,0,0,9,"Fentress, Tennessee, US",18523,201,184,260,-76,-1,275,274,4620,11855,84700,362910,1197
30027,"Fergus","Montana",47.26331584,-109.2245206,0,0,0,0,"Fergus, Montana, US",11050,-67,104,130,-26,10,-51,-41,5324,14035,95433,450623,2106
53019,"Ferry","Washington",48.4711431,-118.5154041,1,0,0,1,"Ferry, Washington, US",7627,-11,64,81,-17,0,8,8,2140,3163,27602,114381,633
27045,"Fillmore","Minnesota",43.67394126,-92.08980382,17,1,0,16,"Fillmore, Minnesota, US",21067,23,256,237,19,16,-11,5,7112,21232,158039,707739,3146
31059,"Fillmore","Nebraska",40.52458567,-97.59646937,5,0,0,5,"Fillmore, Nebraska, US",5462,-73,65,66,-1,0,-73,-73,2802,6103,58213,244624,1083
20055,"Finney","Kansas",38.04340344,-100.7381938,1418,6,0,1412,"Finney, Kansas, US",36467,-61,613,208,405,105,-574,-469,18470,62392,509337,2087158,5396
48151,"Fisher","Texas",32.74281316,-100.4019302,2,0,0,2,"Fisher, Texas, US",3830,9,36,45,-9,6,14,20,1251,1173,11554,45699,241
12035,"Flagler","Florida",29.45933576,-81.31508595,173,4,0,169,"Flagler, Florida, US",115081,2996,807,1385,-578,21,3537,3558,25393,97926,738641,3087673,12391
30029,"Flathead","Montana",48.29575866,-114.0520569,37,2,0,35,"Flathead, Montana, US",103806,1789,1113,917,196,-42,1629,1587,42160,216557,2039816,8484967,24367
21069,"Fleming","Kentucky",38.36758311,-83.69657514,2,0,0,2,"Fleming, Kentucky, US",14581,96,199,161,38,0,59,59,3708,7504,54911,228747,1015
45041,"Florence","South Carolina",34.02361754,-79.70189312,588,31,0,557,"Florence, South Carolina, US",138293,16,1614,1558,56,107,-142,-35,67260,286415,2428984,10209766,18167
55037,"Florence","Wisconsin",45.84963535,-88.39804137,2,0,0,2,"Florence, Wisconsin, US",4295,1,27,47,-20,-2,24,22,1144,2702,14364,61962,471
13115,"Floyd","Georgia",34.26268279,-85.21577392,226,14,0,212,"Floyd, Georgia, US",98498,534,1133,1140,-7,152,391,543,43760,168446,1477619,6201122,11434
18043,"Floyd","Indiana",38.32117957,-85.90385377,311,38,0,273,"Floyd, Indiana, US",78522,688,885,758,127,62,504,566,30684,134371,1208687,5080158,10603
19067,"Floyd","Iowa",43.0600053,-92.78940097,17,1,0,16,"Floyd, Iowa, US",15642,-110,187,180,7,-5,-113,-118,6625,20843,194670,759523,2052
21071,"Floyd","Kentucky",37.56213922,-82.74750924,16,0,0,16,"Floyd, Kentucky, US",35589,-307,416,522,-106,0,-200,-200,10854,41367,347185,1418191,3913
48153,"Floyd","Texas",34.07227468,-101.3031546,5,0,0,5,"Floyd, Texas, US",5712,-71,70,52,18,2,-91,-89,2350,3640,32183,136756,605
51063,"Floyd","Virginia",36.9302126,-80.36738849,4,0,0,4,"Floyd, Virginia, US",15749,-41,144,192,-48,-6,15,9,4206,9112,54731,240069,1499
51065,"Fluvanna","Virginia",37.84157909,-78.27715475,84,6,0,78,"Fluvanna, Virginia, US",27270,372,290,213,77,4,292,296,4462,12165,105189,454969,1914
55039,"Fond du Lac","Wisconsin",43.75354908,-88.48885325,158,4,0,154,"Fond du Lac, Wisconsin, US",103403,402,1068,911,157,74,179,253,47776,213522,2184723,8873913,13325
17053,"Ford","Illinois",40.59706922,-88.22350769,19,1,0,18,"Ford, Illinois, US",12961,-251,145,186,-41,2,-214,-212,5346,16228,133464,558139,1781
20057,"Ford","Kansas",37.69200114,-99.88825298,1555,8,0,1547,"Ford, Kansas, US",33619,-258,559,219,340,240,-842,-602,16957,53767,474162,2030176,4110
42053,"Forest","Pennsylvania",41.51095103,-79.23229292,7,0,0,7,"Forest, Pennsylvania, US",7247,-37,20,79,-59,0,22,22,2161,2497,16434,68076,384
55041,"Forest","Wisconsin",45.66678019,-88.77084892,11,0,0,11,"Forest, Wisconsin, US",9004,27,97,104,-7,0,33,33,3266,5773,36773,157453,1076
28035,"Forrest","Mississippi",31.18961454,-89.25832496,478,33,0,445,"Forrest, Mississippi, US",74897,-15,1000,764,236,154,-404,-250,41486,146293,1346154,5787381,10084
13117,"Forsyth","Georgia",34.22604035,-84.1231513,446,12,0,434,"Forsyth, Georgia, US",244252,7259,2435,1340,1095,409,5743,6152,73189,405053,4526381,18633879,38359
37067,"Forsyth","North Carolina",36.12859861,-80.25459052,889,7,0,882,"Forsyth, North Carolina, US",382295,3079,4356,3339,1017,333,1734,2067,184199,900967,11706253,43092179,51073
48157,"Fort Bend","Texas",29.52704478,-95.77219463,1676,41,0,1635,"Fort Bend, Texas, US",811688,23607,9532,3762,5770,4360,13487,17847,170204,984383,10712646,43072167,80154
38031,"Foster","North Dakota",47.4571084,-98.88279923,1,0,0,1,"Foster, North Dakota, US",3210,3,38,32,6,-2,-1,-3,1852,3986,39027,164713,546
18045,"Fountain","Indiana",40.12361933,-87.24217689,17,2,0,15,"Fountain, Indiana, US",16346,-44,184,180,4,3,-51,-48,5760,12567,89577,375640,1469
1059,"Franklin","Alabama",34.44235334,-87.84289505,434,6,0,428,"Franklin, Alabama, US",31362,64,432,367,65,29,-28,1,10759,36105,273705,1146156,2653
5047,"Franklin","Arkansas",35.51202821,-93.89299569,4,0,0,4,"Franklin, Arkansas, US",17715,-49,178,190,-12,-1,-34,-35,5125,13600,110601,441935,1346
12037,"Franklin","Florida",29.83791238,-84.82731662,2,0,0,2,"Franklin, Florida, US",12125,449,94,111,-17,2,458,460,4425,9896,64250,284198,1469
13119,"Franklin","Georgia",34.37525597,-83.23159927,36,1,0,35,"Franklin, Georgia, US",23349,315,287,300,-13,26,301,327,8163,26758,202290,833264,2272
17055,"Franklin","Illinois",37.99189086,-88.92567818,11,0,0,11,"Franklin, Illinois, US",38469,-226,460,509,-49,-2,-173,-175,10282,30023,208666,887832,3842
18047,"Franklin","Indiana",39.4142482,-85.06062647,106,8,0,98,"Franklin, Indiana, US",22758,52,275,211,64,6,-18,-12,5172,19858,154316,653151,2149
19069,"Franklin","Iowa",42.73270384,-93.26256925,7,0,0,7,"Franklin, Iowa, US",10070,-15,117,107,10,6,-31,-25,4639,10884,89664,394319,1550
20059,"Franklin","Kansas",38.56443815,-95.28644341,32,0,0,32,"Franklin, Kansas, US",25544,-81,295,250,45,9,-136,-127,10427,30444,268307,1108187,2993
21073,"Franklin","Kentucky",38.2379395,-84.87962551,24,0,0,24,"Franklin, Kentucky, US",50991,190,605,539,66,28,97,125,32816,79000,692013,2815660,6419
22041,"Franklin","Louisiana",32.13675181,-91.67589857,287,9,0,278,"Franklin, Louisiana, US",20015,-149,272,277,-5,0,-143,-143,5683,17054,107342,429607,1960
23007,"Franklin","Maine",44.97330019,-70.44381045,36,1,0,35,"Franklin, Maine, US",30199,284,237,341,-104,-1,391,390,13354,41058,285167,1149755,4743
25011,"Franklin","Massachusetts",42.58119713,-72.58602547,312,46,0,266,"Franklin, Massachusetts, US",70180,-431,526,703,-177,102,-355,-253,29454,99413,933848,3863903,8741
28037,"Franklin","Mississippi",31.47786634,-90.89672989,25,2,0,23,"Franklin, Mississippi, US",7713,-45,84,88,-4,3,-43,-40,1883,3028,26184,107507,484
29071,"Franklin","Missouri",38.41127108,-91.07522826,138,16,0,122,"Franklin, Missouri, US",103967,251,1186,1047,139,12,106,118,39299,181811,1585218,6658397,15069
31061,"Franklin","Nebraska",40.17636348,-98.95299073,6,0,0,6,"Franklin, Nebraska, US",2979,-34,35,27,8,0,-43,-43,1112,1246,8003,36736,272
36033,"Franklin","New York",44.59040891,-74.29926032,20,0,0,20,"Franklin, New York, US",50022,-257,444,524,-80,-6,-171,-177,19886,48419,382153,1621480,5253
37069,"Franklin","North Carolina",36.081519,-78.28708884,141,22,0,119,"Franklin, North Carolina, US",69685,2060,725,642,83,103,1867,1970,14220,43728,379759,1607320,5801
39049,"Franklin","Ohio",39.96995815,-83.01115755,5097,224,0,4873,"Franklin, Ohio, US",1316756,9058,18521,10027,8494,3595,-2967,628,716279,3775265,48565949,190400631,169990
42055,"Franklin","Pennsylvania",39.92956518,-77.72157791,711,29,0,682,"Franklin, Pennsylvania, US",155027,448,1730,1632,98,53,306,359,61082,266595,2344744,9702258,17879
47051,"Franklin","Tennessee",35.15634626,-86.09201039,45,1,0,44,"Franklin, Tennessee, US",42208,273,413,456,-43,40,276,316,14422,42377,386032,1616588,3693
48159,"Franklin","Texas",33.17653242,-95.21917243,8,0,0,8,"Franklin, Texas, US",10725,-53,115,135,-20,0,-32,-32,4363,18207,56805,240665,718
50011,"Franklin","Vermont",44.85627605,-72.91249563,99,5,0,94,"Franklin, Vermont, US",49402,144,569,392,177,6,-37,-31,18907,55576,521586,2140285,5675
51067,"Franklin","Virginia",36.99536167,-79.88023649,32,1,0,31,"Franklin, Virginia, US",56042,-149,456,681,-225,-15,95,80,16866,58627,396215,1672719,6366
53021,"Franklin","Washington",46.53351425,-118.9018212,480,18,0,462,"Franklin, Washington, US",95222,1219,1573,460,1113,60,44,104,31116,111881,1044863,4673982,8972
51620,"Franklin City","Virginia",36.6831435,-76.93859681,38,1,0,37,"Franklin City, Virginia, US",7967,-122,155,110,45,-1,-166,-167,4127,14619,94981,395744,1275
24021,"Frederick","Maryland",39.47296601,-77.39999394,1661,96,0,1565,"Frederick, Maryland, US",259547,4604,2864,1859,1005,325,3280,3605,104990,507839,6022888,24604034,36757
51069,"Frederick","Virginia",39.20172582,-78.25974949,255,3,0,252,"Frederick, Virginia, US",89313,1140,949,755,194,3,943,946,30870,135570,1401616,5529801,8537
51630,"Fredericksburg","Virginia",38.2977863,-77.4922454,113,0,0,113,"Fredericksburg, Virginia, US",29036,-135,429,201,228,36,-399,-363,26813,102748,980313,4147727,7882
27047,"Freeborn","Minnesota",43.67385583,-93.34884422,82,0,0,82,"Freeborn, Minnesota, US",30281,-199,314,352,-38,25,-187,-162,13259,48754,398524,1710027,4127
48161,"Freestone","Texas",31.70422788,-96.15072516,7,0,0,7,"Freestone, Texas, US",19717,-72,219,223,-4,13,-79,-66,6435,15496,143988,556412,1822
8043,"Fremont","Colorado",38.47362326,-105.4399667,26,0,0,26,"Fremont, Colorado, US",47839,-120,381,564,-183,-5,70,65,13788,39375,268755,1153650,4636
16043,"Fremont","Idaho",44.22800938,-111.4809943,3,0,0,3,"Fremont, Idaho, US",13099,-56,183,92,91,5,-151,-146,3467,6439,42922,223215,1512
19071,"Fremont","Iowa",40.7454272,-95.60129045,4,0,0,4,"Fremont, Iowa, US",6960,-21,78,77,1,2,-24,-22,2595,7131,51165,217203,777
56013,"Fremont","Wyoming",43.04183996,-108.6296893,244,0,0,244,"Fremont, Wyoming, US",39261,-300,505,485,20,-3,-316,-319,17325,52272,452922,1920926,7242
6019,"Fresno","California",36.75733899,-119.6466953,1417,22,0,1395,"Fresno, California, US",999101,7151,14506,7467,7039,479,-348,131,361256,1513406,15019431,64013653,100799
48163,"Frio","Texas",28.86751206,-99.10804207,35,0,0,35,"Frio, Texas, US",20306,95,251,158,93,236,-235,1,8930,19714,207056,833414,1601
31063,"Frontier","Nebraska",40.52993007,-100.3924658,1,0,0,1,"Frontier, Nebraska, US",2627,27,24,15,9,0,17,17,1155,1395,9811,46701,268
5049,"Fulton","Arkansas",36.38177105,-91.81729127,6,0,0,6,"Fulton, Arkansas, US",12477,169,134,201,-67,5,232,237,2967,5549,32079,138841,677
13121,"Fulton","Georgia",33.79216944,-84.46319413,3977,197,0,3780,"Fulton, Georgia, US",1063937,13806,12612,7418,5194,3003,5556,8559,837900,4785942,98679232,345460124,220187
17057,"Fulton","Illinois",40.47289135,-90.20862357,10,0,0,10,"Fulton, Illinois, US",34340,-490,321,463,-142,5,-353,-348,9663,31023,229120,867438,3367
18049,"Fulton","Indiana",41.0469907,-86.26252745,46,1,0,45,"Fulton, Indiana, US",19974,-79,230,207,23,-1,-100,-101,6898,20632,143677,616411,2313
21075,"Fulton","Kentucky",36.55238827,-89.20140068,3,0,0,3,"Fulton, Kentucky, US",5969,-97,54,90,-36,0,-62,-62,2593,4793,37541,136796,555
36035,"Fulton","New York",43.11363907,-74.41798804,193,15,0,178,"Fulton, New York, US",53383,-250,517,565,-48,0,-203,-203,18793,63425,489392,2069237,6429
39051,"Fulton","Ohio",41.60213491,-84.12571393,35,0,0,35,"Fulton, Ohio, US",42126,-141,487,429,58,10,-209,-199,18033,66824,656750,2763211,5227
42057,"Fulton","Pennsylvania",39.92913544,-78.11163677,14,1,0,13,"Fulton, Pennsylvania, US",14530,5,144,153,-9,1,15,16,5491,12602,112083,490263,1168
31065,"Furnas","Nebraska",40.17642064,-99.91247454,7,0,0,7,"Furnas, Nebraska, US",4676,-25,56,55,1,0,-27,-27,2235,4293,32440,141781,730
12039,"Gadsden","Florida",30.57796289,-84.61915825,255,1,0,254,"Gadsden, Florida, US",45660,-267,520,522,-2,41,-303,-262,11729,30892,280962,1163486,3350
31067,"Gage","Nebraska",40.26186809,-96.68946704,44,3,0,41,"Gage, Nebraska, US",21513,18,228,255,-27,1,46,47,9632,31912,238842,997046,3536
48165,"Gaines","Texas",32.74055318,-102.6353295,6,0,0,6,"Gaines, Texas, US",21492,672,430,121,309,67,295,362,7216,22646,308413,1320581,2286
51640,"Galax","Virginia",36.66601852,-80.91703124,87,0,0,87,"Galax, Virginia, US",6347,-1,69,116,-47,-5,53,48,3885,22461,159779,659894,1475
17059,"Gallatin","Illinois",37.76430935,-88.22953869,2,0,0,2,"Gallatin, Illinois, US",4828,-217,40,79,-39,0,-178,-178,1624,1713,12947,56525,322
21077,"Gallatin","Kentucky",38.75398691,-84.8558382,8,0,0,8,"Gallatin, Kentucky, US",8869,103,112,84,28,0,75,75,2415,2526,16554,70672,328
30031,"Gallatin","Montana",45.54486106,-111.1692571,149,1,0,148,"Gallatin, Montana, US",114434,2752,1262,612,650,111,1973,2084,50924,259265,2431846,10513842,33342
39053,"Gallia","Ohio",38.82708533,-82.31647569,7,1,0,6,"Gallia, Ohio, US",29898,-47,353,389,-36,16,-24,-8,11914,39382,353382,1391714,2881
48167,"Galveston","Texas",29.40167322,-94.90469073,740,31,0,709,"Galveston, Texas, US",342139,4281,3944,2935,1009,329,2949,3278,108816,462479,4336823,16919239,34907
8045,"Garfield","Colorado",39.59921777,-107.902708,120,2,0,118,"Garfield, Colorado, US",60061,360,781,380,401,54,-94,-40,26872,102703,1103492,4735383,14182
40047,"Garfield","Oklahoma",36.3791334,-97.78265517,25,1,0,24,"Garfield, Oklahoma, US",61056,-39,864,621,243,147,-430,-283,29408,107934,942617,3979664,9319
53023,"Garfield","Washington",46.43197502,-117.5454032,0,0,0,0,"Garfield, Washington, US",2225,-15,27,28,-1,5,-19,-14,701,977,8143,31934,155
5051,"Garland","Arkansas",34.57692074,-93.14921604,133,1,0,132,"Garland, Arkansas, US",99386,420,1071,1347,-276,-27,726,699,39806,177353,1352133,5692228,16022
21079,"Garrard","Kentucky",37.6388668,-84.53289319,4,0,0,4,"Garrard, Kentucky, US",17666,147,192,185,7,-2,144,142,2469,5976,42998,189576,1035
24023,"Garrett","Maryland",39.52786077,-79.27355126,7,0,0,7,"Garrett, Maryland, US",29014,-119,260,345,-85,-1,-31,-32,13249,44698,333488,1421789,4771
40049,"Garvin","Oklahoma",34.70418038,-97.30811132,15,1,0,14,"Garvin, Oklahoma, US",27711,-35,328,351,-23,29,-39,-10,11840,33017,326009,1388824,3667
48169,"Garza","Texas",33.17969345,-101.2984114,4,0,0,4,"Garza, Texas, US",6229,-14,52,34,18,38,-70,-32,2209,4947,45101,187445,537
29073,"Gasconade","Missouri",38.43947277,-91.50847147,2,0,0,2,"Gasconade, Missouri, US",14706,26,152,197,-45,-1,74,73,6195,17981,115226,470656,1995
37071,"Gaston","North Carolina",35.29373559,-81.17477045,247,6,0,241,"Gaston, North Carolina, US",224529,1899,2580,2422,158,59,1679,1738,71535,339414,2932522,12311007,24447
37073,"Gates","North Carolina",36.44667547,-76.69749701,21,1,0,20,"Gates, North Carolina, US",11562,-1,96,142,-46,6,40,46,1846,2784,17675,71974,503
20061,"Geary","Kansas",38.99871131,-96.7577178,16,0,0,16,"Geary, Kansas, US",31670,-1107,851,187,664,24,-1793,-1769,23977,32384,218002,886886,2925
39055,"Geauga","Ohio",41.49952319,-81.17935342,250,29,0,221,"Geauga, Ohio, US",93649,-296,940,822,118,24,-436,-412,35568,155043,1418919,6211019,16112
16045,"Gem","Idaho",44.06482372,-116.398376,17,0,0,17,"Gem, Idaho, US",18112,525,200,203,-3,-1,528,527,3875,10954,62450,282494,1787
26049,"Genesee","Michigan",43.02244215,-83.70589709,1936,240,0,1696,"Genesee, Michigan, US",405813,-875,4600,4557,43,117,-1026,-909,144583,680885,6421895,26561987,45872
36037,"Genesee","New York",43.0022601,-78.19135193,191,4,0,187,"Genesee, New York, US",57280,-207,542,630,-88,2,-120,-118,25337,78262,609310,2651413,7118
1061,"Geneva","Alabama",31.09389027,-85.83572839,31,0,0,31,"Geneva, Alabama, US",26271,-35,278,365,-87,-7,62,55,6081,14385,91916,394146,2031
29075,"Gentry","Missouri",40.21097916,-94.40944419,6,0,0,6,"Gentry, Missouri, US",6571,-27,83,90,-7,0,-19,-19,2506,7013,42630,174897,911
28039,"George","Mississippi",30.86259065,-88.64436789,19,1,0,18,"George, Mississippi, US",24500,390,347,249,98,2,290,292,4827,14921,102077,417704,1634
45043,"Georgetown","South Carolina",33.43443342,-79.33202141,56,3,0,53,"Georgetown, South Carolina, US",62680,448,521,879,-358,-13,817,804,22254,99679,837456,3590815,10387
18051,"Gibson","Indiana",38.30393723,-87.58054938,13,2,0,11,"Gibson, Indiana, US",33659,49,384,385,-1,64,-12,52,20396,72638,796386,3254314,3757
47053,"Gibson","Tennessee",35.99438059,-88.93358327,61,1,0,60,"Gibson, Tennessee, US",49133,-38,579,654,-75,5,34,39,14915,51907,401030,1724478,5010
4007,"Gila","Arizona",33.80190085,-110.8132779,23,1,0,22,"Gila, Arizona, US",54018,217,514,811,-297,9,504,513,17941,55390,525117,2057981,5609
12041,"Gilchrist","Florida",29.72856978,-82.79880657,10,0,0,10,"Gilchrist, Florida, US",18582,298,182,206,-24,3,318,321,3823,6510,47978,199867,1135
47055,"Giles","Tennessee",35.20222469,-87.03992678,12,0,0,12,"Giles, Tennessee, US",29464,18,301,371,-70,39,51,90,10001,35290,287477,1241281,2756
51071,"Giles","Virginia",37.31234791,-80.70636931,5,0,0,5,"Giles, Virginia, US",16720,-79,166,217,-51,-1,-26,-27,5654,12910,105117,427621,1362
48171,"Gillespie","Texas",30.31824095,-98.94676915,5,0,0,5,"Gillespie, Texas, US",26988,286,248,373,-125,12,397,409,11094,47970,379829,1608478,5531
13123,"Gilmer","Georgia",34.69316688,-84.45802506,134,0,0,134,"Gilmer, Georgia, US",31369,534,313,367,-54,-1,586,585,8445,23738,158921,662573,2819
54021,"Gilmer","West Virginia",38.9251277,-80.85952723,9,0,0,9,"Gilmer, West Virginia, US",7823,-75,47,79,-32,-2,-41,-43,2790,3189,24019,99512,454
8047,"Gilpin","Colorado",39.85646523,-105.5252597,3,0,0,3,"Gilpin, Colorado, US",6243,131,36,24,12,0,117,117,5683,28367,270364,1068331,524
30035,"Glacier","Montana",48.70513576,-112.9934235,6,0,0,6,"Glacier, Montana, US",13753,-75,238,142,96,3,-175,-172,4605,8135,62757,313695,1033
12043,"Glades","Florida",26.95635849,-81.18996211,20,1,0,19,"Glades, Florida, US",13811,125,64,129,-65,15,173,188,2794,2617,18983,77943,410
26051,"Gladwin","Michigan",43.98901072,-84.38774817,17,1,0,16,"Gladwin, Michigan, US",25449,123,240,374,-134,2,256,258,5485,17258,132640,585149,2002
13125,"Glascock","Georgia",33.22879932,-82.61297636,1,0,0,1,"Glascock, Georgia, US",2971,-6,29,35,-6,0,0,0,556,439,1800,7637,66
48173,"Glasscock","Texas",31.86942909,-101.5207776,1,0,0,1,"Glasscock, Texas, US",1409,18,16,8,8,9,2,11,844,473,15028,46396,108
6021,"Glenn","California",39.59875897,-122.3938452,12,0,0,12,"Glenn, California, US",28393,426,371,251,120,-31,337,306,8939,20625,181379,797209,2334
34015,"Gloucester","New Jersey",39.71581067,-75.13995546,2044,134,0,1910,"Gloucester, New Jersey, US",291636,111,2841,2694,147,61,-86,-25,104648,535270,5273826,22104394,35987
51073,"Gloucester","Virginia",37.40809042,-76.53524337,30,1,0,29,"Gloucester, Virginia, US",37348,7,338,450,-112,-7,130,123,10707,36369,234437,992484,4591
13127,"Glynn","Georgia",31.23279254,-81.53811412,85,1,0,84,"Glynn, Georgia, US",85292,317,916,923,-7,8,318,326,41007,169800,1362913,5566862,14606
26053,"Gogebic","Michigan",46.40862701,-89.69377193,5,1,0,4,"Gogebic, Michigan, US",13975,-1141,128,210,-82,3,-1073,-1070,5566,16077,105809,429048,1836
30037,"Golden Valley","Montana",46.3816474,-109.1768522,3,0,0,3,"Golden Valley, Montana, US",821,-1,12,5,7,0,-6,-6,269,90,372,1690,20
48175,"Goliad","Texas",28.65696592,-97.42760647,7,0,0,7,"Goliad, Texas, US",7658,70,72,62,10,-1,61,60,1728,3113,24434,100767,492
48177,"Gonzales","Texas",29.45634206,-97.49424032,90,2,0,88,"Gonzales, Texas, US",20837,56,272,198,74,-23,7,-16,9013,21412,195527,806951,2042
51075,"Goochland","Virginia",37.71714806,-77.90381514,90,5,0,85,"Goochland, Virginia, US",23753,534,161,196,-35,-3,569,566,12418,39590,787368,2948517,3511
27049,"Goodhue","Minnesota",44.40849741,-92.7234195,50,2,0,48,"Goodhue, Minnesota, US",46340,41,503,454,49,3,-10,-7,22744,84543,782402,3257860,7132
16047,"Gooding","Idaho",42.96927962,-114.8108306,35,0,0,35,"Gooding, Idaho, US",15179,63,191,117,74,0,-9,-9,6088,11608,103828,431384,1872
13129,"Gordon","Georgia",34.50487351,-84.87296253,138,15,0,123,"Gordon, Georgia, US",57963,335,669,571,98,23,217,240,23420,97195,870825,3672801,5596
56015,"Goshen","Wyoming",42.08798185,-104.3534743,5,0,0,5,"Goshen, Wyoming, US",13211,-81,132,142,-10,6,-78,-72,5394,11793,88006,364541,1626
31073,"Gosper","Nebraska",40.51481965,-99.83020279,13,0,0,13,"Gosper, Nebraska, US",1990,-6,20,18,2,0,-8,-8,722,540,4340,18465,192
20063,"Gove","Kansas",38.91588178,-100.4829321,1,0,0,1,"Gove, Kansas, US",2636,25,27,35,-8,2,33,35,1492,2969,21238,89949,525
13131,"Grady","Georgia",30.87454847,-84.23418364,93,4,0,89,"Grady, Georgia, US",24633,-141,299,264,35,0,-178,-178,6028,17620,134592,549780,2064
40051,"Grady","Oklahoma",35.0167709,-97.88339847,73,2,0,71,"Grady, Oklahoma, US",55834,386,567,532,35,24,328,352,15867,52235,423807,1830255,6189
33009,"Grafton","New Hampshire",43.93779815,-71.82057197,69,1,0,68,"Grafton, New Hampshire, US",89886,185,681,830,-149,131,209,340,56076,248865,3000180,12043855,16966
4009,"Graham","Arizona",32.93166885,-109.8882178,21,0,0,21,"Graham, Arizona, US",38837,842,526,323,203,30,607,637,10236,31323,243759,1042453,2608
37075,"Graham","North Carolina",35.3506925,-83.83369267,2,0,0,2,"Graham, North Carolina, US",8441,-20,72,99,-27,1,7,8,2226,7906,55195,288913,736
47057,"Grainger","Tennessee",36.27469206,-83.51254721,6,0,0,6,"Grainger, Tennessee, US",23320,183,222,296,-74,-2,257,255,4061,9065,57404,260684,1099
8049,"Grand","Colorado",40.10603347,-106.1178042,6,0,0,6,"Grand, Colorado, US",15734,223,109,66,43,10,170,180,7819,41363,293356,1197066,4643
38035,"Grand Forks","North Dakota",47.92093639,-97.45450447,321,3,0,318,"Grand Forks, North Dakota, US",69451,-904,974,526,448,61,-1419,-1358,41659,161055,1387103,6092815,10699
50013,"Grand Isle","Vermont",44.7975824,-73.29679772,6,0,0,6,"Grand Isle, Vermont, US",7235,125,68,57,11,0,114,114,1497,2894,20279,103839,856
26055,"Grand Traverse","Michigan",44.69565625,-85.55585247,23,5,0,18,"Grand Traverse, Michigan, US",93088,558,902,867,35,7,517,524,51591,243539,2365274,10220280,20256
5053,"Grant","Arkansas",34.29017991,-92.42320562,16,0,0,16,"Grant, Arkansas, US",18265,85,172,188,-16,-6,107,101,4103,10988,84053,350400,1261
18053,"Grant","Indiana",40.51587228,-85.65468702,178,20,0,158,"Grant, Indiana, US",65769,-270,750,810,-60,26,-235,-209,30351,113349,919021,3742631,7176
20067,"Grant","Kansas",37.56227336,-101.3079758,18,0,0,18,"Grant, Kansas, US",7150,-144,108,34,74,-9,-210,-219,3446,8007,71785,299003,959
21081,"Grant","Kentucky",38.64962758,-84.62415957,36,3,0,33,"Grant, Kentucky, US",25069,4,363,250,113,-14,-96,-110,5348,15406,113208,467602,1878
22043,"Grant","Louisiana",31.59882456,-92.56124347,26,1,0,25,"Grant, Louisiana, US",22389,-47,239,192,47,-1,-91,-92,2941,4881,33522,146310,786
27051,"Grant","Minnesota",45.93424769,-96.01139609,2,0,0,2,"Grant, Minnesota, US",5972,-17,56,59,-3,0,-13,-13,2318,5816,42508,199307,942
35017,"Grant","New Mexico",32.73911281,-108.3827845,16,0,0,16,"Grant, New Mexico, US",26998,-305,256,325,-69,-10,-221,-231,10626,26719,184035,743833,3067
38037,"Grant","North Dakota",46.35821257,-101.6390013,2,0,0,2,"Grant, North Dakota, US",2274,-80,26,24,2,0,-83,-83,1131,1230,9842,39529,254
40053,"Grant","Oklahoma",36.796297,-97.78638765,2,0,0,2,"Grant, Oklahoma, US",4333,12,48,49,-1,0,12,12,1918,2723,26886,109609,518
41023,"Grant","Oregon",44.49024544,-119.0068631,1,0,0,1,"Grant, Oregon, US",7199,14,63,86,-23,-2,40,38,2708,5291,34892,170511,1042
46051,"Grant","South Dakota",45.1723937,-96.77002276,10,0,0,10,"Grant, South Dakota, US",7052,-51,82,70,12,-5,-58,-63,4247,13148,116809,489159,1398
53025,"Grant","Washington",47.20753737,-119.4500749,189,4,0,185,"Grant, Washington, US",97733,1061,1486,719,767,81,215,296,39430,117006,1054739,4731465,10789
54023,"Grant","West Virginia",39.10314817,-79.19440518,6,0,0,6,"Grant, West Virginia, US",11568,-62,127,129,-2,-1,-58,-59,4231,9179,68065,282889,1106
55043,"Grant","Wisconsin",42.8671731,-90.7063218,81,10,0,71,"Grant, Wisconsin, US",51439,-5,561,471,90,10,-103,-93,21656,66518,518063,2208013,6813
37077,"Granville","North Carolina",36.30337451,-78.65184241,239,7,0,232,"Granville, North Carolina, US",60443,464,601,599,2,-11,473,462,20854,55862,473680,1935524,4804
26057,"Gratiot","Michigan",43.29265605,-84.60505416,67,5,0,62,"Gratiot, Michigan, US",40711,109,366,423,-57,7,160,167,15194,44242,356586,1551389,3832
21083,"Graves","Kentucky",36.72292505,-88.65143315,157,19,0,138,"Graves, Kentucky, US",37266,-53,492,420,72,19,-144,-125,12301,40789,304211,1266994,3561
20069,"Gray","Kansas",37.73836671,-100.4369088,21,0,0,21,"Gray, Kansas, US",5988,-88,94,41,53,16,-159,-143,2819,5649,53770,225670,1099
48179,"Gray","Texas",35.40081878,-100.8129222,95,1,0,94,"Gray, Texas, US",21886,-165,259,254,5,-1,-170,-171,9137,26053,274148,1098724,2870
53027,"Grays Harbor","Washington",47.14003705,-123.7820567,16,0,0,16,"Grays Harbor, Washington, US",75061,1260,734,886,-152,-16,1423,1407,24033,81207,672333,2901895,9214
21085,"Grayson","Kentucky",37.46231118,-86.34248968,121,8,0,113,"Grayson, Kentucky, US",26427,134,300,316,-16,-1,152,151,8273,24106,176166,703569,2249
48181,"Grayson","Texas",33.62744998,-96.67753461,268,1,0,267,"Grayson, Texas, US",136212,2425,1630,1494,136,90,2193,2283,48343,197991,1744769,7350088,14745
51077,"Grayson","Virginia",36.65677234,-81.23215889,24,0,0,24,"Grayson, Virginia, US",15550,-85,118,202,-84,-2,2,0,4297,3341,22070,90833,624
31077,"Greeley","Nebraska",41.56742671,-98.52150266,3,0,0,3,"Greeley, Nebraska, US",2356,1,29,23,6,0,-5,-5,872,1148,8044,36131,247
21087,"Green","Kentucky",37.26484328,-85.5540745,1,0,0,1,"Green, Kentucky, US",10941,-57,107,137,-30,0,-26,-26,2138,4475,28524,120115,646
55045,"Green","Wisconsin",42.6794956,-89.60243287,52,0,0,52,"Green, Wisconsin, US",36960,36,366,369,-3,15,26,41,17110,57607,497487,2187743,5386
55047,"Green Lake","Wisconsin",43.80025981,-89.04679553,14,0,0,14,"Green Lake, Wisconsin, US",18913,64,202,215,-13,-2,80,78,7998,21799,164567,740677,2358
54025,"Greenbrier","West Virginia",37.9463652,-80.45335881,9,0,0,9,"Greenbrier, West Virginia, US",34662,-130,342,503,-161,2,31,33,15306,48859,379778,1567975,4936
1063,"Greene","Alabama",32.85504247,-87.95684022,90,4,0,86,"Greene, Alabama, US",8111,-98,96,93,3,0,-101,-101,1883,3197,23815,98034,360
5055,"Greene","Arkansas",36.1173546,-90.55832668,45,0,0,45,"Greene, Arkansas, US",45325,-14,587,505,82,-7,-87,-94,16695,56398,492876,1903990,4189
13133,"Greene","Georgia",33.5769205,-83.17139104,63,7,0,56,"Greene, Georgia, US",18324,591,176,228,-52,25,616,641,6339,20491,185977,791195,2279
17061,"Greene","Illinois",39.35907414,-90.388865,5,0,0,5,"Greene, Illinois, US",12969,-96,131,153,-22,1,-76,-75,3425,7065,53163,212901,1045
18055,"Greene","Indiana",39.03630547,-86.96223202,167,23,0,144,"Greene, Indiana, US",31922,-137,339,416,-77,4,-62,-58,8054,20295,143049,599232,2857
19073,"Greene","Iowa",42.03614551,-94.39658081,13,0,0,13,"Greene, Iowa, US",8888,-77,103,114,-11,-1,-65,-66,3940,10366,83715,348573,1276
28041,"Greene","Mississippi",31.21444233,-88.63922281,7,1,0,6,"Greene, Mississippi, US",13586,-410,143,126,17,13,-444,-431,2021,3312,26844,143331,572
29077,"Greene","Missouri",37.2575872,-93.34230916,121,8,0,113,"Greene, Missouri, US",293086,2032,3269,2773,496,224,1310,1534,168379,888566,8744119,36113736,49169
36039,"Greene","New York",42.275797,-74.12384884,217,18,0,199,"Greene, New York, US",47188,-193,384,540,-156,20,-54,-34,15260,50857,388339,1620616,6436
37079,"Greene","North Carolina",35.48544173,-77.67578087,64,2,0,62,"Greene, North Carolina, US",21069,-37,206,223,-17,16,-35,-19,5295,8757,57478,249413,1223
39057,"Greene","Ohio",39.69116283,-83.89032084,92,5,0,87,"Greene, Ohio, US",168937,1491,1716,1490,226,209,1062,1271,81581,309256,3062677,12859094,18840
42059,"Greene","Pennsylvania",39.85746531,-80.22357106,27,0,0,27,"Greene, Pennsylvania, US",36233,-428,361,430,-69,-1,-360,-361,16286,59219,667430,2722612,3849
47059,"Greene","Tennessee",36.17470125,-82.84691273,48,2,0,46,"Greene, Tennessee, US",69069,-95,665,908,-243,9,144,153,26192,104210,799746,3345557,6119
51079,"Greene","Virginia",38.29545894,-78.46525378,21,1,0,20,"Greene, Virginia, US",19819,127,224,148,76,12,38,50,3842,11232,80315,333953,1746
4011,"Greenlee","Arizona",33.21498827,-109.2405279,3,0,0,3,"Greenlee, Arizona, US",9498,50,144,49,95,8,-52,-44,5138,5216,63541,257460,302
51081,"Greensville","Virginia",36.67878901,-77.56351439,55,7,0,48,"Greensville, Virginia, US",11336,-96,107,126,-19,2,-79,-77,4082,5679,41374,167896,379
21089,"Greenup","Kentucky",38.54332505,-82.9215658,13,0,0,13,"Greenup, Kentucky, US",35098,-234,352,471,-119,-3,-112,-115,8514,23013,171538,726319,2353
45045,"Greenville","South Carolina",34.89502264,-82.37295012,1231,50,0,1181,"Greenville, South Carolina, US",523542,8921,6308,4496,1812,1469,5618,7087,248523,1337438,14914557,59202226,79662
20073,"Greenwood","Kansas",37.8774388,-96.23250453,3,0,0,3,"Greenwood, Kansas, US",5982,-29,56,71,-15,0,-14,-14,2070,4070,29251,124473,800
45047,"Greenwood","South Carolina",34.15272415,-82.12715789,82,1,0,81,"Greenwood, South Carolina, US",70811,214,811,803,8,76,132,208,28880,98718,814789,3357059,7277
40055,"Greer","Oklahoma",34.93535801,-99.5605612,66,7,0,59,"Greer, Oklahoma, US",5712,-102,52,54,-2,-2,-99,-101,1643,1738,12193,46751,287
48183,"Gregg","Texas",32.47940482,-94.81591935,180,4,0,176,"Gregg, Texas, US",123945,694,1625,1307,318,23,356,379,75739,339426,3341878,13730386,23752
28043,"Grenada","Mississippi",33.77036166,-89.80245083,72,2,0,70,"Grenada, Mississippi, US",20758,-226,247,288,-41,-3,-182,-185,9316,29798,228114,947988,2811
38039,"Griggs","North Dakota",47.45785838,-98.23850925,1,0,0,1,"Griggs, North Dakota, US",2231,3,22,31,-9,0,12,12,1173,1738,11084,48153,307
48185,"Grimes","Texas",30.54579585,-95.98902499,91,1,0,90,"Grimes, Texas, US",28880,589,306,246,60,11,518,529,7445,23148,253683,1132012,2139
17063,"Grundy","Illinois",41.28569601,-88.41905692,87,2,0,85,"Grundy, Illinois, US",51054,81,576,405,171,8,-99,-91,18497,76975,875183,3497189,6511
19075,"Grundy","Iowa",42.40183723,-92.78829551,19,0,0,19,"Grundy, Iowa, US",12232,-40,124,134,-10,0,-29,-29,4087,12868,119789,547520,1453
47061,"Grundy","Tennessee",35.38433717,-85.72142731,31,1,0,30,"Grundy, Tennessee, US",13427,79,158,177,-19,0,97,97,2725,4431,26336,112099,618
35019,"Guadalupe","New Mexico",34.86319296,-104.790669,19,0,0,19,"Guadalupe, New Mexico, US",4300,-34,41,43,-2,0,-32,-32,1280,4345,24345,101139,345
48187,"Guadalupe","Texas",29.58165339,-97.94786822,116,0,0,116,"Guadalupe, Texas, US",166847,3571,1840,1158,682,21,2866,2887,41057,158694,1496061,6308211,12070
39059,"Guernsey","Ohio",40.05026529,-81.49248905,30,0,0,30,"Guernsey, Ohio, US",38875,-136,426,462,-36,-1,-97,-98,15886,61928,502670,2157397,4568
37081,"Guilford","North Carolina",36.07959451,-79.78824948,1033,52,0,981,"Guilford, North Carolina, US",537174,4567,6111,4602,1509,1132,1947,3079,280078,1492438,16847209,67537127,80826
12045,"Gulf","Florida",29.93543004,-85.2427099,1,0,0,1,"Gulf, Florida, US",13639,-2507,112,186,-74,-2,-2461,-2463,4524,9350,61260,259027,1411
8051,"Gunnison","Colorado",38.66611652,-107.0320729,178,6,0,172,"Gunnison, Colorado, US",17462,295,130,70,60,7,226,233,9600,35194,242329,991725,6346
19077,"Guthrie","Iowa",41.68378965,-94.50111014,42,3,0,39,"Guthrie, Iowa, US",10689,-31,112,117,-5,5,-30,-25,3608,8587,67537,281594,1546
13135,"Gwinnett","Georgia",33.96044201,-84.02137802,2997,121,0,2876,"Gwinnett, Georgia, US",936250,8913,11368,4729,6639,2348,-59,2289,354476,1904124,23720667,95466420,142236
13137,"Habersham","Georgia",34.63331566,-83.53094677,488,19,0,469,"Habersham, Georgia, US",45328,-45,537,449,88,2,-134,-132,15853,46693,374109,1500653,4430
1065,"Hale","Alabama",32.76039258,-87.63284988,122,3,0,119,"Hale, Alabama, US",14651,-98,190,181,9,-3,-103,-106,2639,6636,53550,215511,767
48189,"Hale","Texas",34.07044901,-101.8268114,50,4,0,46,"Hale, Texas, US",33406,-225,427,299,128,0,-354,-354,13889,38280,309088,1311402,3678
37083,"Halifax","North Carolina",36.25669272,-77.6556109,147,1,0,146,"Halifax, North Carolina, US",50010,-624,540,706,-166,9,-468,-459,16048,58199,418874,1730254,5074
51083,"Halifax","Virginia",36.76654925,-78.93512622,29,0,0,29,"Halifax, Virginia, US",33911,-270,359,506,-147,-6,-115,-121,13199,39749,311314,1278976,3715
13139,"Hall","Georgia",34.32207823,-83.81896936,2305,41,0,2264,"Hall, Georgia, US",204441,2903,2586,1600,986,73,1830,1903,84225,393798,3958815,16888096,25622
31079,"Hall","Nebraska",40.87257079,-98.50218293,1460,39,0,1421,"Hall, Nebraska, US",61353,67,953,523,430,208,-572,-364,35317,140781,1208592,5099993,10767
48191,"Hall","Texas",34.5307555,-100.6813852,1,0,0,1,"Hall, Texas, US",2964,-61,24,27,-3,-1,-57,-58,1255,1125,7039,27943,202
47063,"Hamblen","Tennessee",36.21990035,-83.26586179,25,2,0,23,"Hamblen, Tennessee, US",64934,305,780,724,56,59,194,253,29940,132632,1148913,4719651,7258
12047,"Hamilton","Florida",30.49673973,-82.94998918,161,0,0,161,"Hamilton, Florida, US",14428,166,164,129,35,-2,132,130,3408,5513,42773,165501,760
17065,"Hamilton","Illinois",38.08163641,-88.53883373,2,0,0,2,"Hamilton, Illinois, US",8116,-32,78,102,-24,0,-7,-7,2300,4968,36680,155714,862
18057,"Hamilton","Indiana",40.07306535,-86.05244729,1092,91,0,1001,"Hamilton, Indiana, US",338011,7700,3832,1891,1941,792,4962,5754,127933,836832,11486933,43680500,53789
19079,"Hamilton","Iowa",42.38382428,-93.70197703,19,0,0,19,"Hamilton, Iowa, US",14773,-113,170,178,-8,1,-107,-106,6654,18427,155486,674744,1881
20075,"Hamilton","Kansas",37.99978709,-101.7921066,10,0,0,10,"Hamilton, Kansas, US",2539,-61,29,17,12,15,-88,-73,1310,1193,8281,34892,226
31081,"Hamilton","Nebraska",40.87349452,-98.02099117,54,10,0,44,"Hamilton, Nebraska, US",9324,64,106,84,22,-1,45,44,3948,10088,108308,432939,1538
36041,"Hamilton","New York",43.66146647,-74.49721957,5,0,0,5,"Hamilton, New York, US",4416,-16,28,63,-35,-2,20,18,1453,4343,23964,131225,959
39061,"Hamilton","Ohio",39.19673558,-84.54502924,2349,128,0,2221,"Hamilton, Ohio, US",817473,2028,10671,7868,2803,1071,-1811,-740,497491,2809075,40717902,159909829,125607
47065,"Hamilton","Tennessee",35.17670231,-85.16652245,511,14,0,497,"Hamilton, Tennessee, US",367804,3511,4213,3718,495,411,2595,3006,202284,1060040,11272493,45490245,53556
48193,"Hamilton","Texas",31.70470573,-98.11083887,7,0,0,7,"Hamilton, Texas, US",8461,-16,91,116,-25,6,4,10,2966,7219,52717,208377,958
46057,"Hamlin","South Dakota",44.67385954,-97.18829593,3,0,0,3,"Hamlin, South Dakota, US",6164,94,119,55,64,0,31,31,2159,4685,36875,174243,895
25013,"Hampden","Massachusetts",42.13440424,-72.63235561,5621,541,0,5080,"Hampden, Massachusetts, US",466372,-2016,4972,4536,436,367,-2820,-2453,203183,987441,11020127,44024377,56980
25015,"Hampshire","Massachusetts",42.33997957,-72.65898478,819,77,0,742,"Hampshire, Massachusetts, US",160830,-309,976,1306,-330,490,-469,21,76536,276971,2439922,10171726,20872
54027,"Hampshire","West Virginia",39.32103553,-78.60826476,13,1,0,12,"Hampshire, West Virginia, US",23175,-182,205,260,-55,-8,-118,-126,4662,10757,69630,282723,1583
45049,"Hampton","South Carolina",32.77419582,-81.13845571,31,0,0,31,"Hampton, South Carolina, US",19222,-126,196,239,-43,1,-84,-83,6623,12582,92007,455300,1616
51650,"Hampton","Virginia",37.03513786,-76.35879121,172,3,0,169,"Hampton, Virginia, US",134510,180,1686,1307,379,70,-264,-194,64911,215368,1988499,8369393,13527
13141,"Hancock","Georgia",33.2721566,-82.99766919,176,17,0,159,"Hancock, Georgia, US",8457,89,49,120,-71,4,155,159,1180,1249,8466,32936,227
17067,"Hancock","Illinois",40.40423981,-91.16313899,13,0,0,13,"Hancock, Illinois, US",17708,-120,178,198,-20,2,-102,-100,4799,12040,100661,437998,1927
18059,"Hancock","Indiana",39.82304555,-85.77566351,315,27,0,288,"Hancock, Indiana, US",78168,1690,846,631,215,18,1457,1475,21728,94347,1004431,3773411,7893
19081,"Hancock","Iowa",43.08178477,-93.73454884,12,0,0,12,"Hancock, Iowa, US",10630,-80,115,130,-15,1,-66,-65,5412,13207,115694,489459,1504
21091,"Hancock","Kentucky",37.83766422,-86.78280584,6,0,0,6,"Hancock, Kentucky, US",8722,-16,106,77,29,0,-47,-47,4648,13088,188610,777854,483
23009,"Hancock","Maine",44.59816444,-68.38401854,11,1,0,10,"Hancock, Maine, US",54987,253,448,665,-217,41,432,473,25208,86722,711332,3454904,13150
28045,"Hancock","Mississippi",30.41830223,-89.48851033,84,11,0,73,"Hancock, Mississippi, US",47632,354,453,473,-20,-22,394,372,17475,39515,382618,1568739,3762
39063,"Hancock","Ohio",41.00250487,-83.66838948,48,1,0,47,"Hancock, Ohio, US",75783,-137,881,722,159,98,-394,-296,45844,207392,2615370,9706701,9715
47067,"Hancock","Tennessee",36.52692871,-83.22375847,1,0,0,1,"Hancock, Tennessee, US",6620,59,68,93,-25,1,82,83,1302,1145,6744,31756,155
54029,"Hancock","West Virginia",40.51943859,-80.57461608,15,0,0,15,"Hancock, West Virginia, US",28810,-269,243,440,-197,-12,-59,-71,11775,32205,246095,1020368,2928
46059,"Hand","South Dakota",44.54708407,-99.00386459,1,0,0,1,"Hand, South Dakota, US",3191,-49,37,28,9,0,-59,-59,1655,3405,23250,110068,520
51085,"Hanover","Virginia",37.7583355,-77.49464673,252,19,0,233,"Hanover, Virginia, US",107766,880,966,907,59,23,806,829,44246,248301,2328303,9864167,18626
48195,"Hansford","Texas",36.27743284,-101.3545796,18,2,0,16,"Hansford, Texas, US",5399,-71,74,35,39,23,-135,-112,2391,3981,42369,172369,672
13143,"Haralson","Georgia",33.79602175,-85.21005667,36,2,0,34,"Haralson, Georgia, US",29792,231,350,347,3,-5,235,230,8820,19678,173129,881942,2228
12049,"Hardee","Florida",27.49293939,-81.80956574,63,0,0,63,"Hardee, Florida, US",26937,-231,339,193,146,-2,-376,-378,8679,18569,146966,579826,1955
47069,"Hardeman","Tennessee",35.20772017,-88.99161161,188,0,0,188,"Hardeman, Tennessee, US",25050,-226,218,289,-71,0,-155,-155,7069,17590,136261,558235,1654
17069,"Hardin","Illinois",37.51810645,-88.26873022,1,0,0,1,"Hardin, Illinois, US",3821,-72,31,65,-34,0,-38,-38,1111,1657,13358,56354,213
19083,"Hardin","Iowa",42.38353877,-93.23654611,13,0,0,13,"Hardin, Iowa, US",16846,-91,169,210,-41,10,-58,-48,7976,25471,222083,973358,2956
21093,"Hardin","Kentucky",37.6976111,-85.96319251,96,2,0,94,"Hardin, Kentucky, US",110958,679,1443,972,471,-59,271,212,55397,178383,1514642,6359760,11957
39065,"Hardin","Ohio",40.66015414,-83.65929931,38,0,0,38,"Hardin, Ohio, US",31365,-53,374,327,47,-1,-100,-101,10170,24580,179386,735425,2285
47071,"Hardin","Tennessee",35.19732531,-88.18593755,11,2,0,9,"Hardin, Tennessee, US",25652,-41,237,356,-119,13,67,80,8621,27543,230942,983888,2529
48199,"Hardin","Texas",30.33364686,-94.38931817,121,4,0,117,"Hardin, Texas, US",57602,495,661,595,66,-3,434,431,12400,46627,391976,1616067,4425
35021,"Harding","New Mexico",35.85751555,-103.8220938,1,0,0,1,"Harding, New Mexico, US",625,-25,2,9,-7,0,-18,-18,242,38,212,896,16
54031,"Hardy","West Virginia",39.00683177,-78.85855301,35,0,0,35,"Hardy, West Virginia, US",13776,12,147,162,-15,7,21,28,5989,16721,121358,526922,1350
24025,"Harford","Maryland",39.55010644,-76.3077594,764,46,0,718,"Harford, Maryland, US",255441,1559,2601,2250,351,136,1096,1232,98565,409189,4215275,17837694,32528
21095,"Harlan","Kentucky",36.85699301,-83.21899516,1,0,0,1,"Harlan, Kentucky, US",26010,-299,298,400,-102,0,-197,-197,8151,19202,146486,619380,2001
31083,"Harlan","Nebraska",40.17658508,-99.40438879,1,0,0,1,"Harlan, Nebraska, US",3380,-6,31,39,-8,0,3,3,1324,2244,15414,63495,419
37085,"Harnett","North Carolina",35.36731853,-78.87243571,269,21,0,248,"Harnett, North Carolina, US",135976,1640,1873,1105,768,29,836,865,26812,108350,768730,3173853,9575
41025,"Harney","Oregon",43.06422669,-118.9666306,1,0,0,1,"Harney, Oregon, US",7393,101,63,78,-15,5,110,115,2887,5696,37998,168855,969
20077,"Harper","Kansas",37.19175361,-98.07578384,1,0,0,1,"Harper, Kansas, US",5436,-72,57,91,-34,2,-40,-38,2842,5466,42169,180275,923
40059,"Harper","Oklahoma",36.78836519,-99.6679804,1,0,0,1,"Harper, Oklahoma, US",3688,-39,39,52,-13,20,-45,-25,1591,1536,11234,46314,338
13145,"Harris","Georgia",32.73709786,-84.90538572,80,4,0,76,"Harris, Georgia, US",35236,676,307,332,-25,-2,707,705,5838,15954,95398,384301,2195
48201,"Harris","Texas",29.86,-95.39,10770,219,0,10551,"Harris, Texas, US",4713325,33280,66937,28172,38765,24889,-30449,-5560,2348073,12202448,211568973,781300899,612568
18061,"Harrison","Indiana",38.19467379,-86.10948271,183,21,0,162,"Harrison, Indiana, US",40515,301,426,368,58,20,224,244,11273,33783,253422,1057962,3670
19085,"Harrison","Iowa",41.68330137,-95.81558439,18,0,0,18,"Harrison, Iowa, US",14049,-56,154,181,-27,-1,-28,-29,4596,12879,100974,423895,1736
21097,"Harrison","Kentucky",38.44188174,-84.32869741,18,0,0,18,"Harrison, Kentucky, US",18886,106,234,218,16,-2,94,92,4918,14548,123014,474235,1310
28047,"Harrison","Mississippi",30.51359752,-89.12467576,231,6,0,225,"Harrison, Mississippi, US",208080,1796,2597,2013,584,120,1088,1208,98787,426077,3865772,15813570,24514
29081,"Harrison","Missouri",40.35570088,-93.99222144,8,0,0,8,"Harrison, Missouri, US",8352,-42,86,114,-28,-3,-10,-13,3424,6926,38877,162068,888
39067,"Harrison","Ohio",40.29380509,-81.09068544,10,0,0,10,"Harrison, Ohio, US",15040,-127,144,203,-59,1,-69,-68,5185,10304,90905,411232,1287
48203,"Harrison","Texas",32.54935988,-94.36934071,217,22,0,195,"Harrison, Texas, US",66553,-31,725,701,24,40,-93,-53,23370,82592,842118,3374285,7026
54033,"Harrison","West Virginia",39.2853852,-80.37919577,38,1,0,37,"Harrison, West Virginia, US",67256,-238,696,877,-181,-5,-47,-52,36540,142076,1416827,5813760,10483
51660,"Harrisonburg","Virginia",38.43542574,-78.87536254,709,21,0,688,"Harrisonburg, Virginia, US",53016,-472,580,283,297,219,-994,-775,32688,126423,973291,4032888,9088
13147,"Hart","Georgia",34.34626973,-82.96567682,26,0,0,26,"Hart, Georgia, US",26205,134,249,312,-63,-2,199,197,7044,20281,161146,663142,1984
21099,"Hart","Kentucky",37.29943898,-85.88461055,20,0,0,20,"Hart, Kentucky, US",19035,133,276,191,85,0,47,47,5378,14239,100267,409274,1334
9003,"Hartford","Connecticut",41.80283011,-72.73103891,9545,1169,0,8376,"Hartford, Connecticut, US",891720,-860,9126,8275,851,3454,-5188,-1734,502938,2701888,44638641,163579070,136726
48205,"Hartley","Texas",35.84008013,-102.6029022,11,2,0,9,"Hartley, Texas, US",5576,-35,64,25,39,13,-85,-72,2339,4125,35461,156114,518
20079,"Harvey","Kansas",38.04293782,-97.42747573,11,0,0,11,"Harvey, Kansas, US",34429,246,372,332,40,37,172,209,15049,53338,436479,1738139,4045
20081,"Haskell","Kansas",37.5620394,-100.8710738,17,0,0,17,"Haskell, Kansas, US",3968,-22,49,21,28,3,-53,-50,2080,2917,27907,113540,497
40061,"Haskell","Oklahoma",35.222576,-95.11513306,6,0,0,6,"Haskell, Oklahoma, US",12627,-9,120,136,-16,6,3,9,3913,8608,61647,265765,991
48207,"Haskell","Texas",33.17823584,-99.73037358,2,0,0,2,"Haskell, Texas, US",5658,-41,42,66,-24,36,-52,-16,2004,3696,26816,98890,629
15001,"Hawaii","Hawaii",19.60121157,-155.5210167,81,0,0,81,"Hawaii, Hawaii, US",201513,4,2237,2003,234,427,-643,-216,79833,320639,3019582,12413518,24268
47073,"Hawkins","Tennessee",36.44355426,-82.94885298,31,2,0,29,"Hawkins, Tennessee, US",56786,73,511,731,-220,15,280,295,12778,43497,367565,1457172,3223
48209,"Hays","Texas",30.05669873,-98.02944344,250,3,0,247,"Hays, Texas, US",230191,7485,2638,1147,1491,212,5751,5963,65919,323919,2553280,10817155,24990
37087,"Haywood","North Carolina",35.55269063,-82.98196486,39,0,0,39,"Haywood, North Carolina, US",62317,427,587,766,-179,-23,630,607,19958,73547,536874,2329861,7720
47075,"Haywood","Tennessee",35.58332824,-89.28536625,29,2,0,27,"Haywood, Tennessee, US",17304,-43,189,233,-44,-1,2,1,5193,16305,135333,531874,1512
13149,"Heard","Georgia",33.29686567,-85.12886832,26,2,0,24,"Heard, Georgia, US",11923,52,125,128,-3,-2,57,55,2002,3139,36366,140116,502
48211,"Hemphill","Texas",35.83764858,-100.2703577,1,0,0,1,"Hemphill, Texas, US",3819,-26,43,20,23,1,-49,-48,2643,5499,80098,295941,612
5057,"Hempstead","Arkansas",33.73325583,-93.66935133,13,1,0,12,"Hempstead, Arkansas, US",21532,-153,291,233,58,-13,-199,-212,9049,21570,153555,624238,1917
17071,"Henderson","Illinois",40.81908672,-90.92491462,8,0,0,8,"Henderson, Illinois, US",6646,-51,63,95,-32,1,-18,-17,1471,2622,15961,71820,478
21101,"Henderson","Kentucky",37.79344553,-87.57392021,95,3,0,92,"Henderson, Kentucky, US",45210,-302,521,520,1,-5,-297,-302,19000,70529,674082,2692587,5412
37089,"Henderson","North Carolina",35.33788927,-82.4766782,313,42,0,271,"Henderson, North Carolina, US",117417,917,1066,1426,-360,-20,1296,1276,39794,169918,1475830,6204949,15797
47077,"Henderson","Tennessee",35.65581134,-88.38600175,12,0,0,12,"Henderson, Tennessee, US",28117,134,305,309,-4,-3,143,140,9243,28344,200318,822455,2586
48213,"Henderson","Texas",32.21128872,-95.85846587,51,0,0,51,"Henderson, Texas, US",82737,634,894,1105,-211,9,836,845,21055,65632,514760,2201044,7375
18063,"Hendricks","Indiana",39.76719009,-86.51037283,1103,65,0,1038,"Hendricks, Indiana, US",170311,3403,1731,1139,592,273,2539,2812,58425,315069,2716110,11770015,19190
12051,"Hendry","Florida",26.55386945,-81.16469006,249,12,0,237,"Hendry, Florida, US",42022,686,576,356,220,341,126,467,14566,26984,201361,817694,3005
27053,"Hennepin","Minnesota",45.00761521,-93.47694895,6649,524,0,6125,"Hennepin, Minnesota, US",1265843,7918,16008,8750,7258,3649,-2922,727,863170,5328981,89938580,339651025,244745
51087,"Henrico","Virginia",37.53460572,-77.39326555,1411,118,0,1293,"Henrico, Virginia, US",330818,1825,3862,2832,1030,918,-113,805,168351,992967,14246122,51052533,56163
1067,"Henry","Alabama",31.51148016,-85.24267944,52,1,0,51,"Henry, Alabama, US",17205,32,167,213,-46,-1,79,78,4181,10263,89707,413363,1399
13151,"Henry","Georgia",33.4533428,-84.1481466,626,19,0,607,"Henry, Georgia, US",234561,4833,2602,1679,923,26,3894,3920,60065,276335,2223381,9324783,22090
17073,"Henry","Illinois",41.3533994,-90.13296166,66,0,0,66,"Henry, Illinois, US",48913,-156,479,543,-64,-1,-88,-89,15145,57662,504991,2029488,5761
18065,"Henry","Indiana",39.93029017,-85.39625719,155,6,0,149,"Henry, Indiana, US",47972,-159,448,549,-101,4,-60,-56,13572,52668,376712,1526532,4417
19087,"Henry","Iowa",40.98767962,-91.54436349,57,1,0,56,"Henry, Iowa, US",19954,-79,215,183,32,6,-117,-111,8822,27653,233387,1000696,2439
21103,"Henry","Kentucky",38.44942688,-85.11587507,14,0,0,14,"Henry, Kentucky, US",16126,65,181,166,15,0,51,51,3518,7719,53274,227822,1032
29083,"Henry","Missouri",38.38482826,-93.79293734,9,3,0,6,"Henry, Missouri, US",21824,16,236,290,-54,-6,76,70,8539,25659,185549,789829,2880
39069,"Henry","Ohio",41.3339642,-84.06830637,14,0,0,14,"Henry, Ohio, US",27006,-85,313,262,51,0,-137,-137,10729,36506,316433,1339991,2903
47079,"Henry","Tennessee",36.33160906,-88.30121797,29,0,0,29,"Henry, Tennessee, US",32345,9,300,481,-181,-5,197,192,12130,37229,287271,1216540,3649
51089,"Henry","Virginia",36.68542395,-79.87634026,63,2,0,61,"Henry, Virginia, US",50557,-493,400,744,-344,-4,-143,-147,16743,47085,352859,1429546,4292
36043,"Herkimer","New York",43.42034246,-74.96145307,100,3,0,97,"Herkimer, New York, US",61319,-394,560,659,-99,2,-297,-295,18739,56320,440061,1926421,6218
12053,"Hernando","Florida",28.55364461,-82.42700204,109,5,0,104,"Hernando, Florida, US",193920,3338,1597,2850,-1253,50,4530,4580,43480,186571,1451913,5926923,19316
37091,"Hertford","North Carolina",36.3607755,-76.98104134,65,1,0,64,"Hertford, North Carolina, US",23677,-201,224,287,-63,36,-174,-138,9298,29668,231636,966730,2456
21105,"Hickman","Kentucky",36.6794808,-88.97875928,5,0,0,5,"Hickman, Kentucky, US",4380,-51,35,63,-28,0,-24,-24,1634,1997,15003,60309,243
47081,"Hickman","Tennessee",35.80609681,-87.47643507,54,0,0,54,"Hickman, Tennessee, US",25178,171,255,283,-28,-7,207,200,4347,9492,68754,297078,1338
35023,"Hidalgo","New Mexico",31.91383467,-108.7151824,1,0,0,1,"Hidalgo, New Mexico, US",4198,-33,41,51,-10,1,-24,-23,1872,3258,17579,71686,458
48215,"Hidalgo","Texas",26.39418217,-98.18299696,482,10,0,472,"Hidalgo, Texas, US",868707,6409,14054,4597,9457,-18,-3038,-3056,279551,1168210,7940706,32466580,72182
39071,"Highland","Ohio",39.1839264,-83.60331456,18,1,0,17,"Highland, Ohio, US",43161,109,530,482,48,-1,65,64,11748,37002,313413,1185316,3587
51091,"Highland","Virginia",38.35799465,-79.56124594,3,0,0,3,"Highland, Virginia, US",2190,-18,17,31,-14,0,-4,-4,898,967,5556,24304,272
12055,"Highlands","Florida",27.34254618,-81.34071957,112,8,0,104,"Highlands, Florida, US",106221,1288,854,1627,-773,258,1799,2057,29640,107290,837632,3391067,10995
30041,"Hill","Montana",48.62879827,-110.1129252,1,0,0,1,"Hill, Montana, US",16484,142,289,161,128,7,7,14,7781,21896,160702,672196,2652
48217,"Hill","Texas",31.99045053,-97.13423143,23,1,0,22,"Hill, Texas, US",36649,484,404,427,-23,-4,510,506,10227,34501,266319,1114590,3362
12057,"Hillsborough","Florida",27.9276559,-82.32013172,1823,72,0,1751,"Hillsborough, Florida, US",1471968,20049,17267,11696,5571,5266,9183,14449,662689,3540906,46361637,179227542,220357
33011,"Hillsborough","New Hampshire",42.91537785,-71.7200253,2049,81,0,1968,"Hillsborough, New Hampshire, US",417025,2395,4148,3390,758,1002,650,1652,195329,1074815,14595344,59295202,65557
26059,"Hillsdale","Michigan",41.88753639,-84.59312019,168,24,0,144,"Hillsdale, Michigan, US",45605,-97,509,480,29,2,-129,-127,15943,45507,409022,1674995,3940
28049,"Hinds","Mississippi",32.2656285,-90.44435448,877,24,0,853,"Hinds, Mississippi, US",231840,-3984,2953,2122,831,187,-5018,-4831,121456,560708,6347387,25160460,30708
8053,"Hinsdale","Colorado",37.82247444,-107.3004345,3,0,0,3,"Hinsdale, Colorado, US",820,12,2,3,-1,0,13,13,411,332,2607,15243,239
31087,"Hitchcock","Nebraska",40.17609175,-101.0416477,1,0,0,1,"Hitchcock, Nebraska, US",2762,-39,20,37,-17,0,-22,-22,921,1135,8678,42795,246
39073,"Hocking","Ohio",39.49537927,-82.47991446,64,3,0,61,"Hocking, Ohio, US",28264,-93,289,331,-42,3,-52,-49,8049,22780,147454,632313,2440
48219,"Hockley","Texas",33.60771256,-102.3431676,27,1,0,26,"Hockley, Texas, US",23021,50,306,201,105,-1,-54,-55,10145,30208,356329,1553506,2564
20083,"Hodgeman","Kansas",38.08780079,-99.89829881,1,0,0,1,"Hodgeman, Kansas, US",1794,-28,17,25,-8,6,-27,-21,850,464,3458,13585,132
37093,"Hoke","North Carolina",35.01888303,-79.23651674,187,1,0,186,"Hoke, North Carolina, US",55234,539,847,362,485,4,50,54,9817,23323,156852,641213,2331
12059,"Holmes","Florida",30.86747479,-85.81319222,14,0,0,14,"Holmes, Florida, US",19617,174,198,250,-52,-3,228,225,3520,7998,49255,207926,1246
28051,"Holmes","Mississippi",33.12345854,-90.08923538,359,23,0,336,"Holmes, Mississippi, US",17010,-434,219,221,-2,0,-431,-431,3596,7860,48132,195263,1184
39075,"Holmes","Ohio",40.56163713,-81.92635677,22,1,0,21,"Holmes, Ohio, US",43960,41,783,327,456,-2,-415,-417,21031,99306,786633,3533545,7199
29087,"Holt","Missouri",40.09799248,-95.2163888,1,0,0,1,"Holt, Missouri, US",4403,-9,43,57,-14,0,6,6,1825,2979,23468,96644,520
31089,"Holt","Nebraska",42.45522056,-98.78402558,1,0,0,1,"Holt, Nebraska, US",10067,-81,139,120,19,6,-107,-101,5586,14703,111557,478748,2099
15003,"Honolulu","Hawaii",21.45803166,-157.9712182,414,11,0,403,"Honolulu, Hawaii, US",974563,-5295,12013,8595,3418,3736,-12427,-8691,486682,2155027,24875344,99841401,129399
48221,"Hood","Texas",32.42990927,-97.83242024,23,3,0,20,"Hood, Texas, US",61643,1466,627,736,-109,2,1565,1567,17862,68030,587649,2433558,7397
41027,"Hood River","Oregon",45.51872811,-121.6552036,12,0,0,12,"Hood River, Oregon, US",23382,115,250,171,79,1,35,36,12203,51724,381323,1683045,5758
31091,"Hooker","Nebraska",41.91586243,-101.1354293,0,0,0,0,"Hooker, Nebraska, US",682,6,6,7,-1,0,7,7,421,150,1020,6171,67
51670,"Hopewell","Virginia",37.29186313,-77.29754684,67,0,0,67,"Hopewell, Virginia, US",22529,51,347,296,51,27,-25,2,7624,26455,287635,1203229,2079
21107,"Hopkins","Kentucky",37.30939025,-87.54670406,218,28,0,190,"Hopkins, Kentucky, US",44686,-338,525,545,-20,7,-325,-318,18576,58457,535187,2116628,5315
48223,"Hopkins","Texas",33.14875072,-95.56351139,12,0,0,12,"Hopkins, Texas, US",37084,346,444,386,58,-9,296,287,13147,46344,380306,1566507,4047
45051,"Horry","South Carolina",33.9212828,-78.99555293,371,21,0,350,"Horry, South Carolina, US",354081,9976,3161,3879,-718,293,10315,10608,128131,655408,4639924,20405346,54034
5059,"Hot Spring","Arkansas",34.31709259,-92.95396325,29,0,0,29,"Hot Spring, Arkansas, US",33771,99,361,379,-18,-1,119,118,9819,25559,200408,838232,2583
56017,"Hot Springs","Wyoming",43.71930657,-108.4423174,9,0,0,9,"Hot Springs, Wyoming, US",4413,-155,37,71,-34,1,-122,-121,2081,5911,47290,207678,808
26061,"Houghton","Michigan",46.89988536,-88.68495385,2,0,0,2,"Houghton, Michigan, US",35684,-259,358,348,10,64,-335,-271,14675,43235,326423,1357514,4742
1069,"Houston","Alabama",31.15197924,-85.29939599,161,4,0,157,"Houston, Alabama, US",105882,1112,1304,1137,167,11,936,947,50383,226063,1975028,8469761,15717
13153,"Houston","Georgia",32.45802497,-83.66879087,342,16,0,326,"Houston, Georgia, US",157863,2340,1958,1284,674,141,1528,1669,65861,195279,1564019,6342281,14767
27055,"Houston","Minnesota",43.67129565,-91.49143057,2,0,0,2,"Houston, Minnesota, US",18600,28,204,196,8,0,23,23,5891,17676,114415,510216,2075
47083,"Houston","Tennessee",36.28872054,-87.71878828,7,0,0,7,"Houston, Tennessee, US",8201,-33,80,93,-13,-1,-18,-19,1821,3454,22931,100091,435
48225,"Houston","Texas",31.31925973,-95.42226208,81,0,0,81,"Houston, Texas, US",22968,-100,209,300,-91,6,-14,-8,7241,14094,111503,448735,1606
5061,"Howard","Arkansas",34.09007427,-93.9934871,15,0,0,15,"Howard, Arkansas, US",13202,-100,172,171,1,-2,-99,-101,7364,18131,142197,555539,1315
18067,"Howard","Indiana",40.48527731,-86.11351892,344,17,0,327,"Howard, Indiana, US",82544,287,946,950,-4,37,261,298,39930,142215,1218916,4976604,10164
19089,"Howard","Iowa",43.35671042,-92.31702714,12,0,0,12,"Howard, Iowa, US",9158,-14,117,120,-3,-4,-6,-10,4359,11266,76088,341867,1178
24027,"Howard","Maryland",39.25305293,-76.93126208,1638,52,0,1586,"Howard, Maryland, US",325690,3069,3447,1845,1602,779,710,1489,158635,1034589,16325350,64936942,56669
29089,"Howard","Missouri",39.1435761,-92.69756691,3,0,0,3,"Howard, Missouri, US",10001,-58,107,87,20,0,-78,-78,2684,7034,40097,176578,865
31093,"Howard","Nebraska",41.2200529,-98.5166499,39,0,0,39,"Howard, Nebraska, US",6445,-12,72,59,13,0,-25,-25,1849,3952,28534,126186,786
48227,"Howard","Texas",32.30621324,-101.4356444,6,1,0,5,"Howard, Texas, US",36664,739,438,349,89,81,568,649,14190,42133,426935,1794642,3913
29091,"Howell","Missouri",36.77383887,-91.88683935,5,0,0,5,"Howell, Missouri, US",40117,-9,504,508,-4,9,-11,-2,17621,59142,429707,1839278,5968
27057,"Hubbard","Minnesota",47.10778564,-94.91693868,1,0,0,1,"Hubbard, Minnesota, US",21491,200,216,199,17,2,182,184,7215,19605,140154,648157,3011
34017,"Hudson","New Jersey",40.73766234,-74.07515667,18959,1138,0,17821,"Hudson, New Jersey, US",672391,460,10019,4371,5648,5294,-10458,-5164,276572,1319484,27461527,96324371,80756
8055,"Huerfano","Colorado",37.68473101,-104.9612585,3,0,0,3,"Huerfano, Colorado, US",6897,10,48,96,-48,4,54,58,2158,4108,26695,115607,631
46065,"Hughes","South Dakota",44.39091534,-99.99661148,17,0,0,17,"Hughes, South Dakota, US",17526,-157,228,161,67,-2,-223,-225,10171,31218,268974,1100067,3564
6023,"Humboldt","California",40.69923009,-123.876044,93,2,0,91,"Humboldt, California, US",135558,-686,1352,1390,-38,-17,-625,-642,56968,196014,1671478,7122659,18617
19091,"Humboldt","Iowa",42.7764426,-94.20722537,11,0,0,11,"Humboldt, Iowa, US",9558,-1,107,106,1,5,-7,-2,4119,14097,123512,512738,1449
32013,"Humboldt","Nevada",41.40692186,-118.1109427,78,4,0,74,"Humboldt, Nevada, US",16831,53,221,112,109,-1,-55,-56,8355,28288,411308,1523891,1916
28053,"Humphreys","Mississippi",33.12825718,-90.52252707,52,7,0,45,"Humphreys, Mississippi, US",8064,-192,94,109,-15,2,-178,-176,2072,4133,24002,102169,621
47085,"Humphreys","Tennessee",36.03958805,-87.77992872,12,1,0,11,"Humphreys, Tennessee, US",18582,31,230,254,-24,-4,59,55,6546,17713,208198,853907,1550
48231,"Hunt","Texas",33.12351514,-96.08551032,71,3,0,68,"Hunt, Texas, US",98594,1988,1206,981,225,73,1686,1759,31096,102782,1080219,4312216,8484
34019,"Hunterdon","New Jersey",40.56335249,-74.91284156,938,57,0,881,"Hunterdon, New Jersey, US",124371,-436,972,1009,-37,63,-460,-397,56438,251953,3898646,15011075,22249
42061,"Huntingdon","Pennsylvania",40.42162652,-77.97673273,227,1,0,226,"Huntingdon, Pennsylvania, US",45144,-251,354,532,-178,35,-107,-72,15018,43675,302567,1319450,4507
18069,"Huntington","Indiana",40.82907273,-85.48822092,22,2,0,20,"Huntington, Indiana, US",36520,277,411,390,21,20,238,258,15514,51312,390176,1604612,4808
26063,"Huron","Michigan",43.83353985,-83.04078453,42,1,0,41,"Huron, Michigan, US",30981,-230,310,445,-135,11,-103,-92,14190,48176,415085,1837604,5102
39077,"Huron","Ohio",41.14651175,-82.59867951,49,1,0,48,"Huron, Ohio, US",58266,-98,698,589,109,-4,-202,-206,23411,81693,758423,3193676,6095
46067,"Hutchinson","South Dakota",43.33449012,-97.75536441,3,0,0,3,"Hutchinson, South Dakota, US",7291,-15,109,94,15,1,-30,-29,3196,8558,61122,272199,1105
48233,"Hutchinson","Texas",35.84006574,-101.3546643,31,0,0,31,"Hutchinson, Texas, US",20938,-181,256,215,41,2,-226,-224,9799,25709,339698,1303218,2276
37095,"Hyde","North Carolina",35.42017674,-76.15180542,1,0,0,1,"Hyde, North Carolina, US",4937,-89,33,49,-16,-1,-72,-73,2149,3189,18916,108132,686
46069,"Hyde","South Dakota",44.54747703,-99.48572582,1,0,0,1,"Hyde, South Dakota, US",1301,30,18,9,9,0,21,21,811,925,8428,35927,130
22045,"Iberia","Louisiana",29.86803617,-91.75871777,388,35,0,353,"Iberia, Louisiana, US",69830,-1075,914,777,137,6,-1221,-1215,32050,116521,1197833,5084774,9001
22047,"Iberville","Louisiana",30.25734305,-91.3499598,541,39,0,502,"Iberville, Louisiana, US",32511,-182,351,313,38,-8,-211,-219,16163,51103,1092201,3900398,2748
19093,"Ida","Iowa",42.38696136,-95.51355387,9,0,0,9,"Ida, Iowa, US",6860,14,68,103,-35,1,50,51,4180,11033,107721,439081,1141
16049,"Idaho","Idaho",45.84721541,-115.4634436,3,0,0,3,"Idaho, Idaho, US",16667,191,149,179,-30,1,219,220,5953,14290,105887,470451,2395
6025,"Imperial","California",33.0393082,-115.3669042,1145,23,0,1122,"Imperial, California, US",181215,-308,2728,1079,1649,33,-2000,-1967,57000,168124,1332658,5496726,14607
5063,"Independence","Arkansas",35.74242707,-91.57001641,29,0,0,29,"Independence, Arkansas, US",37825,57,513,430,83,-7,-17,-24,16747,59366,478438,1978892,4139
12061,"Indian River","Florida",27.69308961,-80.60556721,113,9,0,104,"Indian River, Florida, US",159923,2736,1283,2177,-894,205,3407,3612,51988,261448,2390931,9794251,25398
42063,"Indiana","Pennsylvania",40.65241041,-79.08963285,89,5,0,84,"Indiana, Pennsylvania, US",84073,-368,760,896,-136,50,-281,-231,37312,123420,1062126,4508243,10356
26065,"Ingham","Michigan",42.59716886,-84.37472069,695,25,0,670,"Ingham, Michigan, US",292406,794,3181,2246,935,1294,-1437,-143,163246,588548,6589851,26093271,36328
6027,"Inyo","California",36.51112084,-117.4111978,19,1,0,18,"Inyo, California, US",18039,93,191,172,19,18,57,75,8490,21867,163782,707889,2502
26067,"Ionia","Michigan",42.94502238,-85.07413319,141,3,0,138,"Ionia, Michigan, US",64697,421,707,550,157,5,259,264,17748,52558,429206,1824698,4873
26069,"Iosco","Michigan",44.35486835,-83.63484895,77,9,0,68,"Iosco, Michigan, US",25127,24,233,385,-152,-4,182,178,9366,26674,190345,830657,3238
19095,"Iowa","Iowa",41.68630265,-92.0643373,32,0,0,32,"Iowa, Iowa, US",16184,29,182,182,0,-2,34,32,8824,29638,228170,1010972,2413
55049,"Iowa","Wisconsin",43.00050278,-90.13469017,11,0,0,11,"Iowa, Wisconsin, US",23678,-44,248,190,58,3,-103,-100,11272,31708,271257,1206641,2913
37097,"Iredell","North Carolina",35.80950511,-80.8743128,219,6,0,213,"Iredell, North Carolina, US",181806,3474,1872,1685,187,165,3116,3281,71595,365764,3984577,15833660,28077
29093,"Iron","Missouri",37.55487945,-90.7735296,2,0,0,2,"Iron, Missouri, US",10125,-62,98,152,-54,2,-9,-7,3605,7401,50904,210294,1040
55051,"Iron","Wisconsin",46.26302338,-90.24295041,2,1,0,1,"Iron, Wisconsin, US",5687,0,33,91,-58,0,58,58,1964,4784,26481,118288,840
17075,"Iroquois","Illinois",40.74717633,-87.82466784,128,4,0,124,"Iroquois, Illinois, US",27114,-370,292,359,-67,-2,-302,-304,10254,26855,200796,880600,3579
13155,"Irwin","Georgia",31.60213036,-83.27501387,23,1,0,22,"Irwin, Georgia, US",9416,20,104,114,-10,-1,31,30,2190,3429,22041,95185,403
26073,"Isabella","Michigan",43.64060976,-84.84664923,70,7,0,63,"Isabella, Michigan, US",69872,-591,660,460,200,121,-921,-800,34570,116006,912041,3865398,7597
27059,"Isanti","Minnesota",45.56181234,-93.29487636,24,0,0,24,"Isanti, Minnesota, US",40596,646,448,327,121,13,512,525,11766,41358,334093,1414882,4624
53029,"Island","Washington",48.14713305,-122.5216407,177,10,0,167,"Island, Washington, US",85141,914,916,762,154,59,700,759,26116,63528,515656,2259441,10264
51093,"Isle of Wight","Virginia",36.90579348,-76.70842863,124,3,0,121,"Isle of Wight, Virginia, US",37109,137,376,397,-21,7,156,163,10267,33609,367256,1273546,3524
27061,"Itasca","Minnesota",47.51009045,-93.63092229,51,6,0,45,"Itasca, Minnesota, US",45130,79,441,502,-61,8,136,144,18384,60731,485421,2151359,6472
28057,"Itawamba","Mississippi",34.27993475,-88.3606733,82,7,0,75,"Itawamba, Mississippi, US",23390,-71,257,254,3,8,-80,-72,6151,23704,188104,772484,1838
5065,"Izard","Arkansas",36.09604046,-91.90847954,14,0,0,14,"Izard, Arkansas, US",13629,47,119,188,-69,2,113,115,4091,8771,55486,226971,1028
48237,"Jack","Texas",33.23377248,-98.17283469,4,0,0,4,"Jack, Texas, US",8935,110,82,76,6,0,102,102,3359,6928,84459,333403,1034
1071,"Jackson","Alabama",34.78144169,-85.99750489,69,2,0,67,"Jackson, Alabama, US",51626,5,562,675,-113,-7,128,121,17703,53846,394677,1645438,4531
5067,"Jackson","Arkansas",35.59802983,-91.21494602,1,0,0,1,"Jackson, Arkansas, US",16719,-34,187,206,-19,-2,-12,-14,5545,13420,115672,448286,1481
12063,"Jackson","Florida",30.7954597,-85.21500423,225,0,0,225,"Jackson, Florida, US",46414,-1698,502,636,-134,29,-1606,-1577,14942,40739,310305,1237715,4224
13157,"Jackson","Georgia",34.13794553,-83.56814788,147,4,0,143,"Jackson, Georgia, US",72977,2652,918,614,304,26,2311,2337,21995,111465,996211,4405175,7364
17077,"Jackson","Illinois",37.78595185,-89.38232563,207,10,0,197,"Jackson, Illinois, US",56750,-539,614,496,118,184,-845,-661,28546,83092,634558,2606969,7152
18071,"Jackson","Indiana",38.9091582,-86.03851889,353,1,0,352,"Jackson, Indiana, US",44231,163,591,456,135,114,-85,29,21383,79283,746276,3064170,5494
19097,"Jackson","Iowa",42.17178824,-90.57354837,11,0,0,11,"Jackson, Iowa, US",19439,12,223,231,-8,2,20,22,6779,20933,151247,672026,2719
20085,"Jackson","Kansas",39.41673394,-95.79356799,84,0,0,84,"Jackson, Kansas, US",13171,-99,173,131,42,-3,-138,-141,4316,10395,69689,277938,1202
21109,"Jackson","Kentucky",37.41866422,-83.99825483,60,13,0,47,"Jackson, Kentucky, US",13329,-74,154,168,-14,-1,-60,-61,2500,2328,15765,65258,313
22049,"Jackson","Louisiana",32.30251776,-92.55692092,82,10,0,72,"Jackson, Louisiana, US",15744,-168,160,220,-60,-3,-104,-107,3224,9315,66435,273491,1131
26075,"Jackson","Michigan",42.24807035,-84.42258681,432,26,0,406,"Jackson, Michigan, US",158510,-56,1743,1623,120,30,-200,-170,60114,247019,2549318,10615860,16764
27063,"Jackson","Minnesota",43.67423373,-95.15398258,38,0,0,38,"Jackson, Minnesota, US",9846,-49,98,109,-11,7,-45,-38,5604,14776,104183,452453,1376
28059,"Jackson","Mississippi",30.54020656,-88.64184064,296,13,0,283,"Jackson, Mississippi, US",143617,490,1588,1430,158,76,262,338,55065,182341,1926784,7473978,13250
29095,"Jackson","Missouri",39.01002188,-94.34724536,495,16,0,479,"Jackson, Missouri, US",703011,2227,8996,6497,2499,602,-845,-243,379713,1992641,25251785,101133796,106959
37099,"Jackson","North Carolina",35.28814273,-83.14093385,27,1,0,26,"Jackson, North Carolina, US",43938,338,362,371,-9,81,267,348,18708,53903,395856,1781376,5290
39079,"Jackson","Ohio",39.01914254,-82.6181856,11,0,0,11,"Jackson, Ohio, US",32413,47,408,401,7,12,30,42,11270,36026,243465,967193,3259
40065,"Jackson","Oklahoma",34.58781741,-99.41138784,21,1,0,20,"Jackson, Oklahoma, US",24530,-245,359,215,144,45,-434,-389,11924,27825,205879,840667,2697
41029,"Jackson","Oregon",42.43201126,-122.7289309,56,0,0,56,"Jackson, Oregon, US",220944,1533,2251,2325,-74,-41,1652,1611,86124,416083,3723301,16282348,37572
47087,"Jackson","Tennessee",36.36380466,-85.67239905,16,0,0,16,"Jackson, Tennessee, US",11786,9,94,163,-69,1,77,78,1996,2339,13982,64328,373
48239,"Jackson","Texas",28.95472367,-96.57749563,16,1,0,15,"Jackson, Texas, US",14760,-74,221,155,66,11,-151,-140,5719,15513,150909,625840,1606
54035,"Jackson","West Virginia",38.84263974,-81.68148753,135,18,0,117,"Jackson, West Virginia, US",28576,-119,276,361,-85,-1,-31,-32,8228,26272,213558,918804,2447
55053,"Jackson","Wisconsin",44.31864893,-90.80566792,15,1,0,14,"Jackson, Wisconsin, US",20643,171,220,164,56,6,109,115,8111,24637,209971,953287,2157
51095,"James City","Virginia",37.31156958,-76.76950618,192,16,0,176,"James City, Virginia, US",76523,490,721,778,-57,37,516,553,28131,133675,1117336,4783042,9697
13159,"Jasper","Georgia",33.31535543,-83.68844964,31,1,0,30,"Jasper, Georgia, US",14219,190,145,138,7,-1,180,179,2786,5431,35830,155257,705
17079,"Jasper","Illinois",39.01054275,-88.15437049,45,7,0,38,"Jasper, Illinois, US",9610,-14,114,93,21,12,-49,-37,3239,6539,49664,209993,1019
18073,"Jasper","Indiana",41.02078733,-87.11553319,52,1,0,51,"Jasper, Indiana, US",33562,197,362,331,31,3,166,169,12606,39436,322030,1344548,4074
19099,"Jasper","Iowa",41.68576082,-93.05567785,254,16,0,238,"Jasper, Iowa, US",37185,-4,406,378,28,10,-40,-30,11813,37509,280034,1191432,4019
28061,"Jasper","Mississippi",32.01922104,-89.11786866,135,3,0,132,"Jasper, Mississippi, US",16383,-42,182,186,-4,-2,-35,-37,4386,9523,89253,353542,1001
29097,"Jasper","Missouri",37.20351921,-94.34050458,32,0,0,32,"Jasper, Missouri, US",121328,873,1543,1192,351,100,423,523,60689,246197,2333650,8740256,16109
45053,"Jasper","South Carolina",32.43171982,-81.02487495,36,2,0,34,"Jasper, South Carolina, US",30073,926,366,282,84,57,778,835,8341,40669,349079,1418038,3434
48241,"Jasper","Texas",30.74685667,-94.02667579,26,1,0,25,"Jasper, Texas, US",35529,-240,422,430,-8,-12,-219,-231,10932,38696,261755,1126205,3111
18075,"Jay","Indiana",40.43781032,-85.00576229,41,0,0,41,"Jay, Indiana, US",20436,-291,277,226,51,-7,-334,-341,8669,21202,172540,732139,1926
13161,"Jeff Davis","Georgia",31.80405727,-82.6372487,31,1,0,30,"Jeff Davis, Georgia, US",15115,67,190,150,40,9,18,27,4837,14106,106534,435479,1188
1073,"Jefferson","Alabama",33.55554728,-86.895063,1573,88,0,1485,"Jefferson, Alabama, US",658573,-856,8422,7343,1079,460,-2375,-1915,355854,1838084,23383132,91509443,98073
5069,"Jefferson","Arkansas",34.26767081,-91.92619839,504,23,0,481,"Jefferson, Arkansas, US",66824,-1243,788,827,-39,6,-1214,-1208,29948,85373,699044,2812657,7210
8059,"Jefferson","Colorado",39.58635604,-105.2517692,2030,142,0,1888,"Jefferson, Colorado, US",582881,3489,5822,4599,1223,596,1659,2255,237161,1122107,12541879,52318280,103307
12065,"Jefferson","Florida",30.43669112,-83.89442308,29,3,0,26,"Jefferson, Florida, US",14246,-75,122,146,-24,6,-56,-50,2600,6072,40244,162881,1168
13163,"Jefferson","Georgia",33.05867328,-82.41609057,26,1,0,25,"Jefferson, Georgia, US",15362,-62,179,226,-47,5,-19,-14,4735,13410,104083,416373,1536
16051,"Jefferson","Idaho",43.82078483,-112.3131749,7,0,0,7,"Jefferson, Idaho, US",29871,466,496,163,333,-1,135,134,6714,18232,135450,603971,2656
17081,"Jefferson","Illinois",38.29980057,-88.9240025,100,16,0,84,"Jefferson, Illinois, US",37684,-24,452,445,7,14,-44,-30,20727,71299,651796,2690179,5158
18077,"Jefferson","Indiana",38.78576239,-85.43633383,41,1,0,40,"Jefferson, Indiana, US",32308,151,372,350,22,10,123,133,13258,44914,369474,1477524,3446
19101,"Jefferson","Iowa",41.03192394,-91.94849466,14,0,0,14,"Jefferson, Iowa, US",18295,39,158,185,-27,142,-74,68,8600,26181,235651,980830,3554
20087,"Jefferson","Kansas",39.2347941,-95.38289232,21,0,0,21,"Jefferson, Kansas, US",19043,187,171,149,22,-2,167,165,4319,9419,69688,299833,1589
21111,"Jefferson","Kentucky",38.18664655,-85.65931031,2050,141,0,1909,"Jefferson, Kentucky, US",766757,-1344,9603,7744,1859,499,-3669,-3170,436808,2404527,30688614,117309891,118258
22051,"Jefferson","Louisiana",29.74075478,-90.11115756,7232,432,0,6800,"Jefferson, Louisiana, US",432493,-1391,5577,4345,1232,1033,-3646,-2613,198788,1047496,11471914,46939763,70845
28063,"Jefferson","Mississippi",31.73397872,-91.03764977,40,0,0,40,"Jefferson, Mississippi, US",6990,-103,81,80,1,0,-104,-104,1564,1392,10698,42916,202
29099,"Jefferson","Missouri",38.25926778,-90.53870896,337,15,0,322,"Jefferson, Missouri, US",225081,671,2464,2150,314,39,329,368,50991,225796,1798688,7675556,23106
30043,"Jefferson","Montana",46.14907081,-112.094396,3,0,0,3,"Jefferson, Montana, US",12221,127,105,138,-33,2,158,160,2903,7358,52650,233215,1423
31095,"Jefferson","Nebraska",40.17584531,-97.142601,6,0,0,6,"Jefferson, Nebraska, US",7046,-52,73,82,-9,10,-54,-44,3831,9354,76924,321741,1111
36045,"Jefferson","New York",44.04200959,-75.94653457,72,0,0,72,"Jefferson, New York, US",109834,-2032,1913,919,994,-45,-2981,-3026,57596,156276,1333830,5686900,14082
39081,"Jefferson","Ohio",40.38614126,-80.76259514,62,2,0,60,"Jefferson, Ohio, US",65325,-449,638,917,-279,-27,-140,-167,23399,80869,673576,2754869,6890
40067,"Jefferson","Oklahoma",34.11130184,-97.83182974,3,0,0,3,"Jefferson, Oklahoma, US",6002,-104,61,83,-22,1,-83,-82,1769,2466,18590,98164,407
41031,"Jefferson","Oregon",44.62806839,-121.17832,25,0,0,25,"Jefferson, Oregon, US",24658,508,281,250,31,-10,484,474,7239,16012,109902,491196,1970
42065,"Jefferson","Pennsylvania",41.12913106,-78.9986361,7,0,0,7,"Jefferson, Pennsylvania, US",43425,-189,459,519,-60,0,-128,-128,17363,69086,584150,2371822,6155
47089,"Jefferson","Tennessee",36.04818632,-83.45148924,27,0,0,27,"Jefferson, Tennessee, US",54495,483,473,668,-195,15,661,676,15555,44743,340021,1436148,3769
48245,"Jefferson","Texas",29.8832777,-94.16434171,465,27,0,438,"Jefferson, Texas, US",251565,-1669,3323,2538,785,359,-2823,-2464,126998,597312,7254827,29244469,33780
53031,"Jefferson","Washington",47.75003077,-123.5609704,30,0,0,30,"Jefferson, Washington, US",32221,475,181,396,-215,5,683,688,10644,34654,267126,1190673,5793
54037,"Jefferson","West Virginia",39.30776166,-77.86014147,140,1,0,139,"Jefferson, West Virginia, US",57146,256,595,515,80,-39,217,178,18136,50742,378132,1519744,4712
55055,"Jefferson","Wisconsin",43.02054068,-88.77529134,78,3,0,75,"Jefferson, Wisconsin, US",84769,-280,835,694,141,28,-450,-422,33012,145459,1300085,5448567,11417
22053,"Jefferson Davis","Louisiana",30.26896765,-92.81210004,73,6,0,67,"Jefferson Davis, Louisiana, US",31368,-169,384,410,-26,6,-149,-143,9148,30742,235775,992019,3365
28065,"Jefferson Davis","Mississippi",31.56884708,-89.8267099,70,2,0,68,"Jefferson Davis, Mississippi, US",11128,-87,124,159,-35,-1,-49,-50,2234,3636,24581,137002,633
13165,"Jenkins","Georgia",32.79248718,-81.96040187,18,1,0,17,"Jenkins, Georgia, US",8676,-89,97,107,-10,9,-88,-79,2093,3402,24299,90085,432
18079,"Jennings","Indiana",38.99588883,-85.62710784,126,4,0,122,"Jennings, Indiana, US",27735,56,338,302,36,-1,23,22,8239,23923,204614,897902,1994
46073,"Jerauld","South Dakota",44.06637798,-98.62965972,16,1,0,15,"Jerauld, South Dakota, US",2013,-13,20,20,0,2,-15,-13,1245,2272,22291,83189,286
16053,"Jerome","Idaho",42.68891267,-114.2655033,137,2,0,135,"Jerome, Idaho, US",24412,346,367,152,215,93,41,134,8819,28661,249751,1075885,3009
17083,"Jersey","Illinois",39.08869046,-90.35393073,20,1,0,19,"Jersey, Illinois, US",21773,-22,211,234,-23,20,-18,2,5785,17514,113568,493210,2145
21113,"Jessamine","Kentucky",37.87119786,-84.58252003,51,0,0,51,"Jessamine, Kentucky, US",54115,358,629,430,199,35,125,160,18196,76012,665059,2735582,6165
20089,"Jewell","Kansas",39.78470589,-98.21820662,4,0,0,4,"Jewell, Kansas, US",2879,34,31,34,-3,0,38,38,1094,1100,7278,30944,292
48247,"Jim Hogg","Texas",27.04453923,-98.6968187,4,0,0,4,"Jim Hogg, Texas, US",5200,8,56,57,-1,20,-11,9,1720,3044,16217,64457,296
48249,"Jim Wells","Texas",27.73103938,-98.0904705,9,0,0,9,"Jim Wells, Texas, US",40482,-274,510,407,103,47,-424,-377,19024,74221,553025,2429640,4523
17085,"Jo Daviess","Illinois",42.36542373,-90.21094405,26,0,0,26,"Jo Daviess, Illinois, US",21235,-96,165,240,-75,-9,-8,-17,8506,27807,198171,877203,3757
5071,"Johnson","Arkansas",35.56759135,-93.46036368,38,0,0,38,"Johnson, Arkansas, US",26578,-81,326,252,74,-4,-150,-154,10232,23576,165257,682175,1898
13167,"Johnson","Georgia",32.70211082,-82.66166794,76,2,0,74,"Johnson, Georgia, US",9643,-63,105,113,-8,-2,-54,-56,2304,2564,16730,70605,518
17087,"Johnson","Illinois",37.45939802,-88.88165419,7,0,0,7,"Johnson, Illinois, US",12417,-6,101,144,-43,0,38,38,2963,5159,25754,105235,745
18081,"Johnson","Indiana",39.48994426,-86.10149107,1065,102,0,963,"Johnson, Indiana, US",158167,2074,1810,1299,511,302,1268,1570,49331,266741,2253482,9508162,18450
19103,"Johnson","Iowa",41.67169354,-91.58754744,593,7,0,586,"Johnson, Iowa, US",151140,591,1730,765,965,478,-855,-377,86796,351118,3578050,14854902,19246
20091,"Johnson","Kansas",38.88548175,-94.82250877,688,60,0,628,"Johnson, Kansas, US",602401,4274,7125,4070,3055,937,299,1236,317531,1953102,26938392,105853637,107422
21115,"Johnson","Kentucky",37.85106355,-82.8264322,5,0,0,5,"Johnson, Kentucky, US",22188,-203,253,312,-59,-4,-138,-142,5850,15462,116409,513605,1807
29101,"Johnson","Missouri",38.74719601,-93.80691168,72,0,0,72,"Johnson, Missouri, US",54062,441,686,378,308,41,94,135,23459,46118,314158,1293137,4964
31097,"Johnson","Nebraska",40.39257596,-96.26522753,7,0,0,7,"Johnson, Nebraska, US",5071,-44,41,57,-16,2,-30,-28,1974,2678,19447,81865,419
47091,"Johnson","Tennessee",36.4552395,-81.84886538,15,0,0,15,"Johnson, Tennessee, US",17788,14,154,237,-83,-6,104,98,4626,10603,84098,367461,1105
48251,"Johnson","Texas",32.37877812,-97.36615819,144,4,0,140,"Johnson, Texas, US",175817,4696,2155,1464,691,-18,4018,4000,44002,197631,1837267,7773108,16363
56019,"Johnson","Wyoming",44.04057166,-106.5845174,16,1,0,15,"Johnson, Wyoming, US",8445,-1,67,92,-25,2,21,23,3227,10440,83282,371575,2433
37101,"Johnston","North Carolina",35.51745004,-78.36622717,320,20,0,300,"Johnston, North Carolina, US",209339,6647,2371,1618,753,121,5752,5873,50912,212975,1674011,6981736,19861
40069,"Johnston","Oklahoma",34.31440473,-96.66011537,3,0,0,3,"Johnston, Oklahoma, US",11085,65,130,147,-17,1,83,84,3223,6083,57284,240792,773
13169,"Jones","Georgia",33.02512137,-83.56019163,33,0,0,33,"Jones, Georgia, US",28735,55,216,292,-76,0,133,133,4728,11213,80576,334830,1608
19105,"Jones","Iowa",42.12118609,-91.13139641,36,0,0,36,"Jones, Iowa, US",20681,8,200,202,-2,11,1,12,6971,19314,151583,644978,2632
28067,"Jones","Mississippi",31.62257767,-89.168969,435,13,0,422,"Jones, Mississippi, US",68098,-98,883,813,70,20,-186,-166,28387,100094,826614,3485552,7439
37103,"Jones","North Carolina",35.02254606,-77.35870791,28,3,0,25,"Jones, North Carolina, US",9419,-194,91,118,-27,-2,-166,-168,2009,3217,20111,90267,589
48253,"Jones","Texas",32.73997145,-99.87861576,134,0,0,134,"Jones, Texas, US",20083,217,156,156,0,1,218,219,4215,9870,90158,374584,1298
41033,"Josephine","Oregon",42.3665549,-123.5561938,25,1,0,24,"Josephine, Oregon, US",87487,337,866,1190,-324,-26,693,667,26273,118509,885838,3883482,11534
2110,"Juneau","Alaska",58.45031811,-134.200436,31,0,0,31,"Juneau, Alaska, US",31974,-63,340,177,163,20,-247,-227,17899,53366,561507,2538872,6431
55057,"Juneau","Wisconsin",43.92456975,-90.11120239,22,1,0,21,"Juneau, Wisconsin, US",26687,94,270,255,15,1,78,79,10081,27065,222802,919976,2788
42067,"Juniata","Pennsylvania",40.53358749,-77.3997513,94,4,0,90,"Juniata, Pennsylvania, US",24763,45,276,252,24,14,9,23,7587,24145,170890,723131,2462
26077,"Kalamazoo","Michigan",42.24542231,-85.53038622,793,47,0,746,"Kalamazoo, Michigan, US",265066,386,3010,2209,801,303,-715,-412,127003,601725,6735443,27587101,33307
26079,"Kalkaska","Michigan",44.68512729,-85.09085699,19,2,0,17,"Kalkaska, Michigan, US",18038,232,171,173,-2,3,229,232,4633,14734,136960,642880,1605
27065,"Kanabec","Minnesota",45.9459309,-93.29275192,11,1,0,10,"Kanabec, Minnesota, US",16337,91,180,142,38,9,44,53,4477,11770,89397,432130,1412
54039,"Kanawha","West Virginia",38.33860077,-81.52857054,212,18,0,194,"Kanawha, West Virginia, US",178124,-2286,1834,2471,-637,-18,-1633,-1651,102677,422387,4563144,18010371,28238
27067,"Kandiyohi","Minnesota",45.1526059,-95.00586446,449,1,0,448,"Kandiyohi, Minnesota, US",43199,289,568,370,198,193,-100,93,22562,95903,809823,3530676,7712
17089,"Kane","Illinois",41.93842729,-88.42861412,5484,152,0,5332,"Kane, Illinois, US",532403,-317,6249,3464,2785,-81,-3026,-3107,219452,1079118,11639472,49607994,77436
17091,"Kankakee","Illinois",41.13746989,-87.86205334,783,42,0,741,"Kankakee, Illinois, US",109862,-91,1240,1167,73,29,-192,-163,45084,179762,1517463,6425564,13443
48255,"Karnes","Texas",28.90705334,-97.85960149,4,0,0,4,"Karnes, Texas, US",15601,-59,165,157,8,86,-154,-68,8119,21976,364382,1349273,1714
15007,"Kauai","Hawaii",22.03935037,-159.5966786,20,0,0,20,"Kauai, Hawaii, US",72293,125,794,704,90,269,-230,39,33256,160905,1549118,6516298,12125
48257,"Kaufman","Texas",32.5991417,-96.28734728,173,2,0,171,"Kaufman, Texas, US",136154,7875,1796,1056,740,-4,7124,7120,28885,132738,1162148,4821089,11091
40071,"Kay","Oklahoma",36.81799745,-97.14421435,52,7,0,45,"Kay, Oklahoma, US",43538,-406,537,576,-39,-2,-363,-365,20272,68300,579292,2384115,5942
31099,"Kearney","Nebraska",40.50663314,-98.94877182,11,0,0,11,"Kearney, Nebraska, US",6495,-44,80,62,18,-1,-60,-61,3240,4801,41668,175281,706
20093,"Kearny","Kansas",38.00017981,-101.321681,40,1,0,39,"Kearny, Kansas, US",3838,-103,59,23,36,5,-146,-141,1548,1597,12555,50560,317
31101,"Keith","Nebraska",41.19930341,-101.6620164,2,0,0,2,"Keith, Nebraska, US",8034,31,85,82,3,-5,34,29,4040,12192,87638,355303,1746
28069,"Kemper","Mississippi",32.75462946,-88.64105766,118,10,0,108,"Kemper, Mississippi, US",9742,9,90,113,-23,0,33,33,3626,3509,36140,126211,525
2122,"Kenai Peninsula","Alaska",60.24429722,-151.5388884,26,2,0,24,"Kenai Peninsula, Alaska, US",58708,147,665,541,124,20,6,26,23631,79859,862729,3841315,12363
17093,"Kendall","Illinois",41.59081014,-88.42869583,689,19,0,670,"Kendall, Illinois, US",128990,1273,1473,580,893,107,277,384,31906,120886,934199,4050836,12358
48259,"Kendall","Texas",29.94414155,-98.7113588,24,0,0,24,"Kendall, Texas, US",47431,1828,403,392,11,27,1789,1816,13985,71801,710306,3002734,7650
23011,"Kennebec","Maine",44.40759555,-69.76738544,126,9,0,117,"Kennebec, Maine, US",122302,258,1113,1390,-277,40,500,540,59723,269621,2484336,10513014,18818
55059,"Kenosha","Wisconsin",42.57639354,-88.04051686,983,22,0,961,"Kenosha, Wisconsin, US",169561,635,1831,1369,462,-48,227,179,59853,307228,2743472,11941434,18857
10001,"Kent","Delaware",39.08646628,-75.56884914,1296,56,0,1240,"Kent, Delaware, US",180786,2246,2127,1757,370,62,1812,1874,67012,262848,2337796,9868166,20937
24029,"Kent","Maryland",39.24976208,-76.04741541,148,15,0,133,"Kent, Maryland, US",19422,-12,142,284,-142,8,124,132,9154,29643,235477,1004347,3179
26081,"Kent","Michigan",43.03197711,-85.54934642,3308,67,0,3241,"Kent, Michigan, US",656955,3605,8637,4816,3821,1018,-1208,-190,348435,2130753,24461092,99087803,100007
44003,"Kent","Rhode Island",41.67106337,-71.57641596,1005,0,0,1005,"Kent, Rhode Island, US",164292,239,1547,1673,-126,153,223,376,73241,387933,4242911,16807262,27664
21117,"Kenton","Kentucky",38.93950319,-84.53241199,527,32,0,495,"Kenton, Kentucky, US",166998,706,2236,1501,735,-25,2,-23,63755,282182,3182255,13344925,18346
19107,"Keokuk","Iowa",41.33649833,-92.1785067,13,0,0,13,"Keokuk, Iowa, US",10246,33,121,103,18,4,12,16,3075,6156,46403,193501,1159
6029,"Kern","California",35.34329425,-118.7277796,1757,29,0,1728,"Kern, California, US",900202,6444,13144,6478,6666,81,-291,-210,322560,1100991,12177989,49237627,77009
48265,"Kerr","Texas",30.06040006,-99.34930144,11,0,0,11,"Kerr, Texas, US",52600,185,530,747,-217,29,374,403,20331,81625,696463,2985822,8005
45055,"Kershaw","South Carolina",34.33988254,-80.58763164,299,13,0,286,"Kershaw, South Carolina, US",66551,749,725,794,-69,28,793,821,19531,66194,536040,2195904,6103
2130,"Ketchikan Gateway","Alaska",55.57445008,-130.975561,16,0,0,16,"Ketchikan Gateway, Alaska, US",13901,45,153,88,65,24,-42,-18,6884,20301,206963,1110467,3131
55061,"Kewaunee","Wisconsin",44.51727459,-87.61468386,33,1,0,32,"Kewaunee, Wisconsin, US",20434,39,196,192,4,28,8,36,7977,18972,150973,650437,2322
31103,"Keya Paha","Nebraska",42.87990694,-99.71343729,0,0,0,0,"Keya Paha, Nebraska, US",806,0,6,8,-2,0,2,2,362,146,665,2746,61
31105,"Kimball","Nebraska",41.19774275,-103.7148131,8,0,0,8,"Kimball, Nebraska, US",3632,54,34,43,-9,1,62,63,1648,2571,23661,104648,490
48267,"Kimble","Texas",30.48678918,-99.74856473,1,0,0,1,"Kimble, Texas, US",4337,-1,48,66,-18,0,16,16,1885,3498,20857,86882,527
53033,"King","Washington",47.49137892,-121.8346131,7669,542,0,7127,"King, Washington, US",2252782,24418,25188,13917,11271,17969,-4784,13185,1225496,7228266,139815518,573057198,415036
51099,"King George","Virginia",38.26818502,-77.15852768,52,4,0,48,"King George, Virginia, US",26836,224,287,169,118,3,104,107,12584,25293,322447,1352698,2561
51101,"King William","Virginia",37.70965316,-77.09384941,20,0,0,20,"King William, Virginia, US",17148,229,204,141,63,1,166,167,4422,11859,104706,420267,1637
51097,"King and Queen","Virginia",37.71044922,-76.88689628,7,0,0,7,"King and Queen, Virginia, US",7025,-20,59,94,-35,1,14,15,1425,2464,22184,91600,510
40073,"Kingfisher","Oklahoma",35.94530008,-97.94193268,13,0,0,13,"Kingfisher, Oklahoma, US",15765,-49,180,145,35,9,-93,-84,6933,26636,308654,1373680,2519
6031,"Kings","California",36.07409056,-119.8159973,506,2,0,504,"Kings, California, US",152940,1558,2321,887,1434,-74,197,123,54129,120482,1047559,4472409,9311
46077,"Kingsbury","South Dakota",44.36956169,-97.4913945,0,0,0,0,"Kingsbury, South Dakota, US",4939,13,66,50,16,1,-2,-1,2098,3723,31449,153407,652
20097,"Kiowa","Kansas",37.55848695,-99.2856537,2,0,0,2,"Kiowa, Kansas, US",2475,-14,29,23,6,1,-20,-19,1444,2044,17568,71521,320
40075,"Kiowa","Oklahoma",34.91671958,-98.97720696,6,0,0,6,"Kiowa, Oklahoma, US",8708,-24,113,107,6,2,-32,-30,3192,4868,36169,136501,798
8063,"Kit Carson","Colorado",39.30497777,-102.6022199,26,3,0,23,"Kit Carson, Colorado, US",7097,-62,78,74,4,8,-75,-67,3673,8896,68704,289367,1350
53035,"Kitsap","Washington",47.63479026,-122.6436061,160,2,0,158,"Kitsap, Washington, US",271473,2197,3023,2375,648,75,1469,1544,106982,329602,3022657,12864048,35021
53037,"Kittitas","Washington",47.12521214,-120.679439,66,0,0,66,"Kittitas, Washington, US",47935,577,426,307,119,81,376,457,17647,60792,428261,1897944,7096
27069,"Kittson","Minnesota",48.77754106,-96.78317184,1,0,0,1,"Kittson, Minnesota, US",4298,30,66,52,14,3,14,17,1953,4163,29081,127794,580
41035,"Klamath","Oregon",42.68762984,-121.6496461,41,0,0,41,"Klamath, Oregon, US",68238,551,767,834,-67,-2,620,618,24675,78933,630680,2726153,8562
48273,"Kleberg","Texas",27.42435506,-97.69894948,14,1,0,13,"Kleberg, Texas, US",30680,-42,402,245,157,41,-241,-200,13199,28687,190507,841258,2949
53039,"Klickitat","Washington",45.87325839,-120.7913598,24,3,0,21,"Klickitat, Washington, US",22425,289,222,223,-1,-4,293,289,7012,15892,145697,652508,2755
21119,"Knott","Kentucky",37.35388197,-82.94981134,4,0,0,4,"Knott, Kentucky, US",14806,-270,142,205,-63,-2,-205,-207,3230,5312,37220,153345,715
17095,"Knox","Illinois",40.93148779,-90.2133034,94,0,0,94,"Knox, Illinois, US",49699,-279,559,620,-61,77,-296,-219,21097,67951,476905,1968284,5563
18083,"Knox","Indiana",38.68861576,-87.4194665,24,0,0,24,"Knox, Indiana, US",36594,-2,390,394,-4,20,-17,3,18564,61320,476311,1968956,4672
21121,"Knox","Kentucky",36.89225732,-83.85403396,8,0,0,8,"Knox, Kentucky, US",31145,-155,385,419,-34,-3,-117,-120,8575,31959,188530,787280,2358
23013,"Knox","Maine",44.11486325,-69.10529169,20,0,0,20,"Knox, Maine, US",39772,55,307,452,-145,3,199,202,20677,72833,647002,2813453,10169
31107,"Knox","Nebraska",42.63758421,-97.89178836,8,0,0,8,"Knox, Nebraska, US",8332,-73,100,99,1,2,-75,-73,3611,7565,49999,202917,1266
39083,"Knox","Ohio",40.39830217,-82.42027563,23,1,0,22,"Knox, Ohio, US",62322,422,741,630,111,-5,319,314,23284,80034,627098,2816268,5973
47093,"Knox","Tennessee",35.99508821,-83.94635435,326,5,0,321,"Knox, Tennessee, US",470313,4055,5154,4548,606,818,2627,3445,239358,1271418,13045653,53667381,68859
48275,"Knox","Texas",33.60519951,-99.7422906,1,0,0,1,"Knox, Texas, US",3664,2,41,37,4,4,-6,-2,1545,1615,13565,61006,343
2150,"Kodiak Island","Alaska",57.65529415,-153.7493579,1,0,0,1,"Kodiak Island, Alaska, US",12998,-252,168,53,115,33,-400,-367,7743,28241,252304,962752,2500
27071,"Koochiching","Minnesota",48.24539665,-93.78352843,4,0,0,4,"Koochiching, Minnesota, US",12229,-202,96,149,-53,3,-153,-150,5614,14610,104373,430403,1845
16055,"Kootenai","Idaho",47.67282258,-116.7020872,66,0,0,66,"Kootenai, Idaho, US",165697,4488,1815,1503,312,-118,4277,4159,56443,283690,2444524,10803955,28813
18085,"Kosciusko","Indiana",41.24521668,-85.86312322,71,1,0,70,"Kosciusko, Indiana, US",79456,40,1029,724,305,85,-346,-261,37094,187231,2348098,8930765,11159
19109,"Kossuth","Iowa",43.20405458,-94.20691791,7,0,0,7,"Kossuth, Iowa, US",14813,-65,164,152,12,5,-83,-78,7857,24729,225192,941716,2879
55063,"La Crosse","Wisconsin",43.90632465,-91.11451093,48,0,0,48,"La Crosse, Wisconsin, US",118016,-25,1160,997,163,-11,-172,-183,70844,323092,3046728,12409859,17814
4012,"La Paz","Arizona",33.72854224,-113.9810029,49,1,0,48,"La Paz, Arizona, US",21108,69,191,310,-119,68,123,191,6770,17154,108904,433281,1668
8067,"La Plata","Colorado",37.28632032,-107.8429014,76,1,0,75,"La Plata, Colorado, US",56221,-78,472,367,105,-11,-169,-180,28037,110975,1067620,4606041,13822
48283,"La Salle","Texas",28.34453111,-99.09908775,4,0,0,4,"La Salle, Texas, US",7520,27,92,41,51,21,-45,-24,5216,8111,85940,329820,707
18087,"LaGrange","Indiana",41.64232188,-85.42674232,59,2,0,57,"LaGrange, Indiana, US",39614,239,727,261,466,0,-230,-230,14554,63596,656665,2876854,4546
18091,"LaPorte","Indiana",41.54366008,-86.74072188,387,21,0,366,"LaPorte, Indiana, US",109888,-93,1248,1215,33,7,-127,-120,41547,180003,1631215,6659562,13235
17099,"LaSalle","Illinois",41.3442613,-88.88633881,134,10,0,124,"LaSalle, Illinois, US",108669,-490,1124,1252,-128,29,-389,-360,46219,189528,1769634,7199753,15357
22059,"LaSalle","Louisiana",31.67884782,-92.15907765,45,1,0,44,"LaSalle, Louisiana, US",14892,-9,175,173,2,4,-14,-10,4737,11684,96773,413643,1696
20099,"Labette","Kansas",37.19113093,-95.29849679,22,0,0,22,"Labette, Kansas, US",19618,-288,248,222,26,-3,-312,-315,10086,28849,221608,902770,2308
27073,"Lac qui Parle","Minnesota",44.9973857,-96.17488219,3,0,0,3,"Lac qui Parle, Minnesota, US",6623,-41,58,98,-40,3,-4,-1,2777,5934,44844,187721,850
42069,"Lackawanna","Pennsylvania",41.43564672,-75.60379201,1476,152,0,1324,"Lackawanna, Pennsylvania, US",209674,-595,2037,2530,-493,395,-489,-94,98495,490891,4643916,18686551,31043
29105,"Laclede","Missouri",37.65896829,-92.5888493,3,0,0,3,"Laclede, Missouri, US",35723,127,474,396,78,-2,53,51,14656,49877,361980,1506103,3978
5073,"Lafayette","Arkansas",33.24116713,-93.60677071,9,1,0,8,"Lafayette, Arkansas, US",6624,-55,61,94,-33,-1,-20,-21,1711,2633,18447,81112,457
12067,"Lafayette","Florida",29.98484137,-83.18166636,8,0,0,8,"Lafayette, Florida, US",8422,-269,63,77,-14,-5,-254,-259,1940,2254,15974,63956,382
22055,"Lafayette","Louisiana",30.2049055,-92.06959876,637,23,0,614,"Lafayette, Louisiana, US",244390,1277,3208,1999,1209,184,-113,71,142027,719151,7660139,31862801,50950
28071,"Lafayette","Mississippi",34.35687874,-89.48490961,118,3,0,115,"Lafayette, Mississippi, US",54019,477,513,395,118,19,342,361,23287,85027,642656,2767880,7221
29107,"Lafayette","Missouri",39.06986886,-93.78076396,69,3,0,66,"Lafayette, Missouri, US",32708,166,356,371,-15,-7,192,185,10335,31410,215545,913914,3774
55065,"Lafayette","Wisconsin",42.66005229,-90.1317729,18,0,0,18,"Lafayette, Wisconsin, US",16665,-7,206,152,54,6,-67,-61,5751,15307,125810,628563,1861
22057,"Lafourche","Louisiana",29.52470226,-90.40976986,766,64,0,702,"Lafourche, Louisiana, US",97614,-367,1148,907,241,50,-656,-606,39302,139167,1577564,6511732,9960
6033,"Lake","California",39.10124298,-122.7536244,12,0,0,12,"Lake, California, US",64386,69,731,848,-117,-26,215,189,18046,48181,385362,1659149,6189
8065,"Lake","Colorado",39.20278823,-106.3555697,27,0,0,27,"Lake, Colorado, US",8127,281,86,28,58,0,220,220,3142,5399,35218,141622,935
12069,"Lake","Florida",28.76202069,-81.7125123,271,15,0,256,"Lake, Florida, US",367118,10398,3388,4431,-1043,215,11162,11377,89441,477278,3937624,16433042,43480
17097,"Lake","Illinois",42.3224907,-88.00367925,7465,250,0,7215,"Lake, Illinois, US",696535,-3052,7261,4780,2481,817,-6404,-5587,359429,1837701,36772647,133639704,118651
18089,"Lake","Indiana",41.41874274,-87.38277575,3191,167,0,3024,"Lake, Indiana, US",485493,1053,5438,5029,409,260,413,673,196435,949290,10211628,42684030,60048
26085,"Lake","Michigan",43.99050893,-85.802173,5,0,0,5,"Lake, Michigan, US",11853,-23,115,162,-47,3,23,26,2099,3773,20844,100688,644
27075,"Lake","Minnesota",47.64270764,-91.44557998,1,0,0,1,"Lake, Minnesota, US",10641,31,105,134,-29,5,58,63,4454,12703,85870,393710,1465
30047,"Lake","Montana",47.64514965,-114.0898013,5,0,0,5,"Lake, Montana, US",30458,238,317,331,-14,-5,261,256,10420,24519,175884,776491,4383
39085,"Lake","Ohio",41.69710807,-81.23676539,263,12,0,251,"Lake, Ohio, US",230149,47,2192,2481,-289,69,281,350,95724,466581,5200479,20664563,35316
46079,"Lake","South Dakota",44.02193107,-97.12926365,5,0,0,5,"Lake, South Dakota, US",12797,-258,129,113,16,-3,-273,-276,5999,14190,118533,479020,1694
47095,"Lake","Tennessee",36.3418017,-89.48921915,408,0,0,408,"Lake, Tennessee, US",7016,-391,57,92,-35,0,-360,-360,1959,2024,12445,50095,255
1075,"Lamar","Alabama",33.77995024,-88.09668032,18,0,0,18,"Lamar, Alabama, US",13805,-77,159,172,-13,-1,-64,-65,4113,11016,85294,367098,1128
13171,"Lamar","Georgia",33.07841647,-84.14263877,50,1,0,49,"Lamar, Georgia, US",19077,116,215,236,-21,25,113,138,4574,10554,68445,275232,1152
28073,"Lamar","Mississippi",31.20572971,-89.5077704,218,4,0,214,"Lamar, Mississippi, US",63343,706,793,438,355,34,317,351,20663,102074,686640,2844824,8131
48277,"Lamar","Texas",33.66981763,-95.57404777,126,9,0,117,"Lamar, Texas, US",49859,130,619,661,-42,2,172,174,21253,82800,695386,2926324,6789
48279,"Lamb","Texas",34.06859623,-102.3516289,11,0,0,11,"Lamb, Texas, US",12893,-210,167,141,26,0,-236,-236,5078,9631,81110,328469,1185
50015,"Lamoille","Vermont",44.60353043,-72.64356694,29,1,0,28,"Lamoille, Vermont, US",25362,67,228,181,47,4,18,22,12256,57580,438520,1698694,5348
48281,"Lampasas","Texas",31.19531316,-98.24206613,8,0,0,8,"Lampasas, Texas, US",21428,294,204,210,-6,1,298,299,5325,18085,131869,563607,2042
31109,"Lancaster","Nebraska",40.78416049,-96.68777155,1033,6,0,1027,"Lancaster, Nebraska, US",319090,2563,3883,2145,1738,799,36,835,167067,781607,8030432,32545415,50904
42071,"Lancaster","Pennsylvania",40.03904563,-76.24770128,2790,279,0,2511,"Lancaster, Pennsylvania, US",545724,1755,7132,5160,1972,647,-852,-205,241271,1342104,13758919,56514037,77825
45057,"Lancaster","South Carolina",34.68270843,-80.70513032,121,5,0,116,"Lancaster, South Carolina, US",98012,2977,1010,1026,-16,45,2933,2978,23905,90491,946152,3931180,7952
51103,"Lancaster","Virginia",37.71889653,-76.46400482,10,0,0,10,"Lancaster, Virginia, US",10603,-93,62,206,-144,4,48,52,5242,15899,137544,603048,2331
32015,"Lander","Nevada",39.9332233,-117.0397075,19,0,0,19,"Lander, Nevada, US",5532,-15,76,37,39,-2,-53,-55,2759,2768,30568,107152,315
20101,"Lane","Kansas",38.48119447,-100.4660754,1,0,0,1,"Lane, Kansas, US",1535,-11,13,17,-4,0,-7,-7,874,630,5830,24379,216
41039,"Lane","Oregon",43.93727035,-122.847753,67,2,0,65,"Lane, Oregon, US",382067,3518,3425,3631,-206,230,3487,3717,156340,712200,6734764,28261773,59244
55067,"Langlade","Wisconsin",45.26271619,-89.07483625,1,0,0,1,"Langlade, Wisconsin, US",19189,-47,188,236,-48,9,-6,3,7945,27751,233626,1030831,2914
13173,"Lanier","Georgia",31.0382857,-83.06472457,12,2,0,10,"Lanier, Georgia, US",10423,68,116,114,2,-4,70,66,1663,2764,16912,68289,350
26087,"Lapeer","Michigan",43.09052506,-83.22153148,187,30,0,157,"Lapeer, Michigan, US",87607,-314,753,892,-139,10,-183,-173,24559,97458,778865,3379685,9627
56021,"Laramie","Wyoming",41.3070252,-104.6887497,182,0,0,182,"Laramie, Wyoming, US",99500,635,1269,874,395,1,242,243,50324,168476,1555933,6739510,18853
8069,"Larimer","Colorado",40.66671597,-105.4625784,530,21,0,509,"Larimer, Colorado, US",356899,6239,3337,2295,1042,537,4638,5175,152968,727912,7567317,32383124,65078
21123,"Larue","Kentucky",37.54567114,-85.70138352,7,0,0,7,"Larue, Kentucky, US",14398,99,174,157,17,-3,86,83,3383,7495,57088,250096,953
8071,"Las Animas","Colorado",37.3153406,-104.0376458,5,0,0,5,"Las Animas, Colorado, US",14506,-2,117,160,-43,18,24,42,6129,13859,87592,374383,1824
6035,"Lassen","California",40.67311306,-120.5935099,2,0,0,2,"Lassen, California, US",30573,-45,281,202,79,7,-133,-126,10037,15388,121541,523298,2064
16057,"Latah","Idaho",46.81587887,-116.7113698,7,0,0,7,"Latah, Idaho, US",40108,279,422,215,207,52,20,72,15334,44484,287377,1271186,4978
40077,"Latimer","Oklahoma",34.87844729,-95.25215049,5,1,0,4,"Latimer, Oklahoma, US",10073,-102,121,116,5,2,-109,-107,3664,8519,82506,340010,667
1077,"Lauderdale","Alabama",34.90171875,-87.65624729,126,2,0,124,"Lauderdale, Alabama, US",92729,125,876,1136,-260,35,355,390,34315,131682,931006,3893913,11326
28075,"Lauderdale","Mississippi",32.40419769,-88.66229662,670,54,0,616,"Lauderdale, Mississippi, US",74125,-1113,910,861,49,-26,-1140,-1166,37346,146690,1217664,4951747,10752
47097,"Lauderdale","Tennessee",35.75893438,-89.6301591,51,1,0,50,"Lauderdale, Tennessee, US",25633,-364,283,265,18,-1,-381,-382,7931,17606,137401,569553,1405
21125,"Laurel","Kentucky",37.10975748,-84.11321779,21,2,0,19,"Laurel, Kentucky, US",60813,153,724,673,51,-9,115,106,23899,102697,791442,3230277,6673
13175,"Laurens","Georgia",32.46325233,-82.92221316,100,1,0,99,"Laurens, Georgia, US",47546,210,615,561,54,2,155,157,18087,70884,567619,2344466,5809
45059,"Laurens","South Carolina",34.48244419,-82.00490796,57,3,0,54,"Laurens, South Carolina, US",67493,603,783,850,-67,49,621,670,22093,72267,646423,2635114,4842
48285,"Lavaca","Texas",29.38508402,-96.93186692,8,1,0,7,"Lavaca, Texas, US",20154,40,224,241,-17,12,47,59,6924,21288,176135,747609,2351
1079,"Lawrence","Alabama",34.52041498,-87.31069453,41,0,0,41,"Lawrence, Alabama, US",32924,-17,349,428,-79,-3,69,66,6961,14850,95321,396319,2048
5075,"Lawrence","Arkansas",36.04188196,-91.10867198,82,5,0,77,"Lawrence, Arkansas, US",16406,-26,194,249,-55,-3,32,29,5450,11643,83283,347487,1374
17101,"Lawrence","Illinois",38.71987914,-87.72884035,4,0,0,4,"Lawrence, Illinois, US",15678,-135,145,198,-53,4,-86,-82,4507,9536,77766,322544,1120
18093,"Lawrence","Indiana",38.84112637,-86.48361629,142,22,0,120,"Lawrence, Indiana, US",45370,-260,465,563,-98,5,-164,-159,15633,57659,493522,1987152,5085
21127,"Lawrence","Kentucky",38.07136018,-82.72882223,1,0,0,1,"Lawrence, Kentucky, US",15317,-266,174,225,-51,-4,-210,-214,3762,8484,64742,272341,910
28077,"Lawrence","Mississippi",31.55147224,-90.10841127,86,1,0,85,"Lawrence, Mississippi, US",12586,138,145,150,-5,0,145,145,3250,6086,62848,237781,798
29109,"Lawrence","Missouri",37.10626634,-93.83293097,8,0,0,8,"Lawrence, Missouri, US",38355,91,502,461,41,-22,75,53,10373,31354,224103,951985,3743
39087,"Lawrence","Ohio",38.59743452,-82.53466552,28,0,0,28,"Lawrence, Ohio, US",59463,-304,610,793,-183,-24,-95,-119,13507,49601,346255,1437834,4358
42073,"Lawrence","Pennsylvania",40.99206278,-80.33393706,74,8,0,66,"Lawrence, Pennsylvania, US",85512,-616,863,1090,-227,9,-396,-387,32145,131290,1071400,4645173,10855
46081,"Lawrence","South Dakota",44.35919441,-103.7929428,9,0,0,9,"Lawrence, South Dakota, US",25844,117,224,233,-9,17,110,127,12331,47996,332759,1433472,5695
47099,"Lawrence","Tennessee",35.21675201,-87.39787695,24,0,0,24,"Lawrence, Tennessee, US",44142,371,585,539,46,-5,331,326,12089,39575,284936,1203572,3879
40079,"Le Flore","Oklahoma",34.89851864,-94.70392124,13,1,0,12,"Le Flore, Oklahoma, US",49853,-240,591,678,-87,39,-189,-150,14168,35372,234705,989259,4262
27079,"Le Sueur","Minnesota",44.37136597,-93.72844721,41,1,0,40,"Le Sueur, Minnesota, US",28887,299,343,222,121,30,148,178,8736,29688,250476,1131326,3800
35025,"Lea","New Mexico",32.79215361,-103.4123733,21,0,0,21,"Lea, New Mexico, US",71070,1527,1086,507,579,22,923,945,30744,125371,1477156,6236182,9529
28079,"Leake","Mississippi",32.7536828,-89.52402044,382,8,0,374,"Leake, Mississippi, US",22786,-5,299,274,25,-7,-23,-30,5816,13586,90131,371237,1466
20103,"Leavenworth","Kansas",39.20183497,-95.03620809,1067,7,0,1060,"Leavenworth, Kansas, US",81758,261,940,639,301,17,-58,-41,26943,76343,698138,2943953,7127
42075,"Lebanon","Pennsylvania",40.36680311,-76.45651841,900,24,0,876,"Lebanon, Pennsylvania, US",141793,454,1581,1504,77,124,260,384,54466,235729,2055741,8691326,15440
1081,"Lee","Alabama",32.60154883,-85.35132246,488,32,0,456,"Lee, Alabama, US",164542,886,1825,1133,692,303,-112,191,56537,238082,1796198,7316573,16197
5077,"Lee","Arkansas",34.78498904,-90.78383866,14,1,0,13,"Lee, Arkansas, US",8857,-119,81,120,-39,0,-80,-80,2375,3337,30340,109703,473
12071,"Lee","Florida",26.58410348,-81.88399313,1677,92,0,1585,"Lee, Florida, US",770577,16107,6760,7950,-1190,2183,15043,17226,243397,1237319,12579679,50035304,112283
13177,"Lee","Georgia",31.7793306,-84.14324253,342,22,0,320,"Lee, Georgia, US",29992,241,325,245,80,3,161,164,4865,17884,135689,620216,1927
17103,"Lee","Illinois",41.74583951,-89.29977132,76,1,0,75,"Lee, Illinois, US",34096,-200,338,376,-38,7,-169,-162,14252,44062,387800,1616744,3717
19111,"Lee","Iowa",40.64181461,-91.48183025,20,0,0,20,"Lee, Iowa, US",33657,-252,370,398,-28,-5,-219,-224,18638,63519,616609,2422926,4733
28081,"Lee","Mississippi",34.2918775,-88.68149954,101,5,0,96,"Lee, Mississippi, US",85436,160,1121,965,156,18,-12,6,50903,241863,2108859,8511855,14291
37105,"Lee","North Carolina",35.47623147,-79.17569362,362,3,0,359,"Lee, North Carolina, US",61779,571,774,563,211,56,304,360,26957,101480,928041,3676389,7521
45061,"Lee","South Carolina",34.16393091,-80.25690731,187,13,0,174,"Lee, South Carolina, US",16828,-466,165,272,-107,2,-364,-362,3712,6474,39767,165222,865
48287,"Lee","Texas",30.31120597,-96.97045773,8,0,0,8,"Lee, Texas, US",17239,142,208,164,44,-9,108,99,7040,21323,214186,967039,2137
51105,"Lee","Virginia",36.70586667,-83.12606515,9,0,0,9,"Lee, Virginia, US",23423,-233,197,329,-132,-7,-95,-102,5168,9689,60335,257719,1281
26089,"Leelanau","Michigan",44.94430054,-85.80150326,11,0,0,11,"Leelanau, Michigan, US",21761,47,175,222,-47,9,87,96,7582,22094,178501,907982,3938
28083,"Leflore","Mississippi",33.55545125,-90.29900733,240,25,0,215,"Leflore, Mississippi, US",28183,-433,412,363,49,-5,-478,-483,12699,50151,387121,1570486,3623
42077,"Lehigh","Pennsylvania",40.6154815,-75.59435245,3628,202,0,3426,"Lehigh, Pennsylvania, US",369318,959,4273,3347,926,818,-777,41,180405,1008325,12679820,52061149,51295
16059,"Lemhi","Idaho",44.9438088,-113.9309747,1,0,0,1,"Lemhi, Idaho, US",8027,95,75,99,-24,-4,124,120,3028,7323,42614,200636,1377
26091,"Lenawee","Michigan",41.89475156,-84.06603727,145,3,0,142,"Lenawee, Michigan, US",98451,310,952,1007,-55,5,367,372,31225,115443,1019894,4237901,10251
37107,"Lenoir","North Carolina",35.2403259,-77.64245615,182,7,0,175,"Lenoir, North Carolina, US",55949,-41,608,768,-160,42,80,122,27604,108817,857000,3604858,6631
12073,"Leon","Florida",30.45955727,-84.27491114,330,6,0,324,"Leon, Florida, US",293582,1925,2984,1945,1039,420,479,899,156788,557518,5355871,22271949,45801
48289,"Leon","Texas",31.29872538,-95.9936328,9,0,0,9,"Leon, Texas, US",17404,144,196,212,-16,4,155,159,6746,16642,174538,726676,1694
21131,"Leslie","Kentucky",37.09246661,-83.37999606,6,0,0,6,"Leslie, Kentucky, US",9877,-274,95,163,-68,-1,-206,-207,1870,3465,25927,110241,486
21133,"Letcher","Kentucky",37.12306748,-82.85346474,4,0,0,4,"Letcher, Kentucky, US",21553,-260,233,310,-77,1,-185,-184,6024,12388,101122,403228,1510
12075,"Levy","Florida",29.31829741,-82.74007147,27,0,0,27,"Levy, Florida, US",41503,705,409,551,-142,-1,845,844,9284,31065,205255,847612,3919
16061,"Lewis","Idaho",46.23315327,-116.434146,0,0,0,0,"Lewis, Idaho, US",3838,6,34,37,-3,3,7,10,1528,3061,18399,79114,478
21135,"Lewis","Kentucky",38.53184419,-83.37735618,7,0,0,7,"Lewis, Kentucky, US",13275,7,164,164,0,-1,10,9,2630,4441,27355,116216,494
29111,"Lewis","Missouri",40.09673161,-91.72070156,7,1,0,6,"Lewis, Missouri, US",9776,-63,125,103,22,-2,-81,-83,3258,6014,36465,151977,796
36049,"Lewis","New York",43.7844157,-75.44903992,19,0,0,19,"Lewis, New York, US",26296,-190,322,271,51,8,-250,-242,8042,17736,156407,659133,2751
47101,"Lewis","Tennessee",35.52853208,-87.49022694,3,0,0,3,"Lewis, Tennessee, US",12268,194,141,142,-1,-1,196,195,3261,7269,45179,198480,934
53041,"Lewis","Washington",46.57756476,-122.3925769,35,3,0,32,"Lewis, Washington, US",80707,1138,895,910,-15,65,1087,1152,26497,108785,908156,3961476,10744
54041,"Lewis","West Virginia",38.9947249,-80.49988181,5,1,0,4,"Lewis, West Virginia, US",15907,-110,139,224,-85,4,-29,-25,6681,18440,158893,659794,1803
30049,"Lewis and Clark","Montana",47.12610041,-112.394698,16,0,0,16,"Lewis and Clark, Montana, US",69432,810,742,653,89,-17,740,723,35712,133425,1259587,5194029,13327
45063,"Lexington","South Carolina",33.89665987,-81.27146426,548,29,0,519,"Lexington, South Carolina, US",298750,4400,3191,2555,636,372,3398,3770,113352,534570,4657847,19012243,38895
51678,"Lexington","Virginia",37.78258621,-79.44262866,6,0,0,6,"Lexington, Virginia, US",7446,149,115,58,57,0,91,91,5188,10838,86197,362098,1223
12077,"Liberty","Florida",30.23766008,-84.8829258,204,0,0,204,"Liberty, Florida, US",8354,-73,71,77,-6,-5,-62,-67,2432,3137,29022,114644,358
13179,"Liberty","Georgia",31.82588896,-81.49251135,64,0,0,64,"Liberty, Georgia, US",61435,829,1361,384,977,-45,-101,-146,35523,52420,430045,1748064,4590
30051,"Liberty","Montana",48.56084317,-111.024307,1,0,0,1,"Liberty, Montana, US",2337,-79,16,20,-4,-1,-73,-74,984,972,5125,23416,226
48291,"Liberty","Texas",30.15152688,-94.81205615,81,3,0,78,"Liberty, Texas, US",88219,2417,1208,828,380,-7,2050,2043,17939,65682,641654,2682841,5961
39089,"Licking","Ohio",40.09136236,-82.48185785,201,10,0,191,"Licking, Ohio, US",176862,1196,1924,1662,262,57,886,943,61650,266641,2398503,9962705,17518
1083,"Limestone","Alabama",34.81185586,-86.98310072,72,0,0,72,"Limestone, Alabama, US",98915,2738,1014,864,150,32,2545,2577,25357,80563,681745,2826087,7666
48293,"Limestone","Texas",31.5454767,-96.58095444,18,1,0,17,"Limestone, Texas, US",23437,94,253,279,-26,6,114,120,9459,19764,168921,644312,1993
5079,"Lincoln","Arkansas",33.95317155,-91.74002806,970,8,0,962,"Lincoln, Arkansas, US",13024,-160,100,146,-46,1,-113,-112,2841,5011,37008,151292,746
8073,"Lincoln","Colorado",38.98749519,-103.5136649,3,0,0,3,"Lincoln, Colorado, US",5701,95,61,44,17,4,73,77,2186,5461,40240,170796,592
13181,"Lincoln","Georgia",33.79201475,-82.45024131,15,0,0,15,"Lincoln, Georgia, US",7921,-4,75,94,-19,2,14,16,1389,3267,22286,91620,561
16063,"Lincoln","Idaho",43.0012336,-114.1358773,30,0,0,30,"Lincoln, Idaho, US",5366,-32,66,41,25,23,-78,-55,1436,1505,12206,54704,298
21137,"Lincoln","Kentucky",37.45475628,-84.6565327,8,1,0,7,"Lincoln, Kentucky, US",24549,-63,329,288,41,-1,-104,-105,4886,10239,62290,256553,1424
22061,"Lincoln","Louisiana",32.6003154,-92.6659741,133,14,0,119,"Lincoln, Louisiana, US",46742,-370,516,417,99,85,-556,-471,20919,77079,612108,2565141,6032
23015,"Lincoln","Maine",44.05996956,-69.54227124,19,0,0,19,"Lincoln, Maine, US",34634,235,307,425,-118,15,341,356,12970,44650,359917,1652792,7975
27081,"Lincoln","Minnesota",44.41311883,-96.26688165,5,0,0,5,"Lincoln, Minnesota, US",5639,-29,70,75,-5,0,-24,-24,2214,5192,32312,147187,918
28085,"Lincoln","Mississippi",31.53288662,-90.45391915,238,20,0,218,"Lincoln, Mississippi, US",34153,-57,413,403,10,6,-71,-65,11436,47025,393200,1585584,4306
29113,"Lincoln","Missouri",39.05345619,-90.95588181,106,1,0,105,"Lincoln, Missouri, US",59013,1400,790,467,323,2,1072,1074,12157,45621,363929,1577534,5014
30053,"Lincoln","Montana",48.54265777,-115.4046155,7,1,0,6,"Lincoln, Montana, US",19980,183,158,282,-124,9,297,306,6593,19500,121569,548416,3094
31111,"Lincoln","Nebraska",41.04658298,-100.7475374,47,2,0,45,"Lincoln, Nebraska, US",34914,-234,414,346,68,17,-320,-303,17927,57219,454090,1886332,5919
32017,"Lincoln","Nevada",37.64268459,-114.8790388,2,0,0,2,"Lincoln, Nevada, US",5183,-54,55,62,-7,-2,-47,-49,1601,1853,10776,46385,261
35027,"Lincoln","New Mexico",33.74526079,-105.4586166,3,0,0,3,"Lincoln, New Mexico, US",19572,54,174,207,-33,18,71,89,7284,24793,159480,678832,3553
37109,"Lincoln","North Carolina",35.48508185,-81.21740317,58,0,0,58,"Lincoln, North Carolina, US",86111,2019,834,891,-57,40,2031,2071,24752,91726,744223,3171618,9678
40081,"Lincoln","Oklahoma",35.70270942,-96.8812462,21,2,0,19,"Lincoln, Oklahoma, US",34877,40,354,379,-25,3,64,67,8687,25466,220219,933787,3035
41041,"Lincoln","Oregon",44.64252874,-123.869912,8,0,0,8,"Lincoln, Oregon, US",49962,738,385,609,-224,0,959,959,19216,73370,498256,2188913,8865
46083,"Lincoln","South Dakota",43.27841182,-96.7203905,225,0,0,225,"Lincoln, South Dakota, US",61128,2333,866,252,614,-17,1727,1710,16435,95649,967894,4197882,9471
47103,"Lincoln","Tennessee",35.13738622,-86.58910106,26,0,0,26,"Lincoln, Tennessee, US",34366,177,386,433,-47,14,212,226,9880,30088,245775,982201,2966
53043,"Lincoln","Washington",47.57705241,-118.4194388,2,0,0,2,"Lincoln, Washington, US",10939,213,105,118,-13,1,225,226,3578,7022,71972,320636,1171
54043,"Lincoln","West Virginia",38.172154,-82.07017953,5,0,0,5,"Lincoln, West Virginia, US",20409,-174,208,313,-105,-6,-62,-68,3137,9033,50411,201938,861
55069,"Lincoln","Wisconsin",45.33737523,-89.73411273,3,0,0,3,"Lincoln, Wisconsin, US",27593,-80,264,291,-27,0,-54,-54,11339,36459,308668,1245372,3673
56023,"Lincoln","Wyoming",42.26376367,-110.6563997,15,0,0,15,"Lincoln, Wyoming, US",19830,385,222,138,84,0,302,302,6928,19865,182307,786445,3739
19113,"Linn","Iowa",42.07923082,-91.59809485,922,75,0,847,"Linn, Iowa, US",226706,943,2734,1801,933,168,-149,19,123819,626302,7176100,28701137,33033
20107,"Linn","Kansas",38.21267844,-94.84254089,7,0,0,7,"Linn, Kansas, US",9703,-68,90,121,-31,0,-36,-36,2708,4240,35693,155694,879
29115,"Linn","Missouri",39.87001769,-93.10704106,5,1,0,4,"Linn, Missouri, US",11920,-119,124,163,-39,5,-84,-79,5046,11018,87185,338737,1345
41043,"Linn","Oregon",44.48899494,-122.5373154,112,9,0,103,"Linn, Oregon, US",129749,2298,1512,1310,202,21,2066,2087,43647,186061,1697362,7069693,15060
48295,"Lipscomb","Texas",36.27783108,-100.2733151,2,0,0,2,"Lipscomb, Texas, US",3233,-109,38,34,4,6,-119,-113,1437,2427,24227,115517,349
9005,"Litchfield","Connecticut",41.7937534,-73.2451475,1304,122,0,1182,"Litchfield, Connecticut, US",180333,-762,1382,1838,-456,263,-562,-299,69889,277018,2719258,11622958,27649
5081,"Little River","Arkansas",33.70375665,-94.23468591,1,0,0,1,"Little River, Arkansas, US",12259,-38,136,176,-40,-3,6,3,3871,8681,98429,355201,764
48297,"Live Oak","Texas",28.35101362,-98.1246786,9,0,0,9,"Live Oak, Texas, US",12207,59,129,106,23,12,26,38,5790,12365,146122,630812,1400
17105,"Livingston","Illinois",40.89188292,-88.55784752,31,2,0,29,"Livingston, Illinois, US",35648,-66,422,412,10,32,-106,-74,15359,48026,418892,1812403,4653
21139,"Livingston","Kentucky",37.21137452,-88.34797529,8,0,0,8,"Livingston, Kentucky, US",9194,-50,94,122,-28,0,-21,-21,2645,8144,77867,339975,636
22063,"Livingston","Louisiana",30.44143993,-90.73061664,366,26,0,340,"Livingston, Louisiana, US",140789,1395,1788,1170,618,-7,780,773,27644,108684,852465,3580223,10166
26093,"Livingston","Michigan",42.60302282,-83.91297209,390,26,0,364,"Livingston, Michigan, US",191995,805,1760,1607,153,53,611,664,57570,290631,2708223,11798048,25735
29117,"Livingston","Missouri",39.78110272,-93.54645978,3,0,0,3,"Livingston, Missouri, US",15227,46,153,165,-12,3,55,58,7253,18979,143544,581551,1877
36051,"Livingston","New York",42.72596275,-77.77966158,114,7,0,107,"Livingston, New York, US",62914,-299,478,552,-74,50,-276,-226,22468,66408,454013,2122694,6861
48299,"Llano","Texas",30.70645047,-98.68475262,3,0,0,3,"Llano, Texas, US",21795,195,161,348,-187,-4,383,379,6337,16116,108386,474039,2339
5083,"Logan","Arkansas",35.21413234,-93.71951016,4,0,0,4,"Logan, Arkansas, US",21466,-207,235,296,-61,10,-156,-146,6797,14635,106278,444642,1892
8075,"Logan","Colorado",40.7249637,-103.110817,493,3,0,490,"Logan, Colorado, US",22409,141,217,195,22,6,115,121,9908,22427,175443,738043,3001
17107,"Logan","Illinois",40.12581572,-89.36638784,10,0,0,10,"Logan, Illinois, US",28618,-294,286,334,-48,13,-258,-245,9609,31899,239768,985133,3009
21141,"Logan","Kentucky",36.85949479,-86.877635,115,3,0,112,"Logan, Kentucky, US",27102,119,360,307,53,-3,70,67,8634,28360,277620,1184735,2471
31113,"Logan","Nebraska",41.56650314,-100.4817851,0,0,0,0,"Logan, Nebraska, US",748,-7,6,8,-2,2,-6,-4,355,117,557,2107,44
39091,"Logan","Ohio",40.38996525,-83.76784341,38,0,0,38,"Logan, Ohio, US",45672,340,547,496,51,-2,294,292,19255,61717,586092,2480976,4432
40083,"Logan","Oklahoma",35.91899576,-97.44352845,18,1,0,17,"Logan, Oklahoma, US",48011,763,494,371,123,1,639,640,9109,31288,236411,1025734,4590
54045,"Logan","West Virginia",37.8299889,-81.93528571,16,1,0,15,"Logan, West Virginia, US",32019,-590,349,487,-138,-1,-452,-453,12360,40266,394921,1642132,3145
13183,"Long","Georgia",31.75218791,-81.74952375,12,1,0,11,"Long, Georgia, US",19559,468,270,113,157,1,310,311,1565,1179,6306,27354,269
5085,"Lonoke","Arkansas",34.75392199,-91.88742357,46,0,0,46,"Lonoke, Arkansas, US",73309,-82,858,690,168,-12,-242,-254,16567,54762,415972,1717746,5768
39093,"Lorain","Ohio",41.29553751,-82.15083537,637,59,0,578,"Lorain, Ohio, US",309833,781,3175,3093,82,108,612,720,105425,463452,4558273,18825061,33104
35028,"Los Alamos","New Mexico",35.86631386,-106.3134985,6,0,0,6,"Los Alamos, New Mexico, US",19369,381,173,111,62,62,256,318,16406,48487,1017280,3966767,1861
6037,"Los Angeles","California",34.30828379,-118.2282411,44121,2092,0,42029,"Los Angeles, California, US",10039107,-34799,112963,68164,44799,21050,-100808,-79758,4665782,22840826,329557330,1340814456,1650309
47105,"Loudon","Tennessee",35.73939663,-84.31145275,131,0,0,131,"Loudon, Tennessee, US",54068,986,483,612,-129,30,1082,1112,15484,60550,485854,2125302,5121
51107,"Loudoun","Virginia",39.08990083,-77.63481877,1831,52,0,1779,"Loudoun, Virginia, US",413538,8016,5016,1602,3414,1039,3566,4605,155439,915577,13306557,53377373,63167
19115,"Louisa","Iowa",41.21842119,-91.26102611,334,7,0,327,"Louisa, Iowa, US",11035,-118,128,113,15,17,-151,-134,3980,9253,80658,307286,947
51109,"Louisa","Virginia",37.97850256,-77.96274807,67,1,0,66,"Louisa, Virginia, US",37591,807,388,383,5,0,799,799,9587,23710,203191,836822,3009
40085,"Love","Oklahoma",33.95273467,-97.23906784,14,0,0,14,"Love, Oklahoma, US",10253,97,113,112,1,6,90,96,5471,12595,97788,382986,578
1085,"Lowndes","Alabama",32.1597283,-86.65158371,182,10,0,172,"Lowndes, Alabama, US",9726,-248,116,141,-25,-1,-223,-224,2379,4171,39910,169417,408
13185,"Lowndes","Georgia",30.83568832,-83.27056716,233,4,0,229,"Lowndes, Georgia, US",117406,1097,1643,993,650,112,336,448,54979,208724,1600161,6694720,16235
28087,"Lowndes","Mississippi",33.47386518,-88.4419153,158,7,0,151,"Lowndes, Mississippi, US",58595,-165,774,610,164,89,-417,-328,27333,101187,904741,3667766,8276
48303,"Lubbock","Texas",33.61008596,-101.8204789,656,50,0,606,"Lubbock, Texas, US",310569,2942,3936,2609,1327,250,1366,1616,140390,639289,5468208,22908503,42700
19117,"Lucas","Iowa",41.02958964,-93.32780803,4,0,0,4,"Lucas, Iowa, US",8600,-17,118,91,27,-2,-42,-44,3758,7482,57644,234145,753
39095,"Lucas","Ohio",41.62101218,-83.65468618,2087,228,0,1859,"Lucas, Ohio, US",428348,-1264,5298,4561,737,182,-2187,-2005,208039,1089559,12524430,48549815,57381
26095,"Luce","Michigan",46.47227431,-85.54471223,3,0,0,3,"Luce, Michigan, US",6229,-98,60,83,-23,1,-74,-73,2416,5662,40342,172207,699
13187,"Lumpkin","Georgia",34.57286511,-84.00425681,88,1,0,87,"Lumpkin, Georgia, US",33610,711,279,300,-21,-13,738,725,9421,20756,144102,602067,2644
35029,"Luna","New Mexico",32.18179341,-107.7508826,8,1,0,7,"Luna, New Mexico, US",23709,-168,346,281,65,16,-247,-231,8237,18592,107721,448489,1901
51111,"Lunenburg","Virginia",36.94618528,-78.24133319,7,0,0,7,"Lunenburg, Virginia, US",12196,-19,117,159,-42,8,17,25,2636,5944,40267,171959,763
42079,"Luzerne","Pennsylvania",41.17823008,-75.98447579,2631,135,0,2496,"Luzerne, Pennsylvania, US",317417,-442,3241,3953,-712,732,-447,285,145456,764550,7354445,29954240,42677
42081,"Lycoming","Pennsylvania",41.34310539,-77.06629984,158,13,0,145,"Lycoming, Pennsylvania, US",113299,-567,1133,1320,-187,65,-444,-379,56224,220815,1909699,8122886,15642
46085,"Lyman","South Dakota",43.89522709,-99.85201878,11,0,0,11,"Lyman, South Dakota, US",3781,-23,65,25,40,0,-62,-62,1629,2687,12520,58388,327
51680,"Lynchburg","Virginia",37.40021399,-79.19888138,77,1,0,76,"Lynchburg, Virginia, US",82168,859,1197,792,405,205,248,453,56516,292895,2731766,11197394,12863
48305,"Lynn","Texas",33.17657705,-101.8162849,5,1,0,4,"Lynn, Texas, US",5951,103,71,43,28,1,75,76,1558,1800,15477,65805,318
19119,"Lyon","Iowa",43.38107862,-96.20926845,19,0,0,19,"Lyon, Iowa, US",11755,-60,171,115,56,5,-120,-115,4702,14156,110926,497701,2057
20111,"Lyon","Kansas",38.45576156,-96.15275715,328,3,0,325,"Lyon, Kansas, US",33195,-105,389,276,113,47,-265,-218,15935,52440,389996,1649603,4537
21143,"Lyon","Kentucky",37.02080035,-88.07886257,14,3,0,11,"Lyon, Kentucky, US",8210,39,45,122,-77,-3,120,117,1974,5169,29901,136932,662
27083,"Lyon","Minnesota",44.41327865,-95.83806103,31,0,0,31,"Lyon, Minnesota, US",25474,-109,343,228,115,94,-319,-225,15455,51511,484331,1895635,4348
32019,"Lyon","Nevada",39.01777974,-119.1870479,51,0,0,51,"Lyon, Nevada, US",57510,1697,664,619,45,-46,1691,1645,12474,46842,389154,1666627,4278
26097,"Mackinac","Michigan",46.07028979,-85.04980537,6,0,0,6,"Mackinac, Michigan, US",10799,18,88,138,-50,27,41,68,4509,9663,69117,568910,2255
26099,"Macomb","Michigan",42.69158356,-82.92752801,6482,778,0,5704,"Macomb, Michigan, US",873972,1177,9132,8548,584,1281,-653,628,329202,1803033,20165093,83420942,114696
1087,"Macon","Alabama",32.38759944,-85.69267724,58,2,0,56,"Macon, Alabama, US",18068,-253,172,264,-92,1,-162,-161,6090,12276,106420,453715,873
13193,"Macon","Georgia",32.35207048,-84.04234127,95,6,0,89,"Macon, Georgia, US",12947,-213,124,160,-36,4,-182,-178,3616,6441,52484,212144,743
17115,"Macon","Illinois",39.86064913,-88.96342505,187,18,0,169,"Macon, Illinois, US",104009,-495,1258,1223,35,34,-564,-530,53752,219625,2397177,9964142,13859
29121,"Macon","Missouri",39.83049768,-92.56453089,2,0,0,2,"Macon, Missouri, US",15117,-50,182,193,-11,6,-44,-38,5422,13703,90051,373398,1665
37113,"Macon","North Carolina",35.14867843,-83.41696617,8,1,0,7,"Macon, North Carolina, US",35858,584,333,417,-84,44,622,666,12607,44487,331636,1455390,6085
47111,"Macon","Tennessee",36.53157855,-86.00778595,97,3,0,94,"Macon, Tennessee, US",24602,313,341,281,60,4,247,251,6043,14007,105844,431531,1477
17117,"Macoupin","Illinois",39.26119767,-89.92424028,41,1,0,40,"Macoupin, Illinois, US",44926,-392,447,561,-114,3,-282,-279,11722,35740,260578,1091202,4697
6039,"Madera","California",37.21513971,-119.7665589,82,2,0,80,"Madera, California, US",157327,445,2108,1060,1048,-139,-464,-603,44353,127706,1215070,5077514,11106
1089,"Madison","Alabama",34.76327133,-86.55069633,292,4,0,288,"Madison, Alabama, US",372909,5905,4242,3305,937,230,4721,4951,195636,898710,11494374,47322213,50246
5087,"Madison","Arkansas",36.01038185,-93.72524943,3,0,0,3,"Madison, Arkansas, US",16576,214,207,141,66,-5,152,147,4019,7890,54624,224886,928
12079,"Madison","Florida",30.44396917,-83.47398594,67,3,0,64,"Madison, Florida, US",18493,-47,177,239,-62,15,1,16,4637,11323,77811,332905,1420
13195,"Madison","Georgia",34.12920917,-83.21218732,37,1,0,36,"Madison, Georgia, US",29880,238,317,308,9,19,212,231,4483,8674,59776,252089,1762
16065,"Madison","Idaho",43.78141028,-111.6538474,20,0,0,20,"Madison, Idaho, US",39907,646,1108,141,967,-12,-305,-317,16780,54005,311629,1374751,4927
17119,"Madison","Illinois",38.83042506,-89.90422563,523,52,0,471,"Madison, Illinois, US",262966,-1060,2804,2944,-140,1,-920,-919,105508,485105,4567841,19121720,33984
18095,"Madison","Indiana",40.16143691,-85.71964711,576,58,0,518,"Madison, Indiana, US",129569,-4,1369,1445,-76,64,16,80,43335,169567,1389065,5684714,13001
19121,"Madison","Iowa",41.33081904,-94.01554631,22,1,0,21,"Madison, Iowa, US",16338,132,158,154,4,3,126,129,4008,11709,94749,420720,2035
21151,"Madison","Kentucky",37.71659336,-84.27220275,45,1,0,44,"Madison, Kentucky, US",92987,880,984,767,217,2,661,663,36394,112726,871163,3703923,9353
22065,"Madison","Louisiana",32.36918118,-91.23973355,54,0,0,54,"Madison, Louisiana, US",10951,-245,151,150,1,0,-247,-247,3422,10126,62033,249161,883
28089,"Madison","Mississippi",32.63389156,-90.03513564,639,21,0,618,"Madison, Mississippi, US",106272,624,1267,1107,160,121,344,465,53225,263211,2785215,11102810,18189
29123,"Madison","Missouri",37.47865134,-90.3467143,3,0,0,3,"Madison, Missouri, US",12088,-100,135,177,-42,-2,-55,-57,3732,10380,66459,266136,1207
30057,"Madison","Montana",45.30080065,-111.9173017,8,1,0,7,"Madison, Montana, US",8600,70,53,78,-25,0,95,95,3587,6967,51585,250000,1955
31119,"Madison","Nebraska",41.91676024,-97.6005481,296,3,0,293,"Madison, Nebraska, US",35099,-90,497,369,128,71,-291,-220,21463,84929,733693,3175166,7240
36053,"Madison","New York",42.91653905,-75.67266639,301,10,0,291,"Madison, New York, US",70941,-176,668,628,40,28,-242,-214,24062,76312,606287,2629300,7858
37115,"Madison","North Carolina",35.85402722,-82.71346418,4,0,0,4,"Madison, North Carolina, US",21755,90,198,240,-42,19,112,131,5845,9578,60370,259841,1572
39097,"Madison","Ohio",39.89381073,-83.40178317,132,7,0,125,"Madison, Ohio, US",44731,342,441,394,47,12,283,295,16585,63837,569616,2560908,3560
47113,"Madison","Tennessee",35.61181957,-88.84076036,164,2,0,162,"Madison, Tennessee, US",97984,381,1193,985,208,74,103,177,57490,262406,2291697,9753969,14534
48313,"Madison","Texas",30.96694679,-95.93003775,8,0,0,8,"Madison, Texas, US",14284,-79,170,138,32,10,-121,-111,4869,12198,99291,455737,1216
51113,"Madison","Virginia",38.41531222,-78.28220331,27,1,0,26,"Madison, Virginia, US",13261,13,129,128,1,11,2,13,3490,7877,56262,232705,1239
21153,"Magoffin","Kentucky",37.70820545,-83.0657714,2,0,0,2,"Magoffin, Kentucky, US",12161,-162,127,172,-45,1,-121,-120,2338,4711,33288,137132,662
19123,"Mahaska","Iowa",41.33521503,-92.64083907,51,5,0,46,"Mahaska, Iowa, US",22095,77,266,217,49,15,15,30,8618,25370,196739,839529,2842
27087,"Mahnomen","Minnesota",47.32557075,-95.80921485,5,1,0,4,"Mahnomen, Minnesota, US",5527,30,90,60,30,0,2,2,2576,3751,25031,110402,376
39099,"Mahoning","Ohio",41.01631101,-80.77287029,1317,169,0,1148,"Mahoning, Ohio, US",228683,-533,2355,2934,-579,22,38,60,101859,491785,4274211,17810211,32243
40093,"Major","Oklahoma",36.31149996,-98.53467076,6,1,0,5,"Major, Oklahoma, US",7629,2,102,90,12,11,-21,-10,3170,8529,87213,359750,1235
41045,"Malheur","Oregon",43.1937027,-117.6227395,28,0,0,28,"Malheur, Oregon, US",30571,18,396,260,136,-14,-103,-117,13899,39257,272124,1185593,3684
51683,"Manassas","Virginia",38.7464321,-77.48509905,792,7,0,785,"Manassas, Virginia, US",41085,39,750,207,543,98,-601,-503,23362,82522,899449,3727264,8513
51685,"Manassas Park","Virginia",38.77058531,-77.44399307,230,4,0,226,"Manassas Park, Virginia, US",17478,-240,14,37,-23,98,-314,-216,3179,14064,151636,663371,1640
12081,"Manatee","Florida",27.47196942,-82.31831044,958,91,0,867,"Manatee, Florida, US",403253,8866,3482,4334,-852,710,8954,9664,116609,573559,5181909,21554249,54247
26101,"Manistee","Michigan",44.33352407,-86.05626916,11,0,0,11,"Manistee, Michigan, US",24558,103,216,308,-92,12,184,196,8447,24462,178732,806044,2933
55071,"Manitowoc","Wisconsin",44.11946801,-87.80928853,28,1,0,27,"Manitowoc, Wisconsin, US",78981,-34,757,816,-59,67,-36,31,36782,142233,1311051,5411209,10011
55073,"Marathon","Wisconsin",44.89792533,-89.75863384,38,1,0,37,"Marathon, Wisconsin, US",135692,271,1480,1116,364,66,-154,-88,71066,338522,3377142,14203044,19785
1091,"Marengo","Alabama",32.24767634,-87.78796182,132,6,0,126,"Marengo, Alabama, US",18863,-193,209,276,-67,3,-129,-126,6373,24672,202703,814639,2326
4013,"Maricopa","Arizona",33.34835867,-112.4918154,8177,383,0,7794,"Maricopa, Arizona, US",4485414,83011,52722,33023,19699,5520,57477,62997,1832427,9936948,125106309,490758333,566774
29125,"Maries","Missouri",38.16193985,-91.92249662,2,0,0,2,"Maries, Missouri, US",8697,-73,76,91,-15,4,-61,-57,1404,3040,20141,84742,536
6041,"Marin","California",38.07122463,-122.7210631,369,14,0,355,"Marin, California, US",258826,-836,2149,1998,151,432,-1416,-984,128242,582035,9097234,37251656,59842
55075,"Marinette","Wisconsin",45.38553432,-88.033246,31,2,0,29,"Marinette, Wisconsin, US",40350,-52,375,487,-112,3,60,63,20097,67707,588502,2491988,6020
1093,"Marion","Alabama",34.13697363,-87.88704173,109,10,0,99,"Marion, Alabama, US",29709,-41,302,405,-103,3,62,65,10606,32491,235551,966434,2974
5089,"Marion","Arkansas",36.26844485,-92.68451899,1,0,0,1,"Marion, Arkansas, US",16694,29,141,278,-137,-4,172,168,4527,8200,53772,216939,925
12083,"Marion","Florida",29.21227113,-82.05803627,233,5,0,228,"Marion, Florida, US",365579,6517,3495,5162,-1667,15,8136,8151,104886,457711,3809619,15725562,42537
13197,"Marion","Georgia",32.3483402,-84.52733571,49,2,0,47,"Marion, Georgia, US",8359,-14,86,90,-4,-3,-8,-11,2195,2896,19451,69790,309
17121,"Marion","Illinois",38.64963204,-88.91899208,50,0,0,50,"Marion, Illinois, US",37205,-176,451,461,-10,10,-176,-166,15683,46441,366977,1509461,4834
18097,"Marion","Indiana",39.78163624,-86.13826325,9040,531,0,8509,"Marion, Indiana, US",964582,5882,14203,8190,6013,4759,-4866,-107,554531,3111013,40978445,160545980,140153
19125,"Marion","Iowa",41.33445101,-93.09934783,29,0,0,29,"Marion, Iowa, US",33253,-6,340,327,13,4,-23,-19,17721,58266,535780,2275589,4443
20115,"Marion","Kansas",38.35855394,-97.0985251,5,1,0,4,"Marion, Kansas, US",11884,-39,107,142,-35,5,-10,-5,4321,9548,61323,259464,1401
21155,"Marion","Kentucky",37.55218078,-85.26898542,18,0,0,18,"Marion, Kentucky, US",19273,-53,236,197,39,-4,-88,-92,8396,37052,316288,1348168,1638
28091,"Marion","Mississippi",31.23132643,-89.8209217,104,8,0,96,"Marion, Mississippi, US",24573,-179,278,307,-29,5,-154,-149,8994,30393,236824,984200,2911
29127,"Marion","Missouri",39.80601912,-91.62203062,5,0,0,5,"Marion, Missouri, US",28530,-10,346,310,36,12,-56,-44,15085,54193,430299,1791539,4365
39101,"Marion","Ohio",40.58610662,-83.15736305,2608,21,0,2587,"Marion, Ohio, US",65093,-334,734,731,3,28,-364,-336,25304,93699,813985,3316705,6195
41047,"Marion","Oregon",44.90287942,-122.5815117,898,25,0,873,"Marion, Oregon, US",347818,2406,4410,2893,1517,17,875,892,140894,611594,5559122,24018068,49053
45067,"Marion","South Carolina",34.07859748,-79.36400756,63,5,0,58,"Marion, South Carolina, US",30657,-399,341,444,-103,6,-302,-296,7715,24189,159622,658569,2538
47115,"Marion","Tennessee",35.12997174,-85.62265895,36,1,0,35,"Marion, Tennessee, US",28907,309,325,358,-33,1,340,341,8439,25305,193719,812704,2137
48315,"Marion","Texas",32.79868409,-94.3566123,15,0,0,15,"Marion, Texas, US",9854,-61,70,138,-68,0,9,9,2204,7166,51652,212862,646
54049,"Marion","West Virginia",39.50984542,-80.24244659,48,2,0,46,"Marion, West Virginia, US",56072,-19,594,673,-79,-17,79,62,20493,68488,586947,2432747,6512
6043,"Mariposa","California",37.57978556,-119.9073334,15,1,0,14,"Mariposa, California, US",17203,-202,149,180,-31,9,-179,-170,5959,11336,77728,363726,1534
45069,"Marlboro","South Carolina",34.59905577,-79.67561152,109,0,0,109,"Marlboro, South Carolina, US",26118,-274,270,310,-40,1,-234,-233,7827,16608,133171,533377,1521
26103,"Marquette","Michigan",46.4338914,-87.64043701,53,10,0,43,"Marquette, Michigan, US",66699,318,570,679,-109,30,397,427,29433,103055,915110,3793667,9323
55077,"Marquette","Wisconsin",43.81911946,-89.40073763,3,1,0,2,"Marquette, Wisconsin, US",15574,156,135,169,-34,1,187,188,4281,10382,80265,316670,1291
1095,"Marshall","Alabama",34.36975964,-86.30486727,644,9,0,635,"Marshall, Alabama, US",96774,604,1395,1155,240,65,303,368,37505,163356,1314361,5248821,10381
17123,"Marshall","Illinois",41.0327901,-89.34510444,5,0,0,5,"Marshall, Illinois, US",11438,-45,117,151,-34,1,-11,-10,3969,10325,80593,341371,1227
18099,"Marshall","Indiana",41.32467367,-86.26185087,61,1,0,60,"Marshall, Indiana, US",46258,-38,582,477,105,56,-199,-143,19452,78290,647342,2700508,5680
19127,"Marshall","Iowa",42.03586837,-92.9990819,859,10,0,849,"Marshall, Iowa, US",39369,-519,514,478,36,35,-591,-556,18919,51335,478857,2015983,4152
21157,"Marshall","Kentucky",36.8800707,-88.32803576,37,2,0,35,"Marshall, Kentucky, US",31100,-102,296,435,-139,1,37,38,11541,49014,524520,2103054,3675
27089,"Marshall","Minnesota",48.35825983,-96.37017407,8,0,0,8,"Marshall, Minnesota, US",9336,-47,106,86,20,2,-69,-67,3034,6138,52904,256478,1234
28093,"Marshall","Mississippi",34.76216286,-89.50299462,69,3,0,66,"Marshall, Mississippi, US",35294,-142,393,446,-53,-5,-81,-86,7935,27534,234861,967326,2151
40095,"Marshall","Oklahoma",34.02311222,-96.76855464,7,0,0,7,"Marshall, Oklahoma, US",16931,204,200,170,30,5,168,173,5017,15807,125147,478217,1374
46091,"Marshall","South Dakota",45.75870838,-97.59855639,4,0,0,4,"Marshall, South Dakota, US",4935,14,73,41,32,2,-20,-18,2082,3717,27319,117556,608
47117,"Marshall","Tennessee",35.45798777,-86.76420988,28,1,0,27,"Marshall, Tennessee, US",34375,569,411,344,67,15,485,500,10165,29569,230799,994911,2477
54051,"Marshall","West Virginia",39.86064362,-80.66591062,27,0,0,27,"Marshall, West Virginia, US",30531,-290,276,388,-112,0,-177,-177,11498,31800,306395,1230657,2467
12085,"Martin","Florida",27.0772071,-80.43109784,483,9,0,474,"Martin, Florida, US",161000,258,1258,2026,-768,71,962,1033,61873,317311,2914182,12115472,32702
18101,"Martin","Indiana",38.7099921,-86.80373186,10,0,0,10,"Martin, Indiana, US",10255,36,111,102,9,-1,30,29,8073,10686,127856,500524,949
21159,"Martin","Kentucky",37.79990579,-82.51247478,3,0,0,3,"Martin, Kentucky, US",11195,-130,99,148,-49,-1,-81,-82,2606,6466,52058,192351,638
27091,"Martin","Minnesota",43.67429718,-94.55099908,124,5,0,119,"Martin, Minnesota, US",19683,-89,234,224,10,1,-98,-97,9692,32073,294883,1321090,3239
37117,"Martin","North Carolina",35.84326734,-77.10860251,52,4,0,48,"Martin, North Carolina, US",22440,-220,246,313,-67,-1,-152,-153,7656,22585,137921,579681,2173
48317,"Martin","Texas",32.30600051,-101.9513518,3,1,0,2,"Martin, Texas, US",5771,90,86,50,36,0,57,57,2427,3411,38685,167009,408
51690,"Martinsville","Virginia",36.68212094,-79.86352771,24,1,0,23,"Martinsville, Virginia, US",12554,-73,183,239,-56,10,-27,-17,8380,37647,278975,1141417,2752
17125,"Mason","Illinois",40.23917274,-89.91824452,17,0,0,17,"Mason, Illinois, US",13359,-174,127,175,-48,0,-128,-128,4605,9139,70623,302887,1319
21161,"Mason","Kentucky",38.59471935,-83.82151043,8,0,0,8,"Mason, Kentucky, US",17070,-10,208,190,18,11,-37,-26,8841,27807,221593,917259,2127
26105,"Mason","Michigan",43.99509218,-86.24988902,31,0,0,31,"Mason, Michigan, US",29144,60,285,306,-21,4,79,83,11707,39026,302731,1356675,3680
48319,"Mason","Texas",30.71780434,-99.22629416,31,0,0,31,"Mason, Texas, US",4274,15,34,41,-7,7,15,22,1849,2996,18060,77330,565
53045,"Mason","Washington",47.35007586,-123.1863685,34,1,0,33,"Mason, Washington, US",66768,1388,666,669,-3,130,1258,1388,16593,43761,380348,1638798,5867
54053,"Mason","West Virginia",38.77071799,-82.02524219,15,0,0,15,"Mason, West Virginia, US",26516,-236,262,367,-105,-3,-126,-129,6848,12462,111307,460741,1598
17127,"Massac","Illinois",37.22078441,-88.71036614,7,0,0,7,"Massac, Illinois, US",13772,-251,138,178,-40,-3,-207,-210,4042,10290,86579,336661,1027
48321,"Matagorda","Texas",28.81955746,-96.01230294,67,5,0,62,"Matagorda, Texas, US",36643,77,520,371,149,7,-79,-72,14467,33500,369402,1471722,3824
2170,"Matanuska-Susitna","Alaska",62.31305045,-149.5741743,24,1,0,23,"Matanuska-Susitna, Alaska, US",108317,1202,1368,646,722,16,466,482,26553,100641,946984,4320693,13168
51115,"Mathews","Virginia",37.44164146,-76.34098896,5,0,0,5,"Mathews, Virginia, US",8834,42,67,126,-59,1,103,104,2122,3979,20323,89760,797
15009,"Maui","Hawaii",20.86399628,-156.5689097,118,6,0,112,"Maui, Hawaii, US",167417,445,1834,1446,388,582,-517,65,79181,375880,3670834,15406255,27762
47119,"Maury","Tennessee",35.6187413,-87.07462444,78,0,0,78,"Maury, Tennessee, US",96387,2114,1244,937,307,19,1778,1797,33077,142913,1492502,5747786,10091
48323,"Maverick","Texas",28.7429195,-100.3157686,94,1,0,93,"Maverick, Texas, US",58722,446,1042,393,649,79,-283,-204,16895,60551,343321,1464897,4354
40097,"Mayes","Oklahoma",36.30179091,-95.23175116,29,4,0,25,"Mayes, Oklahoma, US",41100,-110,459,534,-75,11,-45,-34,14920,44885,382680,1589917,4050
40087,"McClain","Oklahoma",35.01123903,-97.44572302,97,2,0,95,"McClain, Oklahoma, US",40474,587,414,386,28,9,551,560,10397,35903,275372,1192665,4799
46087,"McCook","South Dakota",43.6742571,-97.36863144,5,1,0,4,"McCook, South Dakota, US",5586,-15,90,65,25,4,-44,-40,1910,3947,28249,122585,890
45065,"McCormick","South Carolina",33.90161443,-82.30794338,8,1,0,7,"McCormick, South Carolina, US",9463,55,53,153,-100,-1,157,156,2102,2695,17690,68989,319
21145,"McCracken","Kentucky",37.05350953,-88.70445755,87,2,0,85,"McCracken, Kentucky, US",65418,111,734,823,-89,-9,213,204,40001,181216,1711440,6959224,12046
21147,"McCreary","Kentucky",36.73874143,-84.48102924,13,0,0,13,"McCreary, Kentucky, US",17231,-59,191,192,-1,-4,-54,-58,2914,6511,36670,143221,772
48307,"McCulloch","Texas",31.1925468,-99.34682807,3,0,0,3,"McCulloch, Texas, US",7984,2,86,108,-22,3,22,25,3787,9304,102057,400788,992
40089,"McCurtain","Oklahoma",34.11664328,-94.77222373,23,0,0,23,"McCurtain, Oklahoma, US",32832,-135,444,429,15,89,-238,-149,11695,38489,292200,1194925,3203
29119,"McDonald","Missouri",36.62869595,-94.34867205,15,0,0,15,"McDonald, Missouri, US",22837,-126,364,220,144,24,-293,-269,6941,15812,126349,484068,1433
17109,"McDonough","Illinois",40.45674722,-90.67775541,79,4,0,75,"McDonough, Illinois, US",29682,-302,258,296,-38,77,-344,-267,15176,37757,246362,1055025,3511
37111,"McDowell","North Carolina",35.67736232,-82.0482425,38,1,0,37,"McDowell, North Carolina, US",45756,291,437,513,-76,39,329,368,15694,52965,484416,1778420,3890
54047,"McDowell","West Virginia",37.38002939,-81.65083669,6,0,0,6,"McDowell, West Virginia, US",17624,-597,174,328,-154,-1,-442,-443,5077,8620,65105,280909,1095
13189,"McDuffie","Georgia",33.47851918,-82.48252774,62,5,0,57,"McDuffie, Georgia, US",21312,-220,261,251,10,-11,-220,-231,7462,25147,182107,751886,2069
17111,"McHenry","Illinois",42.32451172,-88.45248227,1360,67,0,1293,"McHenry, Illinois, US",307774,-477,3090,2198,892,7,-1381,-1374,106479,470278,4877628,20784789,47183
38049,"McHenry","North Dakota",48.23104458,-100.6324822,2,1,0,1,"McHenry, North Dakota, US",5745,-63,64,60,4,0,-67,-67,1718,2494,21889,94678,534
13191,"McIntosh","Georgia",31.49683595,-81.40163426,11,0,0,11,"McIntosh, Georgia, US",14378,56,111,141,-30,-1,86,85,3036,5243,26728,111568,756
38051,"McIntosh","North Dakota",46.11182017,-99.44145858,1,0,0,1,"McIntosh, North Dakota, US",2497,-69,26,46,-20,0,-49,-49,1423,2432,19637,83470,389
40091,"McIntosh","Oklahoma",35.37235506,-95.66599306,11,1,0,10,"McIntosh, Oklahoma, US",19596,-149,183,318,-135,1,-13,-12,5207,13875,95629,396818,1730
42083,"McKean","Pennsylvania",41.80938602,-78.56478358,11,1,0,10,"McKean, Pennsylvania, US",40625,-325,367,507,-140,1,-185,-184,17032,53234,422989,1734062,5376
38053,"McKenzie","North Dakota",47.7413337,-103.395905,16,0,0,16,"McKenzie, North Dakota, US",15024,1430,264,64,200,-6,1232,1226,7664,29482,537244,2237322,2553
35031,"McKinley","New Mexico",35.5800772,-108.262245,2086,87,0,1999,"McKinley, New Mexico, US",71367,-544,817,642,175,17,-738,-721,22773,86764,677552,2699060,5486
17113,"McLean","Illinois",40.48996987,-88.84621113,202,9,0,193,"McLean, Illinois, US",171517,-893,1877,1246,631,567,-2102,-1535,94408,333492,3764470,14064287,21092
21149,"McLean","Kentucky",37.5301951,-87.26803443,19,1,0,18,"McLean, Kentucky, US",9207,-51,108,113,-5,0,-44,-44,2363,4096,31583,132973,738
38055,"McLean","North Dakota",47.60766714,-101.3182418,7,0,0,7,"McLean, North Dakota, US",9450,-79,111,98,13,1,-93,-92,4537,8712,87012,374073,1315
48309,"McLennan","Texas",31.55255453,-97.20217694,102,4,0,98,"McLennan, Texas, US",256623,2427,3460,2231,1229,164,1033,1197,111938,555265,4960627,20799899,31254
27085,"McLeod","Minnesota",44.82367677,-94.27287017,26,0,0,26,"McLeod, Minnesota, US",35893,66,372,325,47,5,17,22,17414,64205,579977,2494270,5103
47107,"McMinn","Tennessee",35.42812616,-84.61520715,133,13,0,120,"McMinn, Tennessee, US",53794,458,591,656,-65,73,453,526,19614,70511,583515,2435690,4890
47109,"McNairy","Tennessee",35.17468549,-88.5647812,12,0,0,12,"McNairy, Tennessee, US",25694,-136,263,366,-103,2,-33,-31,6736,17632,125722,491539,1954
20113,"McPherson","Kansas",38.39184858,-97.64769869,27,0,0,27,"McPherson, Kansas, US",28542,14,305,336,-31,0,47,47,16387,59964,547989,2246186,4879
31117,"McPherson","Nebraska",41.56797682,-101.0599362,0,0,0,0,"McPherson, Nebraska, US",494,4,3,2,1,0,2,2,130,24,120,504,7
46089,"McPherson","South Dakota",45.76626028,-99.22118798,1,0,0,1,"McPherson, South Dakota, US",2379,-22,19,20,-1,-1,-19,-20,962,857,6234,25225,244
20119,"Meade","Kansas",37.23859987,-100.364831,24,0,0,24,"Meade, Kansas, US",4033,-65,38,34,4,7,-78,-71,1953,3013,25091,104036,521
21163,"Meade","Kentucky",37.96163597,-86.21028219,21,2,0,19,"Meade, Kentucky, US",28572,-51,271,253,18,-14,-54,-68,5206,14411,105804,427151,1542
46093,"Meade","South Dakota",44.56676791,-102.7162741,7,0,0,7,"Meade, South Dakota, US",28332,128,257,207,50,-9,87,78,8428,24659,209893,933899,3757
30059,"Meagher","Montana",46.59907074,-110.8898557,1,0,0,1,"Meagher, Montana, US",1862,5,12,17,-5,1,9,10,864,924,3901,18174,231
37119,"Mecklenburg","North Carolina",35.24469268,-80.8317671,3142,73,0,3069,"Mecklenburg, North Carolina, US",1110356,16606,14736,6883,7853,4335,4382,8717,623716,3515879,60242183,213667757,192063
51117,"Mecklenburg","Virginia",36.67882005,-78.36131056,193,20,0,173,"Mecklenburg, Virginia, US",30587,-37,312,482,-170,-2,136,134,13208,39931,275630,1178665,4202
26107,"Mecosta","Michigan",43.64064262,-85.32463223,19,2,0,17,"Mecosta, Michigan, US",43453,53,396,357,39,19,-4,15,16187,40905,282768,1282424,3771
39103,"Medina","Ohio",41.11770589,-81.8998621,274,19,0,255,"Medina, Ohio, US",179746,768,1674,1541,133,12,635,647,61360,293924,2881268,11790930,23317
48325,"Medina","Texas",29.3557301,-99.11030298,64,2,0,62,"Medina, Texas, US",51584,722,595,454,141,4,578,582,11698,36907,288811,1229602,4172
27093,"Meeker","Minnesota",45.12328869,-94.52839455,43,0,0,43,"Meeker, Minnesota, US",23222,77,268,216,52,15,11,26,8348,28851,235930,998336,3007
39105,"Meigs","Ohio",39.09224872,-82.0305041,6,0,0,6,"Meigs, Ohio, US",22907,-157,243,307,-64,-3,-89,-92,4083,11377,71505,304778,1552
47121,"Meigs","Tennessee",35.51558739,-84.81482914,25,0,0,25,"Meigs, Tennessee, US",12422,125,133,154,-21,-2,148,146,1931,3962,29693,128171,405
17129,"Menard","Illinois",40.02742725,-89.80246001,17,0,0,17,"Menard, Illinois, US",12196,-93,122,127,-5,-4,-85,-89,2394,5160,39211,163682,890
6045,"Mendocino","California",39.4381191,-123.3911313,21,0,0,21,"Mendocino, California, US",86749,-652,933,860,73,-60,-660,-720,36195,126691,1068469,4600949,14168
21165,"Menifee","Kentucky",37.94090733,-83.59985712,8,0,0,8,"Menifee, Kentucky, US",6489,52,61,91,-30,0,82,82,1223,1088,6404,27873,145
26109,"Menominee","Michigan",45.58038692,-87.55370409,8,0,0,8,"Menominee, Michigan, US",22780,-147,166,233,-67,-2,-75,-77,7598,21161,161010,675018,2167
55078,"Menominee","Wisconsin",45.00422544,-88.70950714,2,0,0,2,"Menominee, Wisconsin, US",4556,-39,84,69,15,0,-53,-53,2432,1206,7786,31760,58
6047,"Merced","California",37.18922369,-120.7209035,251,6,0,245,"Merced, California, US",277680,3529,4086,1787,2299,-144,1381,1237,79326,237521,1949939,8451572,18073
17131,"Mercer","Illinois",41.20596782,-90.74290052,14,0,0,14,"Mercer, Illinois, US",15437,-114,140,194,-54,0,-60,-60,3569,9172,67848,284588,1302
21167,"Mercer","Kentucky",37.81474237,-84.87488475,12,0,0,12,"Mercer, Kentucky, US",21933,231,248,298,-50,6,276,282,7378,16035,137333,552842,1661
34021,"Mercer","New Jersey",40.28047017,-74.70479631,6351,447,0,5904,"Mercer, New Jersey, US",367430,-758,4021,2987,1034,1182,-2997,-1815,226360,1080453,21868364,74608119,57894
38057,"Mercer","North Dakota",47.31213126,-101.8318399,5,0,0,5,"Mercer, North Dakota, US",8187,-79,88,81,7,-4,-82,-86,4924,13331,179636,723771,1137
39107,"Mercer","Ohio",40.54043046,-84.62912742,178,3,0,175,"Mercer, Ohio, US",41172,220,644,385,259,7,-44,-37,17791,71242,637117,2775783,5439
42085,"Mercer","Pennsylvania",41.30248872,-80.25816981,103,4,0,99,"Mercer, Pennsylvania, US",109424,-1047,1056,1431,-375,20,-691,-671,51041,246079,2039070,8679824,16026
54055,"Mercer","West Virginia",37.40481169,-81.11023142,13,0,0,13,"Mercer, West Virginia, US",58758,-444,661,891,-230,-9,-202,-211,22435,79727,653175,2782739,6744
13199,"Meriwether","Georgia",33.04163534,-84.68859732,78,2,0,76,"Meriwether, Georgia, US",21167,73,239,268,-29,0,102,102,5661,12392,99533,409895,1395
31121,"Merrick","Nebraska",41.16624273,-98.0374887,32,0,0,32,"Merrick, Nebraska, US",7755,22,86,81,5,0,19,19,3186,6692,51663,229120,1087
33013,"Merrimack","New Hampshire",43.29662971,-71.6811573,312,13,0,299,"Merrimack, New Hampshire, US",151391,741,1305,1388,-83,279,551,830,78884,362063,3884744,16646677,24072
8077,"Mesa","Colorado",39.01787888,-108.469799,54,0,0,54,"Mesa, Colorado, US",154210,1259,1631,1515,116,-13,1150,1137,64374,295475,2973268,12482197,26133
21169,"Metcalfe","Kentucky",36.99459295,-85.63123699,4,0,0,4,"Metcalfe, Kentucky, US",10071,1,113,128,-15,-1,17,16,2864,3562,23426,94998,466
18103,"Miami","Indiana",40.76940965,-86.04525048,135,1,0,134,"Miami, Indiana, US",35516,-130,382,364,18,26,-175,-149,9939,29213,220123,925911,3058
20121,"Miami","Kansas",38.56383358,-94.83832189,6,0,0,6,"Miami, Kansas, US",34237,500,390,294,96,12,392,404,8704,29733,240213,1029562,3902
39109,"Miami","Ohio",40.0543329,-84.22871271,346,30,0,316,"Miami, Ohio, US",106987,945,1153,1050,103,43,807,850,41725,181092,1632525,6704662,11957
12086,"Miami-Dade","Florida",25.6112362,-80.55170587,16694,629,0,16065,"Miami-Dade, Florida, US",2716940,2086,30789,21689,9100,38016,-45174,-7158,1254642,5851005,72024956,282314494,508231
9007,"Middlesex","Connecticut",41.45949668,-72.53714864,999,136,0,863,"Middlesex, Connecticut, US",162436,-434,1248,1552,-304,237,-359,-122,71611,334245,3762565,15534456,24609
25017,"Middlesex","Massachusetts",42.48607732,-71.39049229,20232,1512,0,18720,"Middlesex, Massachusetts, US",1611699,3229,16755,11911,4844,8965,-10597,-1632,886409,5319779,108494701,418078085,267593
34023,"Middlesex","New Jersey",40.43629879,-74.41426991,15215,942,0,14273,"Middlesex, New Jersey, US",825062,-1110,8907,6284,2623,3354,-7130,-3776,377619,2318189,38275805,145827723,130550
51119,"Middlesex","Virginia",37.63191998,-76.55064617,12,0,0,12,"Middlesex, Virginia, US",10582,-151,88,147,-59,1,-92,-91,3280,10042,67245,297573,1596
26111,"Midland","Michigan",43.64330771,-84.38804374,79,8,0,71,"Midland, Michigan, US",83156,-67,855,743,112,64,-241,-177,39726,153563,2152866,7917187,11141
48329,"Midland","Texas",31.86904128,-102.0315682,123,12,0,111,"Midland, Texas, US",176832,4327,2998,1140,1858,328,2124,2452,88933,497221,8470665,34246829,31529
42087,"Mifflin","Pennsylvania",40.61116939,-77.61070738,57,1,0,56,"Mifflin, Pennsylvania, US",46138,-73,574,527,47,11,-128,-117,17087,62785,498925,2113072,5221
48331,"Milam","Texas",30.7858183,-96.97718698,27,1,0,26,"Milam, Texas, US",24823,-222,268,285,-17,5,-208,-203,7136,21915,199985,860494,2067
27095,"Mille Lacs","Minnesota",45.93705297,-93.63236823,15,1,0,14,"Mille Lacs, Minnesota, US",26277,177,319,268,51,7,119,126,10273,35647,240535,1064002,3780
5091,"Miller","Arkansas",33.31403423,-93.89285258,42,1,0,41,"Miller, Arkansas, US",43257,-105,520,471,49,-28,-123,-151,13690,47056,377809,1474470,3893
13201,"Miller","Georgia",31.16568912,-84.73151117,38,0,0,38,"Miller, Georgia, US",5718,34,69,85,-16,0,49,49,1700,3561,28803,121864,456
29131,"Miller","Missouri",38.21450288,-92.42610898,4,0,0,4,"Miller, Missouri, US",25619,304,301,276,25,-4,285,281,7294,29032,191893,848686,3622
19129,"Mills","Iowa",41.03299766,-95.61920963,14,0,0,14,"Mills, Iowa, US",15109,41,137,134,3,3,34,37,4308,10334,77263,333149,1459
48333,"Mills","Texas",31.49557106,-98.59272068,1,0,0,1,"Mills, Texas, US",4873,-10,30,71,-41,-1,33,32,1657,2722,17614,72947,372
55079,"Milwaukee","Wisconsin",43.00486062,-87.96733172,5987,276,0,5711,"Milwaukee, Wisconsin, US",945726,-1243,12941,8226,4715,1072,-7014,-5942,471816,2629719,34891951,135701239,119270
46097,"Miner","South Dakota",44.02197882,-97.60992207,1,0,0,1,"Miner, South Dakota, US",2216,12,27,21,6,-1,8,7,1033,1359,10596,43220,273
8079,"Mineral","Colorado",37.66954283,-106.9281698,2,0,0,2,"Mineral, Colorado, US",769,-3,8,5,3,0,-6,-6,276,723,4876,31553,242
32021,"Mineral","Nevada",38.53841696,-118.4344506,4,0,0,4,"Mineral, Nevada, US",4505,-39,57,100,-43,0,5,5,1926,1632,13778,58163,151
54057,"Mineral","West Virginia",39.41561583,-78.94104895,36,0,0,36,"Mineral, West Virginia, US",26868,-85,249,343,-94,-4,15,11,7610,22961,189919,779050,2281
54059,"Mingo","West Virginia",37.73048351,-82.13338365,3,1,0,2,"Mingo, West Virginia, US",23424,-427,306,372,-66,-2,-359,-361,6381,13647,102193,442662,1946
16067,"Minidoka","Idaho",42.85518524,-113.6357257,26,0,0,26,"Minidoka, Idaho, US",21039,320,308,179,129,3,188,191,8035,21157,197448,852699,2043
46099,"Minnehaha","South Dakota",43.67441641,-96.7910885,3248,43,0,3205,"Minnehaha, South Dakota, US",193134,2142,2873,1415,1458,272,414,686,114303,682848,7558385,29908754,33694
26113,"Missaukee","Michigan",44.33772443,-85.09256478,16,1,0,15,"Missaukee, Michigan, US",15118,17,189,160,29,5,-18,-13,4336,10325,72422,322395,1414
5093,"Mississippi","Arkansas",35.76271485,-90.0519437,70,1,0,69,"Mississippi, Arkansas, US",40651,-585,580,498,82,-19,-652,-671,20267,55117,565104,2340312,4271
29133,"Mississippi","Missouri",36.82516239,-89.29505753,54,0,0,54,"Mississippi, Missouri, US",13180,-214,141,190,-49,0,-164,-164,4358,10231,74131,311754,1232
30063,"Missoula","Montana",47.03728583,-113.9213508,39,1,0,38,"Missoula, Montana, US",119600,960,1131,887,244,112,603,715,60956,277039,2330034,10068032,26188
13205,"Mitchell","Georgia",31.22483255,-84.19381821,399,32,0,367,"Mitchell, Georgia, US",21863,-272,245,236,9,8,-289,-281,8608,15913,109966,439266,1690
19131,"Mitchell","Iowa",43.35638371,-92.78887719,4,0,0,4,"Mitchell, Iowa, US",10586,15,129,123,6,1,10,11,4807,12452,100155,431623,1519
20123,"Mitchell","Kansas",39.39331582,-98.20906732,3,0,0,3,"Mitchell, Kansas, US",5979,-131,72,102,-30,2,-103,-101,3870,9652,73934,311715,1182
37121,"Mitchell","North Carolina",36.01059309,-82.1582442,9,0,0,9,"Mitchell, North Carolina, US",14964,-32,139,221,-82,19,31,50,5809,14022,95028,408731,1818
48335,"Mitchell","Texas",32.30623474,-100.9212058,1,0,0,1,"Mitchell, Texas, US",8545,20,100,64,36,-1,-14,-15,2566,3759,32383,130163,528
1097,"Mobile","Alabama",30.78472347,-88.20842409,1973,109,0,1864,"Mobile, Alabama, US",413210,-698,5443,4576,867,266,-1821,-1555,179461,872831,8903361,38228232,52383
8081,"Moffat","Colorado",40.61810999,-108.2070876,6,0,0,6,"Moffat, Colorado, US",13283,100,170,81,89,19,-8,11,5465,12139,109634,472559,1953
4015,"Mohave","Arizona",35.70471703,-113.7577902,303,34,0,269,"Mohave, Arizona, US",212181,2889,1752,3375,-1623,-246,4724,4478,55389,239213,1966988,8160958,22116
29135,"Moniteau","Missouri",38.63571781,-92.57976951,45,0,0,45,"Moniteau, Missouri, US",16132,-54,205,165,40,17,-110,-93,4460,11934,79355,339963,1594
34025,"Monmouth","New Jersey",40.26549699,-74.22240686,7720,551,0,7169,"Monmouth, New Jersey, US",618795,-1664,5644,5867,-223,191,-1619,-1428,264940,1425797,17406891,71558591,115284
6051,"Mono","California",37.93899289,-118.8872409,34,1,0,33,"Mono, California, US",14444,41,126,30,96,64,-120,-56,7688,34510,281182,1176737,3209
19133,"Monona","Iowa",42.05220391,-95.95743843,21,0,0,21,"Monona, Iowa, US",8615,-44,86,137,-51,0,7,7,3160,8404,63846,264678,1085
54061,"Monongalia","West Virginia",39.63218457,-80.04766838,119,5,0,114,"Monongalia, West Virginia, US",105612,-39,1071,731,340,-15,-362,-377,59468,222233,2382430,9452030,13874
1099,"Monroe","Alabama",31.56729412,-87.36995001,26,2,0,24,"Monroe, Alabama, US",20733,-329,199,278,-79,-2,-249,-251,6500,21252,188093,773128,1948
5095,"Monroe","Arkansas",34.6815935,-91.20540287,5,0,0,5,"Monroe, Arkansas, US",6701,-179,67,114,-47,0,-133,-133,2740,7423,49437,206606,902
12087,"Monroe","Florida",25.20904673,-81.07812416,107,3,0,104,"Monroe, Florida, US",74228,-529,685,736,-51,273,-750,-477,42089,183730,1551243,5987306,22551
13207,"Monroe","Georgia",33.014289,-83.92097166,117,8,0,109,"Monroe, Georgia, US",27578,75,241,342,-101,-8,187,179,7722,24511,199137,813132,2650
17133,"Monroe","Illinois",38.27594376,-90.17761038,91,11,0,80,"Monroe, Illinois, US",34637,264,359,319,40,0,227,227,8856,41031,314817,1378343,4360
18105,"Monroe","Indiana",39.16130004,-86.52414358,158,10,0,148,"Monroe, Indiana, US",148431,1201,1205,941,264,1218,-282,936,76387,252583,2167988,9161435,18165
19135,"Monroe","Iowa",41.02988815,-92.8690667,32,3,0,29,"Monroe, Iowa, US",7707,-61,78,79,-1,4,-63,-59,3489,6729,55350,226751,765
21171,"Monroe","Kentucky",36.71225341,-85.71596443,14,0,0,14,"Monroe, Kentucky, US",10650,-82,144,142,2,-2,-82,-84,3207,10087,70051,304749,962
26115,"Monroe","Michigan",41.92734151,-83.53749864,461,19,0,442,"Monroe, Michigan, US",150500,326,1459,1481,-22,-10,369,359,44493,189613,1844574,7623040,13492
28095,"Monroe","Mississippi",33.89236763,-88.4808438,241,24,0,217,"Monroe, Mississippi, US",35252,-291,387,413,-26,-1,-265,-266,10907,33245,310008,1210973,3243
36055,"Monroe","New York",43.14638895,-77.69322942,2661,188,0,2473,"Monroe, New York, US",741770,-1094,7762,6693,1069,760,-2918,-2158,385098,2099836,23239250,95479067,105921
39111,"Monroe","Ohio",39.72984936,-81.08464734,71,9,0,62,"Monroe, Ohio, US",13654,-133,116,196,-80,-2,-50,-52,4928,7340,48635,210242,1175
42089,"Monroe","Pennsylvania",41.05934058,-75.34031025,1302,99,0,1203,"Monroe, Pennsylvania, US",170271,977,1545,1618,-73,153,911,1064,62588,258679,2034715,8102340,19681
47123,"Monroe","Tennessee",35.44550387,-84.24902965,57,2,0,55,"Monroe, Tennessee, US",46545,276,484,575,-91,-30,397,367,13909,54564,418823,1761870,3790
54063,"Monroe","West Virginia",37.56274716,-80.54577965,6,0,0,6,"Monroe, West Virginia, US",13275,-14,111,167,-56,-1,43,42,2653,4165,29096,119389,767
55081,"Monroe","Wisconsin",43.94641218,-90.618819,16,1,0,15,"Monroe, Wisconsin, US",46253,112,559,435,124,10,-21,-11,22396,74938,778694,3236338,5169
48337,"Montague","Texas",33.67521893,-97.72500958,9,1,0,8,"Montague, Texas, US",19818,234,204,258,-54,-6,294,288,6644,17454,181637,797182,2216
26117,"Montcalm","Michigan",43.31082541,-85.15252824,66,1,0,65,"Montcalm, Michigan, US",63888,-48,728,613,115,-2,-158,-160,17810,64415,521498,2266513,5491
6053,"Monterey","California",36.21862405,-121.2413397,371,8,0,363,"Monterey, California, US",434061,111,5797,2742,3055,-90,-2850,-2940,177185,658275,7122932,30458222,51969
8083,"Montezuma","Colorado",37.33859579,-108.5958857,35,3,0,32,"Montezuma, Colorado, US",26183,31,263,279,-16,-17,66,49,10027,33355,283070,1152664,3990
1101,"Montgomery","Alabama",32.2206831,-86.20969272,1141,30,0,1111,"Montgomery, Alabama, US",226486,-18,3058,2164,894,321,-1235,-914,134666,573261,5827734,24035906,32943
5097,"Montgomery","Arkansas",34.53704874,-93.65824478,1,0,0,1,"Montgomery, Arkansas, US",8986,76,88,148,-60,4,133,137,2201,3011,19106,88528,510
13209,"Montgomery","Georgia",32.17201038,-82.53527476,9,0,0,9,"Montgomery, Georgia, US",9172,4,102,86,16,3,-14,-11,1544,3175,21511,83563,434
17135,"Montgomery","Illinois",39.23198845,-89.47809254,38,1,0,37,"Montgomery, Illinois, US",28414,-277,301,365,-64,0,-213,-213,9242,33208,234733,987250,3634
18107,"Montgomery","Indiana",40.04034823,-86.89335024,211,14,0,197,"Montgomery, Indiana, US",38338,64,426,389,37,44,-15,29,16271,50920,445695,1821848,4570
19137,"Montgomery","Iowa",41.03018714,-95.15642896,5,0,0,5,"Montgomery, Iowa, US",9917,-44,107,135,-28,1,-17,-16,4620,12984,97103,400764,1488
20125,"Montgomery","Kansas",37.19236568,-95.74329258,20,2,0,18,"Montgomery, Kansas, US",31829,-262,322,356,-34,61,-290,-229,16200,50085,414308,1677598,4148
21173,"Montgomery","Kentucky",38.03253032,-83.9145241,21,0,0,21,"Montgomery, Kentucky, US",28157,48,350,291,59,-10,1,-9,11386,40370,288712,1160383,2708
24031,"Montgomery","Maryland",39.13676329,-77.20358245,9699,550,0,9149,"Montgomery, Maryland, US",1050688,2210,12240,6344,5896,5699,-9423,-3724,498189,2616098,43025967,166028578,164148
28097,"Montgomery","Mississippi",33.49419589,-89.61729103,78,1,0,77,"Montgomery, Mississippi, US",9775,-219,120,151,-31,2,-189,-187,2933,8251,53368,224373,960
29139,"Montgomery","Missouri",38.94022054,-91.47000721,8,0,0,8,"Montgomery, Missouri, US",11551,63,127,140,-13,2,72,74,3281,8286,61065,254163,1171
36057,"Montgomery","New York",42.90123494,-74.44011632,77,4,0,73,"Montgomery, New York, US",49221,-173,613,533,80,14,-267,-253,19360,62455,522257,2185618,5847
37123,"Montgomery","North Carolina",35.33155144,-79.90416657,84,3,0,81,"Montgomery, North Carolina, US",27173,96,268,269,-1,-4,102,98,9963,34014,266413,1115695,2537
39113,"Montgomery","Ohio",39.75394919,-84.29050975,578,14,0,564,"Montgomery, Ohio, US",531687,87,6522,5966,556,533,-973,-440,254416,1314906,14907699,60094923,66314
42091,"Montgomery","Pennsylvania",40.21053671,-75.36652296,6464,633,0,5831,"Montgomery, Pennsylvania, US",830915,3991,8602,7831,771,1584,1698,3282,475085,2991970,51723200,188869556,157469
47125,"Montgomery","Tennessee",36.49609412,-87.38550661,234,3,0,231,"Montgomery, Tennessee, US",208993,3681,3490,1415,2075,15,1576,1591,61383,230340,1699080,7118286,16853
48339,"Montgomery","Texas",30.30079133,-95.50572772,888,23,0,865,"Montgomery, Texas, US",607391,17621,7387,4165,3222,942,13423,14365,178249,966658,14758221,53019742,69611
51121,"Montgomery","Virginia",37.17746986,-80.37868691,69,1,0,68,"Montgomery, Virginia, US",98535,3,804,669,135,276,-412,-136,50294,143332,1206441,5005465,11174
26119,"Montmorency","Michigan",45.0275929,-84.12696227,5,0,0,5,"Montmorency, Michigan, US",9328,53,62,166,-104,2,153,155,2594,5772,40167,184639,865
42093,"Montour","Pennsylvania",41.03023987,-76.66345939,50,0,0,50,"Montour, Pennsylvania, US",18230,-10,211,221,-10,12,-11,1,15428,39016,532639,2190038,2310
8085,"Montrose","Colorado",38.40214114,-108.2639022,159,12,0,147,"Montrose, Colorado, US",42758,552,428,434,-6,15,543,558,15328,60296,501992,2168362,7067
46101,"Moody","South Dakota",44.02266214,-96.67081159,18,0,0,18,"Moody, South Dakota, US",6576,74,82,55,27,-3,51,48,2653,4723,34208,149947,647
37125,"Moore","North Carolina",35.30885257,-79.48474178,198,10,0,188,"Moore, North Carolina, US",100880,2075,1139,1169,-30,78,2023,2101,36145,158828,1374138,5896032,12890
47127,"Moore","Tennessee",35.27724699,-86.36230578,3,0,0,3,"Moore, Tennessee, US",6488,31,59,50,9,16,6,22,1827,1847,17260,75870,222
48341,"Moore","Texas",35.83769242,-101.8930281,579,13,0,566,"Moore, Texas, US",20940,-143,369,130,239,29,-415,-386,11320,27224,268528,1086224,2257
22067,"Morehouse","Louisiana",32.81686191,-91.80421614,110,5,0,105,"Morehouse, Louisiana, US",24874,-450,330,346,-16,-1,-434,-435,6893,26512,169228,716427,2332
1103,"Morgan","Alabama",34.45500589,-86.85475946,157,1,0,156,"Morgan, Alabama, US",119679,476,1402,1316,86,113,285,398,49723,221130,2144516,8810536,15063
8087,"Morgan","Colorado",40.2627981,-103.8093302,603,41,0,562,"Morgan, Colorado, US",29068,299,438,240,198,171,-70,101,12952,39934,386241,1591207,3667
13211,"Morgan","Georgia",33.59232073,-83.49129491,36,0,0,36,"Morgan, Georgia, US",19276,445,215,172,43,1,399,400,9055,24181,181867,765714,2451
17137,"Morgan","Illinois",39.71654544,-90.20255104,34,1,0,33,"Morgan, Illinois, US",33658,-369,355,391,-36,44,-377,-333,16307,55447,444356,1819961,4465
18109,"Morgan","Indiana",39.47899078,-86.44573375,257,24,0,233,"Morgan, Indiana, US",70489,352,780,675,105,45,208,253,17377,61222,500375,2114731,6697
21175,"Morgan","Kentucky",37.92465657,-83.25558245,1,0,0,1,"Morgan, Kentucky, US",13309,-63,105,158,-53,1,-10,-9,2989,6411,48358,198723,652
29141,"Morgan","Missouri",38.4181765,-92.88791859,8,0,0,8,"Morgan, Missouri, US",20627,213,271,289,-18,-6,235,229,5555,13795,83599,375671,2492
39115,"Morgan","Ohio",39.62081738,-81.85308173,5,0,0,5,"Morgan, Ohio, US",14508,-73,135,160,-25,0,-47,-47,3349,8519,58436,245056,663
47129,"Morgan","Tennessee",36.13248031,-84.64880098,17,0,0,17,"Morgan, Tennessee, US",21403,-131,199,229,-30,1,-102,-101,3212,4650,34931,146966,680
54065,"Morgan","West Virginia",39.55439028,-78.26311676,17,0,0,17,"Morgan, West Virginia, US",17884,54,153,219,-66,-8,129,121,3675,7033,48218,205982,1020
31123,"Morrill","Nebraska",41.71711774,-103.0061405,10,0,0,10,"Morrill, Nebraska, US",4642,-32,45,42,3,3,-39,-36,2113,2565,23180,92479,464
20127,"Morris","Kansas",38.68827511,-96.65128437,4,0,0,4,"Morris, Kansas, US",5620,63,75,70,5,8,50,58,2230,3556,25051,101227,514
34027,"Morris","New Jersey",40.86095313,-74.5455371,6192,590,0,5602,"Morris, New Jersey, US",491845,-1225,4568,3857,711,628,-2572,-1944,289087,1749258,36847496,136712290,101252
48343,"Morris","Texas",33.11304005,-94.73255695,15,0,0,15,"Morris, Texas, US",12388,85,141,153,-12,-2,101,99,4291,9596,83708,362895,983
27097,"Morrison","Minnesota",46.01265363,-94.27341528,36,0,0,36,"Morrison, Minnesota, US",33386,228,345,367,-22,3,251,254,13356,37747,276029,1243282,4689
39117,"Morrow","Ohio",40.5236356,-82.7892599,104,1,0,103,"Morrow, Ohio, US",35328,215,381,316,65,-6,157,151,6956,15254,107062,451281,1860
41049,"Morrow","Oregon",45.41846568,-119.584546,12,0,0,12,"Morrow, Oregon, US",11603,243,166,87,79,12,152,164,5292,11303,135835,530163,878
20129,"Morton","Kansas",37.19141121,-101.7992519,4,0,0,4,"Morton, Kansas, US",2587,-106,35,23,12,-2,-116,-118,1499,1895,15131,62970,299
38059,"Morton","North Dakota",46.71681782,-101.2822377,64,2,0,62,"Morton, North Dakota, US",31364,306,434,290,144,3,159,162,11320,48929,499153,2095795,4700
48345,"Motley","Texas",34.07408766,-100.779722,1,0,0,1,"Motley, Texas, US",1200,-32,12,15,-3,0,-28,-28,397,261,1282,5039,61
17139,"Moultrie","Illinois",39.64187451,-88.62099969,9,0,0,9,"Moultrie, Illinois, US",14501,-147,174,160,14,3,-166,-163,5766,22193,183984,789007,1576
38061,"Mountrail","North Dakota",48.20197971,-102.3555315,39,0,0,39,"Mountrail, North Dakota, US",10545,306,186,97,89,29,188,217,7030,19259,264744,1068540,2112
27099,"Mower","Minnesota",43.67142874,-92.75234549,138,1,0,137,"Mower, Minnesota, US",40062,-80,535,370,165,126,-372,-246,17875,51759,426867,1867981,4461
21177,"Muhlenberg","Kentucky",37.21425819,-87.14632053,471,7,0,464,"Muhlenberg, Kentucky, US",30622,-189,340,394,-54,-2,-133,-135,9073,26963,195661,798609,2923
41051,"Multnomah","Oregon",45.54747959,-122.4169351,1037,58,0,979,"Multnomah, Oregon, US",812855,3783,8338,6050,2288,1654,-153,1501,485059,2591899,34086892,137759976,165309
13213,"Murray","Georgia",34.78897608,-84.74993177,77,1,0,76,"Murray, Georgia, US",40096,153,475,416,59,21,76,97,10867,36984,289822,1211772,2047
27101,"Murray","Minnesota",44.02216709,-95.76328482,35,0,0,35,"Murray, Minnesota, US",8194,-60,88,86,2,5,-68,-63,3476,8732,67479,309164,1427
40099,"Murray","Oklahoma",34.48116015,-97.06826283,2,0,0,2,"Murray, Oklahoma, US",14073,105,146,187,-41,5,141,146,5259,13738,105791,462813,1280
19139,"Muscatine","Iowa",41.48370744,-91.1121697,541,38,0,503,"Muscatine, Iowa, US",42664,-210,526,372,154,47,-412,-365,22463,78569,812069,3173184,5090
13215,"Muscogee","Georgia",32.50931999,-84.87142262,536,17,0,519,"Muscogee, Georgia, US",195769,1600,2774,1922,852,204,544,748,112667,412358,4404929,16937436,25270
26121,"Muskegon","Michigan",43.29123859,-86.15176712,583,28,0,555,"Muskegon, Michigan, US",173566,-33,2071,1770,301,32,-362,-330,61083,271962,2494904,10376364,18341
39119,"Muskingum","Ohio",39.96575964,-81.94363275,44,0,0,44,"Muskingum, Ohio, US",86215,84,1002,971,31,43,15,58,36182,135096,1194499,5044441,9755
40101,"Muskogee","Oklahoma",35.61318461,-95.37802952,35,6,0,29,"Muskogee, Oklahoma, US",67997,-327,821,906,-85,7,-250,-243,29966,115159,1075675,4554858,7961
30065,"Musselshell","Montana",46.49684637,-108.39498,1,0,0,1,"Musselshell, Montana, US",4633,1,41,70,-29,3,26,29,1875,2550,25468,105317,450
48347,"Nacogdoches","Texas",31.62017125,-94.61803994,244,17,0,227,"Nacogdoches, Texas, US",65204,43,770,604,166,2,-125,-123,25898,81075,632290,2594379,7217
31125,"Nance","Nebraska",41.39750195,-97.99327291,5,0,0,5,"Nance, Nebraska, US",3519,13,37,28,9,1,3,4,1334,1765,11121,44700,332
6055,"Napa","California",38.50735751,-122.332839,101,3,0,98,"Napa, California, US",137744,-1045,1235,1279,-44,-13,-985,-998,74473,350976,4191441,18102356,25048
37127,"Nash","North Carolina",35.96575634,-77.98422508,174,4,0,170,"Nash, North Carolina, US",94298,204,1061,1041,20,31,159,190,42054,169632,1447661,6009515,11552
12089,"Nassau","Florida",30.61037141,-81.80297522,69,1,0,68,"Nassau, Florida, US",88625,2689,858,979,-121,-15,2813,2798,20029,93687,781020,3150314,10599
36059,"Nassau","New York",40.74066522,-73.58941873,39726,2087,0,37639,"Nassau, New York, US",1356924,-610,14001,11312,2689,1650,-4941,-3291,570791,3365694,44436619,183266962,291069
22069,"Natchitoches","Louisiana",31.72321584,-93.09816516,145,13,0,132,"Natchitoches, Louisiana, US",38158,-458,468,398,70,23,-551,-528,13864,46463,343076,1362307,4249
56025,"Natrona","Wyoming",42.96180148,-106.797885,68,0,0,68,"Natrona, Wyoming, US",79858,683,953,734,219,103,361,464,41536,172894,1917993,8272179,17292
4017,"Navajo","Arizona",35.3997715,-110.3218983,1491,56,0,1435,"Navajo, Arizona, US",110924,682,1447,1117,330,44,311,355,31988,102031,879495,3656456,10087
48349,"Navarro","Texas",32.04620681,-96.47428766,40,2,0,38,"Navarro, Texas, US",50113,577,678,537,141,9,428,437,18344,63876,492074,2013607,5164
21179,"Nelson","Kentucky",37.80335779,-85.4657193,35,0,0,35,"Nelson, Kentucky, US",46233,420,552,419,133,-7,294,287,15839,65563,603849,2652385,4903
38063,"Nelson","North Dakota",47.9226426,-98.19038437,2,0,0,2,"Nelson, North Dakota, US",2879,-6,23,50,-27,25,-3,22,1284,3009,22173,102834,594
51125,"Nelson","Virginia",37.78790447,-78.88498513,13,0,0,13,"Nelson, Virginia, US",14930,68,147,159,-12,-1,82,81,4490,13299,95332,392273,1827
20131,"Nemaha","Kansas",39.78345387,-96.01392079,9,0,0,9,"Nemaha, Kansas, US",10231,106,152,84,68,5,36,41,5631,18409,164563,682150,1848
31127,"Nemaha","Nebraska",40.38514847,-95.85433992,3,0,0,3,"Nemaha, Nebraska, US",6972,15,101,67,34,3,-22,-19,3739,5247,34134,141706,819
20133,"Neosho","Kansas",37.55862897,-95.30670046,2,0,0,2,"Neosho, Kansas, US",16007,-18,182,171,11,38,-67,-29,7223,19706,156754,652854,2210
28099,"Neshoba","Mississippi",32.75339664,-89.11726492,511,30,0,481,"Neshoba, Mississippi, US",29118,-33,435,377,58,-3,-87,-90,11980,35998,348259,1342655,2563
20135,"Ness","Kansas",38.47974157,-99.91547333,1,0,0,1,"Ness, Kansas, US",2750,-46,14,36,-22,7,-30,-23,1692,3367,28900,124381,600
5099,"Nevada","Arkansas",33.66340119,-93.30632432,4,0,0,4,"Nevada, Arkansas, US",8252,-56,102,104,-2,-3,-51,-54,2493,5221,38233,157502,492
6057,"Nevada","California",39.30394768,-120.7627281,41,1,0,40,"Nevada, California, US",99755,247,778,986,-208,-3,465,462,36613,154327,1451346,5995689,17782
10003,"New Castle","Delaware",39.57992638,-75.64054974,3132,146,0,2986,"New Castle, Delaware, US",558753,1203,6268,4916,1352,69,-201,-132,278925,1557604,25503630,95090581,95247
37129,"New Hanover","North Carolina",34.25758282,-77.87075626,152,4,0,148,"New Hanover, North Carolina, US",234473,2217,2197,2034,163,126,1915,2041,119274,544158,5390468,21963651,44746
9009,"New Haven","Connecticut",41.4080325,-72.93620426,10847,897,0,9950,"New Haven, Connecticut, US",854757,-2214,8512,7887,625,2740,-5598,-2858,388447,2001978,25059409,101765151,116828
51127,"New Kent","Virginia",37.50694406,-76.99828634,27,1,0,26,"New Kent, Virginia, US",23091,774,233,165,68,0,702,702,4375,12889,96132,427390,1948
9011,"New London","Connecticut",41.48896435,-72.10430976,970,72,0,898,"New London, Connecticut, US",265206,-1079,2502,2521,-19,326,-1385,-1059,138465,530703,6057198,23916938,34932
29143,"New Madrid","Missouri",36.59666326,-89.66070007,17,0,0,17,"New Madrid, Missouri, US",17076,-196,204,242,-38,0,-160,-160,7645,24097,172105,675714,2065
36061,"New York City","New York",40.7672726,-73.97152637,197266,21138,0,176128,"New York City, New York, US",1628706,-349,16968,12171,4797,6727,-11730,-5003,2436836,13494458,485953645,1512259049,622613
26123,"Newaygo","Michigan",43.554374,-85.80070107,79,0,0,79,"Newaygo, Michigan, US",48980,141,539,532,7,11,126,137,14124,44634,403942,1612593,4389
45071,"Newberry","South Carolina",34.28629098,-81.59935761,44,1,0,43,"Newberry, South Carolina, US",38440,-3,395,454,-59,-1,58,57,15090,45292,379920,1493418,3928
44005,"Newport","Rhode Island",41.5642026,-71.26569799,226,0,0,226,"Newport, Rhode Island, US",82082,-465,695,817,-122,152,-492,-340,44215,168362,1647655,7248583,15961
51700,"Newport News","Virginia",37.08166899,-76.51754109,234,10,0,224,"Newport News, Virginia, US",179225,702,2633,1538,1095,192,-575,-383,111118,408794,4670333,18563955,22211
5101,"Newton","Arkansas",35.91947491,-93.21612969,3,0,0,3,"Newton, Arkansas, US",7753,-47,84,108,-24,0,-22,-22,1936,2093,9056,39983,333
13217,"Newton","Georgia",33.55514538,-83.8454714,289,10,0,279,"Newton, Georgia, US",111744,2323,1373,906,467,37,1822,1859,27472,89625,854909,3523946,7973
18111,"Newton","Indiana",40.95610449,-87.39635768,72,10,0,62,"Newton, Indiana, US",13984,-2,129,142,-13,25,-14,11,3535,8346,62451,272744,1160
28101,"Newton","Mississippi",32.40021118,-89.11843336,221,3,0,218,"Newton, Mississippi, US",21018,-337,284,271,13,0,-351,-351,5824,12430,85820,353967,1611
29145,"Newton","Missouri",36.90519407,-94.3394104,16,1,0,15,"Newton, Missouri, US",58236,78,692,619,73,6,3,9,24343,91735,777501,3267451,6609
48351,"Newton","Texas",30.78548982,-93.74408813,4,0,0,4,"Newton, Texas, US",13595,-156,112,176,-64,0,-94,-94,2702,3297,23353,93795,559
16069,"Nez Perce","Idaho",46.32638236,-116.7500975,81,19,0,62,"Nez Perce, Idaho, US",40408,152,457,452,5,-20,170,150,21496,80315,708962,2849393,6229
36063,"Niagara","New York",43.19898042,-78.74777412,927,59,0,868,"Niagara, New York, US",209281,-779,2067,2382,-315,61,-519,-458,75611,336778,2842649,12058185,26968
21181,"Nicholas","Kentucky",38.33342292,-84.01889177,1,0,0,1,"Nicholas, Kentucky, US",7269,74,84,96,-12,0,86,86,1362,1170,7391,31320,278
54067,"Nicholas","West Virginia",38.29617706,-80.79759588,10,1,0,9,"Nicholas, West Virginia, US",24496,-339,245,352,-107,1,-233,-232,9167,27684,203168,838467,2921
27103,"Nicollet","Minnesota",44.35291112,-94.24710352,64,3,0,61,"Nicollet, Minnesota, US",34274,75,353,259,94,34,-53,-19,16761,45186,406207,1698385,3548
56027,"Niobrara","Wyoming",43.05607708,-104.4758896,2,0,0,2,"Niobrara, Wyoming, US",2356,-44,28,14,14,0,-57,-57,1161,1249,7018,32410,313
18113,"Noble","Indiana",41.39672484,-85.41966713,174,20,0,154,"Noble, Indiana, US",47744,201,632,455,177,15,12,27,19443,67752,622854,2523018,4666
39121,"Noble","Ohio",39.76818851,-81.45937183,5,0,0,5,"Noble, Ohio, US",14424,77,143,143,0,-2,81,79,3757,7401,45899,195226,909
40103,"Noble","Oklahoma",36.38953329,-97.22928674,7,0,0,7,"Noble, Oklahoma, US",11131,-148,121,126,-5,2,-145,-143,4945,9433,92003,358970,994
27105,"Nobles","Minnesota",43.67434621,-95.75329576,1444,2,0,1442,"Nobles, Minnesota, US",21629,-115,382,186,196,87,-399,-312,11003,33870,266123,1191250,3100
29147,"Nodaway","Missouri",40.36079813,-94.88133008,8,0,0,8,"Nodaway, Missouri, US",22092,-131,195,186,9,4,-145,-141,11184,22672,163181,658516,2344
48353,"Nolan","Texas",32.30365282,-100.4060208,2,0,0,2,"Nolan, Texas, US",14714,-85,187,173,14,15,-115,-100,6975,16843,153718,598465,1711
2180,"Nome","Alaska",64.90320724,-164.0353804,3,0,0,3,"Nome, Alaska, US",10004,-49,197,101,96,2,-147,-145,3587,5858,60289,265832,740
25021,"Norfolk","Massachusetts",42.16073095,-71.20530408,7759,774,0,6985,"Norfolk, Massachusetts, US",706775,3545,7148,5883,1265,2645,-336,2309,330451,2076456,28589402,116047832,121284
51710,"Norfolk","Virginia",36.89934014,-76.26420872,393,6,0,387,"Norfolk, Virginia, US",242742,-843,3321,2077,1244,265,-2334,-2069,183258,593159,6664692,27536549,31737
27107,"Norman","Minnesota",47.32628443,-96.45620947,11,0,0,11,"Norman, Minnesota, US",6375,-104,81,90,-9,8,-103,-95,2441,4780,38739,172915,862
37131,"Northampton","North Carolina",36.41736238,-77.39769443,137,12,0,125,"Northampton, North Carolina, US",19483,-215,173,297,-124,7,-97,-90,5689,13251,108065,448264,1241
42095,"Northampton","Pennsylvania",40.75182733,-75.30471829,2866,197,0,2669,"Northampton, Pennsylvania, US",305285,721,2767,2986,-219,272,689,961,117296,616584,6635110,27156385,37698
51131,"Northampton","Virginia",37.34062933,-75.87751591,210,16,0,194,"Northampton, Virginia, US",11710,-51,120,188,-68,2,16,18,5131,12240,81213,392350,1474
42097,"Northumberland","Pennsylvania",40.84785433,-76.70798222,164,3,0,161,"Northumberland, Pennsylvania, US",90843,-237,888,1093,-205,-8,-18,-26,30836,119136,976353,3950652,9439
51133,"Northumberland","Virginia",37.89202088,-76.41949732,22,1,0,21,"Northumberland, Virginia, US",12095,-73,88,181,-93,0,21,21,3063,7061,45144,223491,1526
2188,"Northwest Arctic","Alaska",67.04919196,-159.7503946,2,0,0,2,"Northwest Arctic, Alaska, US",7621,-73,167,90,77,7,-156,-149,2889,4286,66378,266339,294
20137,"Norton","Kansas",39.78443827,-99.90286639,2,0,0,2,"Norton, Kansas, US",5361,-58,51,62,-11,1,-49,-48,2691,5884,47062,189250,766
51720,"Norton","Virginia",36.93357076,-82.62750411,2,0,0,2,"Norton, Virginia, US",3981,9,39,46,-7,1,16,17,1282,12336,111402,439913,931
51135,"Nottoway","Virginia",37.1435975,-78.05065922,19,0,0,19,"Nottoway, Virginia, US",15232,-168,170,224,-54,0,-114,-114,6722,12904,89662,370246,1543
40105,"Nowata","Oklahoma",36.79843529,-95.61902331,23,0,0,23,"Nowata, Oklahoma, US",10076,-202,126,135,-9,2,-195,-193,2398,4810,32265,132606,594
28103,"Noxubee","Mississippi",33.11009499,-88.56949061,157,6,0,151,"Noxubee, Mississippi, US",10417,-133,161,128,33,6,-173,-167,3357,6479,47534,196352,769
31129,"Nuckolls","Nebraska",40.17637905,-98.04743961,1,0,0,1,"Nuckolls, Nebraska, US",4148,-59,43,61,-18,4,-46,-42,1864,4082,32099,131041,736
48355,"Nueces","Texas",27.736286,-97.5433285,260,3,0,257,"Nueces, Texas, US",362294,268,4467,2976,1491,346,-1571,-1225,170651,814719,8249492,33523200,47686
32023,"Nye","Nevada",38.04264256,-116.4722702,59,1,0,58,"Nye, Nevada, US",46523,1337,379,735,-356,-63,1747,1684,13138,36883,325533,1332581,3616
19141,"O'Brien","Iowa",43.08310673,-95.62474482,24,0,0,24,"O'Brien, Iowa, US",13753,-45,170,182,-12,1,-33,-32,6712,23223,168360,730942,2600
26125,"Oakland","Michigan",42.66090111,-83.38595416,8192,954,0,7238,"Oakland, Michigan, US",1257584,890,13042,10978,2064,3617,-4781,-1164,672137,4136665,61265382,245104487,235036
47131,"Obion","Tennessee",36.35732446,-89.14921589,24,1,0,23,"Obion, Tennessee, US",30069,-205,328,417,-89,5,-121,-116,12024,41513,335718,1357801,3300
34029,"Ocean","New Jersey",39.8895449,-74.28089251,8316,686,0,7630,"Ocean, New Jersey, US",607186,5708,8555,7091,1464,42,4224,4266,171764,831495,7310235,31357104,79758
26127,"Oceana","Michigan",43.64124435,-86.26726673,74,2,0,72,"Oceana, Michigan, US",26467,-88,256,267,-11,42,-118,-76,7907,22787,149260,740171,2520
48357,"Ochiltree","Texas",36.27829105,-100.8158184,41,3,0,38,"Ochiltree, Texas, US",9836,-30,139,64,75,-6,-100,-106,6001,17645,220742,908315,1776
13219,"Oconee","Georgia",33.83749973,-83.43679568,103,5,0,98,"Oconee, Georgia, US",40280,802,359,249,110,4,693,697,12271,66082,579913,2414719,6513
45073,"Oconee","South Carolina",34.75225169,-83.06742317,43,0,0,43,"Oconee, South Carolina, US",79546,1239,701,958,-257,150,1343,1493,26895,88325,748445,2983051,8594
55083,"Oconto","Wisconsin",45.02715345,-88.26807503,34,0,0,34,"Oconto, Wisconsin, US",37930,106,369,391,-22,12,117,129,9943,34178,255123,1102983,4165
26129,"Ogemaw","Michigan",44.33481032,-84.12725175,20,0,0,20,"Ogemaw, Michigan, US",20997,115,192,281,-89,5,199,204,7504,25086,177447,776089,2896
46102,"Oglala Lakota","South Dakota",43.33749164,-102.5555498,17,0,0,17,"Oglala Lakota, South Dakota, US",14177,-154,284,172,112,-5,-261,-266,3902,8248,64772,269752,262
17141,"Ogle","Illinois",42.04165196,-89.32184679,185,2,0,183,"Ogle, Illinois, US",50643,-138,525,495,30,5,-172,-167,17950,61298,571333,2395600,5790
13221,"Oglethorpe","Georgia",33.8786296,-83.08278123,58,5,0,53,"Oglethorpe, Georgia, US",15259,179,163,154,9,3,166,169,2464,4500,31614,134732,772
18115,"Ohio","Indiana",38.955305,-84.96515993,13,0,0,13,"Ohio, Indiana, US",5875,-4,71,76,-5,0,1,1,1634,1843,11015,45290,245
21183,"Ohio","Kentucky",37.47751843,-86.85368087,120,0,0,120,"Ohio, Kentucky, US",23994,-70,279,271,8,-7,-69,-76,8289,21490,159008,645807,1912
54069,"Ohio","West Virginia",40.0955451,-80.62203992,38,1,0,37,"Ohio, West Virginia, US",41411,-294,401,586,-185,-15,-92,-107,30255,123916,1162810,4892858,7729
12091,"Okaloosa","Florida",30.69143028,-86.59267105,192,6,0,186,"Okaloosa, Florida, US",210738,3804,2692,1940,752,76,2961,3037,100049,350680,3221549,13461252,32062
53047,"Okanogan","Washington",48.54855019,-119.7387224,42,1,0,41,"Okanogan, Washington, US",42243,126,493,481,12,58,57,115,16744,41660,312509,1418744,6320
12093,"Okeechobee","Florida",27.3863362,-80.88944347,57,0,0,57,"Okeechobee, Florida, US",42168,514,542,447,95,61,358,419,12189,33797,270708,1115222,4424
40107,"Okfuskee","Oklahoma",35.46485198,-96.32639984,3,0,0,3,"Okfuskee, Oklahoma, US",11993,-88,151,179,-28,5,-67,-62,2822,7681,62099,242181,657
40109,"Oklahoma","Oklahoma",35.55140095,-97.40716948,1189,56,0,1133,"Oklahoma, Oklahoma, US",797434,6841,11183,7172,4011,1315,1522,2837,458587,2215656,27015149,104099301,143548
40111,"Okmulgee","Oklahoma",35.64661916,-95.96432828,22,0,0,22,"Okmulgee, Oklahoma, US",38465,144,420,547,-127,1,270,271,11570,28181,187918,806691,3459
28105,"Oktibbeha","Mississippi",33.42491685,-88.87905132,128,10,0,118,"Oktibbeha, Mississippi, US",49587,338,548,366,182,114,42,156,20179,59477,380307,1583711,4797
21185,"Oldham","Kentucky",38.39791089,-85.448222,60,3,0,57,"Oldham, Kentucky, US",66799,287,606,414,192,-1,100,99,16129,54984,461968,2045948,6627
48359,"Oldham","Texas",35.40425596,-102.6027606,3,1,0,2,"Oldham, Texas, US",2112,-6,24,12,12,0,-19,-19,970,975,6362,31305,122
38065,"Oliver","North Dakota",47.11530482,-101.3406158,1,0,0,1,"Oliver, North Dakota, US",1959,14,22,6,16,0,-1,-1,940,754,12989,50737,110
27109,"Olmsted","Minnesota",44.00374114,-92.40209944,542,10,0,532,"Olmsted, Minnesota, US",158293,1935,2080,1102,978,423,537,960,94629,360068,3565571,14613227,20940
36065,"Oneida","New York",43.24375382,-75.43710392,864,38,0,826,"Oneida, New York, US",228671,-803,2482,2490,-8,263,-1058,-795,108461,462151,4541875,18334866,28717
55085,"Oneida","Wisconsin",45.70677897,-89.51944105,7,0,0,7,"Oneida, Wisconsin, US",35595,151,319,461,-142,1,293,294,16979,66639,611169,2605429,7806
36067,"Onondaga","New York",43.00491923,-76.19971155,1904,115,0,1789,"Onondaga, New York, US",460528,-1121,4952,4214,738,842,-2707,-1865,246351,1218736,13253841,54228629,69773
37133,"Onslow","North Carolina",34.72607366,-77.42908179,94,2,0,92,"Onslow, North Carolina, US",197938,1023,3951,1094,2857,-2,-1813,-1815,91487,191991,1276666,5332353,16335
36069,"Ontario","New York",42.85145728,-77.30874425,182,9,0,173,"Ontario, New York, US",109777,39,979,1079,-100,42,106,148,52756,251347,2752262,11467933,17268
26131,"Ontonagon","Michigan",46.6652262,-89.31390481,0,0,0,0,"Ontonagon, Michigan, US",5720,-81,28,106,-78,2,-5,-3,1667,3763,23919,96837,753
6059,"Orange","California",33.70147516,-117.7645998,5157,130,0,5027,"Orange, California, US",3175692,-281,36406,21518,14888,6178,-21358,-15180,1560671,8866391,129807837,519866012,580733
12095,"Orange","Florida",28.51367621,-81.31799498,1768,39,0,1729,"Orange, Florida, US",1393452,11912,16922,8890,8032,7258,-3333,3925,743986,4330956,48877479,194235198,225832
18117,"Orange","Indiana",38.5411892,-86.49523093,122,22,0,100,"Orange, Indiana, US",19646,98,246,226,20,15,64,79,7578,25029,227870,1039837,1850
36071,"Orange","New York",41.40337468,-74.30240757,10197,429,0,9768,"Orange, New York, US",384940,2814,5043,2884,2159,145,530,675,146123,683510,6553371,27267254,57035
37135,"Orange","North Carolina",36.06092947,-79.12167935,294,39,0,255,"Orange, North Carolina, US",148476,496,1158,855,303,499,-305,194,75919,206158,2007830,8653203,19122
48361,"Orange","Texas",30.11879481,-93.89412775,89,2,0,87,"Orange, Texas, US",83396,-78,1014,940,74,-3,-147,-150,27806,97683,1165345,4688508,7316
50017,"Orange","Vermont",44.00470222,-72.37640104,8,0,0,8,"Orange, Vermont, US",28892,4,255,280,-25,2,31,33,9588,25360,222123,980557,3845
51137,"Orange","Virginia",38.24530219,-78.015604,77,0,0,77,"Orange, Virginia, US",37051,453,467,362,105,15,331,346,8552,28353,218595,940703,3475
45075,"Orangeburg","South Carolina",33.4391073,-80.79886287,135,2,0,133,"Orangeburg, South Carolina, US",86175,-838,950,1154,-204,24,-655,-631,32709,114052,896991,3635753,9021
29149,"Oregon","Missouri",36.68710164,-91.4033755,2,0,0,2,"Oregon, Missouri, US",10529,-29,111,146,-35,1,6,7,3066,6042,30058,128981,893
22071,"Orleans","Louisiana",30.06971951,-89.92660315,6944,500,0,6444,"Orleans, Louisiana, US",390144,-860,4399,3640,759,441,-2041,-1600,218690,1021901,11894361,46486585,56047
36073,"Orleans","New York",43.2516977,-78.2320066,196,23,0,173,"Orleans, New York, US",40352,-303,389,418,-29,2,-276,-274,13444,33353,252667,1026819,3472
50019,"Orleans","Vermont",44.82964024,-72.24562697,9,0,0,9,"Orleans, Vermont, US",27037,178,247,280,-33,6,207,213,11577,37532,296592,1242836,4160
20139,"Osage","Kansas",38.65235984,-95.72707998,7,0,0,7,"Osage, Kansas, US",15949,11,170,209,-39,3,48,51,3383,6957,38829,176806,1157
29151,"Osage","Missouri",38.46036182,-91.8613635,5,0,0,5,"Osage, Missouri, US",13615,-37,142,131,11,0,-48,-48,4653,12680,88980,368146,1317
40113,"Osage","Oklahoma",36.62888819,-96.39635704,94,8,0,86,"Osage, Oklahoma, US",46963,-158,418,522,-104,6,-58,-52,10000,25837,195087,824517,3094
20141,"Osborne","Kansas",39.3503437,-98.76753828,2,0,0,2,"Osborne, Kansas, US",3421,-38,41,36,5,1,-45,-44,1666,3528,26451,110969,571
12097,"Osceola","Florida",28.06312234,-81.14882926,648,18,0,630,"Osceola, Florida, US",375751,7295,4498,2465,2033,1208,4041,5249,94576,444302,3391946,14130773,37133
19143,"Osceola","Iowa",43.37824276,-95.62422844,30,0,0,30,"Osceola, Iowa, US",5958,-70,59,67,-8,2,-62,-60,2550,5138,44736,194373,863
26133,"Osceola","Michigan",43.98992088,-85.32566756,10,0,0,10,"Osceola, Michigan, US",23460,83,265,251,14,8,64,72,7610,23136,194078,832852,2202
26135,"Oscoda","Michigan",44.68192279,-84.12939244,5,1,0,4,"Oscoda, Michigan, US",8241,17,71,114,-43,1,58,59,2249,5027,31791,149115,792
36075,"Oswego","New York",43.42778894,-76.14635194,99,3,0,96,"Oswego, New York, US",117124,-391,1207,1090,117,15,-524,-509,37635,119025,1128085,4503011,12237
8089,"Otero","Colorado",37.9014485,-103.7173385,14,1,0,13,"Otero, Colorado, US",18278,-60,216,235,-19,7,-49,-42,7014,17877,128704,535126,2035
35035,"Otero","New Mexico",32.61348406,-105.7417604,12,1,0,11,"Otero, New Mexico, US",67490,831,934,615,319,263,250,513,23710,58510,411081,1690646,5234
31131,"Otoe","Nebraska",40.64843556,-96.13374142,6,0,0,6,"Otoe, Nebraska, US",16012,29,192,154,38,31,-39,-8,6910,17446,128155,524716,2412
26137,"Otsego","Michigan",45.02085831,-84.59898295,100,10,0,90,"Otsego, Michigan, US",24668,27,253,286,-33,-1,62,61,11892,41356,328811,1399597,4034
36077,"Otsego","New York",42.63492579,-75.03151402,68,5,0,63,"Otsego, New York, US",59493,-317,485,648,-163,25,-174,-149,28941,81702,682398,2863818,7725
20143,"Ottawa","Kansas",39.13237408,-97.65020313,4,0,0,4,"Ottawa, Kansas, US",5704,-48,39,57,-18,1,-32,-31,1632,2888,19785,85477,588
26139,"Ottawa","Michigan",42.95996803,-85.9969107,673,26,0,647,"Ottawa, Michigan, US",291830,2022,3267,1968,1299,295,438,733,119330,611581,6117720,26021182,36229
39123,"Ottawa","Ohio",41.53781826,-83.0940185,87,7,0,80,"Ottawa, Ohio, US",40525,-244,324,519,-195,-5,-39,-44,14968,44693,358074,1649544,5748
40115,"Ottawa","Oklahoma",36.83532655,-94.81011909,35,2,0,33,"Ottawa, Oklahoma, US",31127,-192,409,470,-61,15,-146,-131,12665,43060,287389,1218106,2928
27111,"Otter Tail","Minnesota",46.40846929,-95.70835255,53,0,0,53,"Otter Tail, Minnesota, US",58746,76,648,684,-36,31,87,118,24394,91072,728784,3175376,9555
5103,"Ouachita","Arkansas",33.58839816,-92.87795984,10,0,0,10,"Ouachita, Arkansas, US",23382,-238,249,338,-89,0,-147,-147,9094,36841,347014,1416699,2644
22073,"Ouachita","Louisiana",32.47645559,-92.15704172,1041,34,0,1007,"Ouachita, Louisiana, US",153279,-1292,2046,1648,398,40,-1731,-1691,69292,353079,3420876,13308022,25050
8091,"Ouray","Colorado",38.14717457,-107.7675136,8,1,0,7,"Ouray, Colorado, US",4952,130,20,34,-14,1,141,142,2222,5458,36567,184979,1405
55087,"Outagamie","Wisconsin",44.41578887,-88.46565023,181,6,0,175,"Outagamie, Wisconsin, US",187885,1006,2181,1320,861,104,48,152,100039,559966,6336532,25440877,29892
47133,"Overton","Tennessee",36.34117832,-85.28989535,20,0,0,20,"Overton, Tennessee, US",22241,173,233,314,-81,2,254,256,5473,15024,122736,506699,1545
18119,"Owen","Indiana",39.31145587,-86.83900724,30,1,0,29,"Owen, Indiana, US",20799,-63,201,262,-61,5,-4,1,5530,11515,77465,337365,1503
21187,"Owen","Kentucky",38.51679143,-84.82404619,1,0,0,1,"Owen, Kentucky, US",10901,20,109,109,0,0,20,20,2549,3081,20512,82007,502
21189,"Owsley","Kentucky",37.42823949,-83.68811419,2,0,0,2,"Owsley, Kentucky, US",4415,-59,60,65,-5,0,-55,-55,853,1134,6827,29404,135
16073,"Owyhee","Idaho",42.58016894,-116.1693871,8,0,0,8,"Owyhee, Idaho, US",11823,154,141,94,47,-5,110,105,3321,4860,29664,146407,821
23017,"Oxford","Maine",44.49952995,-70.75682123,19,0,0,19,"Oxford, Maine, US",57975,221,461,697,-236,19,439,458,18832,72275,558944,2328900,7452
55089,"Ozaukee","Wisconsin",43.38352225,-87.94625009,134,11,0,123,"Ozaukee, Wisconsin, US",89221,162,850,836,14,32,121,153,40641,200715,2086528,8780313,16295
53049,"Pacific","Washington",46.55418369,-123.7285716,9,1,0,8,"Pacific, Washington, US",22471,397,178,340,-162,32,523,555,6631,19877,136792,621834,2973
19145,"Page","Iowa",40.7393172,-95.1497813,10,0,0,10,"Page, Iowa, US",15107,-122,140,194,-54,1,-68,-67,7627,18474,147925,619664,1996
51139,"Page","Virginia",38.61807452,-78.48797204,186,21,0,165,"Page, Virginia, US",23902,-70,244,299,-55,1,-14,-13,6280,16875,114815,489585,2007
12099,"Palm Beach","Florida",26.64676272,-80.46536002,5140,315,0,4825,"Palm Beach, Florida, US",1496770,13894,14947,15460,-513,7748,6712,14460,624890,3109361,37573310,147727171,291571
19147,"Palo Alto","Iowa",43.08193849,-94.67824621,3,0,0,3,"Palo Alto, Iowa, US",8886,-17,106,108,-2,12,-27,-15,4111,11068,82601,349202,1382
48363,"Palo Pinto","Texas",32.75310985,-98.31319001,10,2,0,8,"Palo Pinto, Texas, US",29189,315,352,343,9,2,304,306,9387,23826,198079,842263,3180
37137,"Pamlico","North Carolina",35.15253315,-76.66559823,10,0,0,10,"Pamlico, North Carolina, US",12726,93,79,157,-78,2,169,171,3512,9227,55169,238117,1119
28107,"Panola","Mississippi",34.36398677,-89.95064249,61,2,0,59,"Panola, Mississippi, US",34192,36,487,411,76,24,-62,-38,11323,34086,244651,1021805,2963
48365,"Panola","Texas",32.1639596,-94.30552481,188,21,0,167,"Panola, Texas, US",23194,52,254,267,-13,15,53,68,9751,27232,269878,1154053,2439
8093,"Park","Colorado",39.120926,-105.7182065,23,0,0,23,"Park, Colorado, US",18845,320,134,117,17,-7,307,300,3944,7129,49846,240450,2376
30067,"Park","Montana",45.48965095,-110.5264394,8,0,0,8,"Park, Montana, US",16606,-42,154,166,-12,-4,-24,-28,6878,23106,166656,780922,4359
56029,"Park","Wyoming",44.52157546,-109.5852825,2,0,0,2,"Park, Wyoming, US",29194,-16,283,271,12,-10,-16,-26,15308,43732,418037,1831817,6691
18121,"Parke","Indiana",39.77202286,-87.20375833,17,0,0,17,"Parke, Indiana, US",16937,-41,203,175,28,5,-73,-68,3987,8572,55924,256714,1208
48367,"Parker","Texas",32.77757172,-97.80500621,67,1,0,66,"Parker, Texas, US",142878,4808,1548,1152,396,35,4369,4404,34891,157518,1437183,6159540,16001
48369,"Parmer","Texas",34.52993409,-102.7844668,39,0,0,39,"Parmer, Texas, US",9605,-114,137,52,85,19,-219,-200,5550,6982,61205,259391,932
12101,"Pasco","Florida",28.30810945,-82.40227529,341,12,0,329,"Pasco, Florida, US",553947,14857,5186,6466,-1280,519,15563,16082,125829,576444,5017657,20525620,57626
37139,"Pasquotank","North Carolina",36.26723798,-76.25134778,95,9,0,86,"Pasquotank, North Carolina, US",39824,241,463,370,93,34,112,146,17661,54883,444342,1785246,4988
34031,"Passaic","New Jersey",41.03238628,-74.29954144,15610,888,0,14722,"Passaic, New Jersey, US",501826,-1357,6602,3769,2833,1837,-6045,-4208,184222,816499,9167049,37816211,72416
51141,"Patrick","Virginia",36.6801638,-80.2865648,13,0,0,13,"Patrick, Virginia, US",17608,-55,153,240,-87,-4,37,33,5062,11435,75241,311059,1296
13223,"Paulding","Georgia",33.91969522,-84.86848792,275,11,0,264,"Paulding, Georgia, US",168667,4614,1860,1079,781,5,3820,3825,27806,103568,783426,3274785,11295
39125,"Paulding","Ohio",41.11676341,-84.5801017,13,0,0,13,"Paulding, Ohio, US",18672,-70,218,203,15,3,-89,-86,5167,14401,107282,454329,1432
40117,"Pawnee","Oklahoma",36.31743373,-96.7033176,29,2,0,27,"Pawnee, Oklahoma, US",16376,20,192,200,-8,4,23,27,4259,7886,64990,307101,1151
16075,"Payette","Idaho",44.00545243,-116.7647695,23,2,0,21,"Payette, Idaho, US",23951,444,306,214,92,-34,386,352,6469,22652,183816,760974,2636
40119,"Payne","Oklahoma",36.07695283,-96.97584944,45,1,0,44,"Payne, Oklahoma, US",81784,-388,815,592,223,396,-1014,-618,37716,121666,911112,3917073,10531
13225,"Peach","Georgia",32.56934316,-83.82937,70,3,0,67,"Peach, Georgia, US",27546,183,339,283,56,11,119,130,9276,24522,186245,799024,2378
28109,"Pearl River","Mississippi",30.77090935,-89.58677275,203,27,0,176,"Pearl River, Mississippi, US",55535,212,610,681,-71,-30,315,285,12049,38290,263004,1082156,4369
48371,"Pecos","Texas",30.78097267,-102.7241261,24,0,0,24,"Pecos, Texas, US",15823,114,189,99,90,-1,25,24,7030,15902,164151,665622,1580
38067,"Pembina","North Dakota",48.76623521,-97.5523809,6,0,0,6,"Pembina, North Dakota, US",6801,-94,70,84,-14,14,-94,-80,4100,9340,78708,351721,1262
29155,"Pemiscot","Missouri",36.2130572,-89.78742322,72,4,0,68,"Pemiscot, Missouri, US",15805,-451,224,236,-12,-8,-433,-441,5818,15510,108312,414695,1833
53051,"Pend Oreille","Washington",48.53234021,-117.2741804,2,0,0,2,"Pend Oreille, Washington, US",13724,138,119,161,-42,6,175,181,3508,5948,48212,213208,993
37141,"Pender","North Carolina",34.52265624,-77.90352133,65,1,0,64,"Pender, North Carolina, US",63060,1043,647,556,91,-2,957,955,12837,45866,305061,1338353,6007
21191,"Pendleton","Kentucky",38.69607718,-84.35599463,7,0,0,7,"Pendleton, Kentucky, US",14590,2,179,164,15,3,-15,-12,3127,5129,36291,152549,714
54071,"Pendleton","West Virginia",38.68314479,-79.35084086,6,0,0,6,"Pendleton, West Virginia, US",6969,-15,62,62,0,-1,-13,-14,2168,3781,23809,103993,573
27113,"Pennington","Minnesota",48.06642577,-96.0370814,7,0,0,7,"Pennington, Minnesota, US",14119,-54,164,129,35,9,-98,-89,10058,27157,244494,1061295,1846
46103,"Pennington","South Dakota",44.0025835,-102.8240777,138,3,0,135,"Pennington, South Dakota, US",113775,1825,1495,920,575,-13,1253,1240,59367,277068,2677383,10844678,22492
23019,"Penobscot","Maine",45.40194593,-68.65020455,98,1,0,97,"Penobscot, Maine, US",152148,331,1378,1594,-216,62,491,553,73447,306432,2793144,11788390,23958
17143,"Peoria","Illinois",40.78702156,-89.76078901,176,7,0,169,"Peoria, Illinois, US",179179,-1441,2445,1826,619,258,-2321,-2063,107061,458324,5423626,21671514,25699
55091,"Pepin","Wisconsin",44.58307413,-91.99949611,1,0,0,1,"Pepin, Wisconsin, US",7287,-17,78,93,-15,6,-8,-2,2810,6153,51169,233434,990
37143,"Perquimans","North Carolina",36.17847453,-76.40603143,23,2,0,21,"Perquimans, North Carolina, US",13463,82,116,146,-30,-8,122,114,2681,5246,35253,151495,894
1105,"Perry","Alabama",32.64048341,-87.29770589,29,0,0,29,"Perry, Alabama, US",8923,-147,95,121,-26,2,-124,-122,2125,5359,36089,150820,480
5105,"Perry","Arkansas",34.9459153,-92.94372564,12,0,0,12,"Perry, Arkansas, US",10455,75,117,138,-21,1,96,97,1764,2263,13792,56068,349
17145,"Perry","Illinois",38.08510853,-89.36856219,40,0,0,40,"Perry, Illinois, US",20916,-228,188,228,-40,4,-193,-189,6327,15848,108265,459303,2065
18123,"Perry","Indiana",38.07809328,-86.63741946,23,0,0,23,"Perry, Indiana, US",19169,92,205,184,21,-1,74,73,7513,19477,156566,632873,1681
21193,"Perry","Kentucky",37.25023553,-83.22922731,19,0,0,19,"Perry, Kentucky, US",25758,-450,321,409,-88,5,-368,-363,11792,41674,342293,1396832,2904
28111,"Perry","Mississippi",31.17161885,-88.99281835,43,2,0,41,"Perry, Mississippi, US",11973,55,128,115,13,-3,44,41,2606,5189,51761,207606,578
29157,"Perry","Missouri",37.70660776,-89.82741088,49,0,0,49,"Perry, Missouri, US",19136,-138,222,222,0,10,-150,-140,9605,34561,275296,1210731,2582
39127,"Perry","Ohio",39.73508655,-82.23804971,17,1,0,16,"Perry, Ohio, US",36134,95,420,369,51,6,40,46,7361,16829,120452,495059,2176
42099,"Perry","Pennsylvania",40.40206612,-77.26297447,45,1,0,44,"Perry, Pennsylvania, US",46272,118,493,459,34,5,83,88,10178,32796,199028,870400,4203
47135,"Perry","Tennessee",35.63708728,-87.86139634,13,0,0,13,"Perry, Tennessee, US",8076,26,102,104,-2,7,21,28,2302,4507,30948,127555,405
32027,"Pershing","Nevada",40.44003782,-118.4005641,0,0,0,0,"Pershing, Nevada, US",6725,40,53,43,10,0,29,29,2105,2738,42297,157978,194
37145,"Person","North Carolina",36.38989032,-78.97217358,37,1,0,36,"Person, North Carolina, US",39490,54,417,448,-31,-8,94,86,11586,36379,314192,1230131,3685
2195,"Petersburg","Alaska",57.13978948,-132.9540995,4,1,0,3,"Petersburg, Alaska, US",3266,22,30,29,1,2,19,21,1587,3039,23114,145004,611
51730,"Petersburg","Virginia",37.20530399,-77.39368102,87,2,0,85,"Petersburg, Virginia, US",31346,290,686,495,191,15,85,100,15263,51973,456053,1905784,3907
29159,"Pettis","Missouri",38.72798918,-93.28471706,70,1,0,69,"Pettis, Missouri, US",42339,-102,577,424,153,15,-270,-255,20042,77337,596904,2417708,5520
29161,"Phelps","Missouri",37.87736118,-91.79351727,4,0,0,4,"Phelps, Missouri, US",44573,22,461,421,40,173,-191,-18,20468,66280,464876,1936733,5784
31137,"Phelps","Nebraska",40.51156033,-99.41461667,18,0,0,18,"Phelps, Nebraska, US",9034,28,116,92,24,5,-1,4,4949,15029,130547,577581,1718
42101,"Philadelphia","Pennsylvania",40.00338507,-75.1379271,21234,1233,0,20001,"Philadelphia, Pennsylvania, US",1584064,472,20924,15561,5363,5649,-10446,-4797,730958,3728783,52801590,210018399,168449
5107,"Phillips","Arkansas",34.43268455,-90.84800154,7,1,0,6,"Phillips, Arkansas, US",17782,-272,267,255,12,-4,-281,-285,6273,18288,122921,528138,1917
8095,"Phillips","Colorado",40.59414277,-102.3577703,12,0,0,12,"Phillips, Colorado, US",4265,-20,42,57,-15,23,-28,-5,2183,3261,26359,110478,591
20147,"Phillips","Kansas",39.78465501,-99.34668865,2,0,0,2,"Phillips, Kansas, US",5234,-42,49,64,-15,0,-27,-27,2710,5679,47480,190837,1072
17147,"Piatt","Illinois",40.01360584,-88.59319339,10,0,0,10,"Piatt, Illinois, US",16344,-22,173,159,14,-1,-35,-36,4493,10050,78865,347101,1627
39129,"Pickaway","Ohio",39.64170392,-83.0243386,2038,35,0,2003,"Pickaway, Ohio, US",58457,380,604,587,17,-1,367,366,16286,46631,372284,1590001,4192
1107,"Pickens","Alabama",33.28094866,-88.08818103,88,4,0,84,"Pickens, Alabama, US",19930,-50,205,235,-30,14,-33,-19,4041,11074,80966,335145,1211
13227,"Pickens","Georgia",34.46589159,-84.46406611,43,3,0,40,"Pickens, Georgia, US",32591,577,297,349,-52,2,625,627,10621,29261,242460,1043840,3682
45077,"Pickens","South Carolina",34.88807695,-82.72791551,114,3,0,111,"Pickens, South Carolina, US",126884,1659,1159,1206,-47,240,1459,1699,40345,131890,950430,3958512,11626
47137,"Pickett","Tennessee",36.55606529,-85.077633,3,0,0,3,"Pickett, Tennessee, US",5048,-5,35,67,-32,-1,29,28,1513,2614,17663,78477,311
13229,"Pierce","Georgia",31.35928155,-82.21598442,88,3,0,85,"Pierce, Georgia, US",19465,77,263,226,37,-8,47,39,4655,12537,94309,389954,1549
31139,"Pierce","Nebraska",42.26434853,-97.60122773,2,0,0,2,"Pierce, Nebraska, US",7148,3,87,67,20,0,-18,-18,2355,6412,46121,205474,1127
38069,"Pierce","North Dakota",48.24977025,-99.96407787,4,0,0,4,"Pierce, North Dakota, US",3975,-95,41,55,-14,0,-82,-82,2164,4193,36562,153681,731
53053,"Pierce","Washington",47.03892768,-122.1405958,1728,69,0,1659,"Pierce, Washington, US",904980,11224,11498,7284,4214,1048,5944,6992,326598,1510340,16994852,71148030,108000
55093,"Pierce","Wisconsin",44.71850291,-92.4224416,36,0,0,36,"Pierce, Wisconsin, US",42754,162,380,290,90,-2,76,74,11324,32285,229193,1014723,4324
1109,"Pike","Alabama",31.80396383,-85.9408295,128,0,0,128,"Pike, Alabama, US",33114,-128,345,339,6,79,-210,-131,16189,48848,395374,1665198,3452
5109,"Pike","Arkansas",34.16250414,-93.65789349,4,0,0,4,"Pike, Arkansas, US",10718,52,102,130,-28,2,80,82,3693,7055,44967,206747,934
13231,"Pike","Georgia",33.09310242,-84.38790389,48,2,0,46,"Pike, Georgia, US",18962,315,205,189,16,0,299,299,2972,7253,56937,230554,1239
17149,"Pike","Illinois",39.62265059,-90.8877017,1,0,0,1,"Pike, Illinois, US",15561,-34,194,176,18,-1,-50,-51,5511,14283,107717,430700,1705
18125,"Pike","Indiana",38.40112197,-87.23574907,5,0,0,5,"Pike, Indiana, US",12389,1,131,145,-14,11,4,15,3873,6795,60931,247428,809
21195,"Pike","Kentucky",37.47088263,-82.39487445,28,2,0,26,"Pike, Kentucky, US",57876,-616,583,808,-225,-1,-390,-391,23406,83754,790698,3245533,6726
28113,"Pike","Mississippi",31.17507789,-90.40392572,194,11,0,183,"Pike, Mississippi, US",39288,-92,540,531,9,4,-104,-100,15256,57487,399663,1613155,5160
29163,"Pike","Missouri",39.34310674,-91.16980779,14,1,0,13,"Pike, Missouri, US",18302,-200,206,189,17,0,-217,-217,7129,16483,111340,458531,1836
39131,"Pike","Ohio",39.07634001,-83.06769584,6,0,0,6,"Pike, Ohio, US",27772,-160,334,379,-45,-2,-114,-116,10253,35887,413519,1655584,2075
42103,"Pike","Pennsylvania",41.33155042,-75.03208106,476,18,0,458,"Pike, Pennsylvania, US",55809,29,411,527,-116,6,144,150,13432,46166,292405,1320043,5066
4019,"Pima","Arizona",32.0971334,-111.7890033,2002,173,0,1829,"Pima, Arizona, US",1047279,10725,10891,10199,692,1204,8801,10005,416900,1842071,18319732,73258028,121334
4021,"Pinal","Arizona",32.90525627,-111.3449483,751,37,0,714,"Pinal, Arizona, US",462789,15983,4568,3330,1238,487,14180,14667,83086,267062,2362494,9413399,21670
27115,"Pine","Minnesota",46.12105238,-92.74070188,84,0,0,84,"Pine, Minnesota, US",29579,111,251,278,-27,3,137,140,10178,28429,183501,799997,3272
12103,"Pinellas","Florida",27.93130349,-82.72239666,1153,75,0,1078,"Pinellas, Florida, US",974996,1938,8104,12833,-4729,1336,5351,6687,428966,2257007,25077111,104541015,171999
27117,"Pipestone","Minnesota",44.02301619,-96.25841142,10,0,0,10,"Pipestone, Minnesota, US",9126,-1,132,112,20,23,-43,-20,4636,12142,83749,380372,1603
23021,"Piscataquis","Maine",45.83839062,-69.2860223,1,0,0,1,"Piscataquis, Maine, US",16785,39,121,226,-105,14,131,145,6273,18341,131377,566945,2254
8097,"Pitkin","Colorado",39.21720112,-106.9310027,57,2,0,55,"Pitkin, Colorado, US",17767,-209,130,55,75,93,-380,-287,16608,92964,995034,3625701,9103
37147,"Pitt","North Carolina",35.59535426,-77.37353178,254,2,0,252,"Pitt, North Carolina, US",180742,1167,2053,1432,621,101,444,545,81060,307142,2723290,11307423,20908
40121,"Pittsburg","Oklahoma",34.92065823,-95.7513432,40,3,0,37,"Pittsburg, Oklahoma, US",43654,-216,508,616,-108,3,-111,-108,18883,50113,423483,1724208,5152
51143,"Pittsylvania","Virginia",36.81980341,-79.39731264,28,1,0,27,"Pittsylvania, Virginia, US",60354,-547,491,766,-275,-1,-269,-270,15600,37115,285059,1219543,4528
6061,"Placer","California",39.06167234,-120.7240569,185,9,0,176,"Placer, California, US",398329,5999,3721,3480,241,79,5687,5766,156221,836758,10021400,41791499,64291
22075,"Plaquemines","Louisiana",29.42245447,-89.60322085,198,16,0,182,"Plaquemines, Louisiana, US",23197,-188,270,195,75,12,-277,-265,18620,41642,578142,2298896,3482
29165,"Platte","Missouri",39.38154439,-94.77068479,63,0,0,63,"Platte, Missouri, US",104418,1654,1191,693,498,208,946,1154,45624,216205,2254804,9039830,13788
31141,"Platte","Nebraska",41.57246836,-97.52144359,522,1,0,521,"Platte, Nebraska, US",33470,183,461,281,180,73,-69,4,19242,70065,603605,2591321,5672
56031,"Platte","Wyoming",42.13299116,-104.966331,1,0,0,1,"Platte, Wyoming, US",8393,-123,74,109,-35,-10,-77,-87,4202,8115,61262,251334,1271
54073,"Pleasants","West Virginia",39.37091679,-81.16771771,3,0,0,3,"Pleasants, West Virginia, US",7460,-45,68,76,-8,-1,-37,-38,2862,5902,72709,271862,489
6063,"Plumas","California",40.00355989,-120.8395236,4,0,0,4,"Plumas, California, US",18807,66,157,213,-56,-3,126,123,7257,16587,146067,689013,3134
19149,"Plymouth","Iowa",42.737633,-96.21366621,103,0,0,103,"Plymouth, Iowa, US",25177,153,276,231,45,17,95,112,11266,43157,433355,1703619,3813
25023,"Plymouth","Massachusetts",41.94070556,-70.80802823,7480,501,0,6979,"Plymouth, Massachusetts, US",521202,2780,5173,4757,416,1300,1105,2405,192057,1007813,10949399,47312409,75866
19151,"Pocahontas","Iowa",42.73420133,-94.67862564,4,0,0,4,"Pocahontas, Iowa, US",6619,-95,71,85,-14,0,-81,-81,3324,6671,54486,240513,992
54075,"Pocahontas","West Virginia",38.32758728,-80.00993811,24,0,0,24,"Pocahontas, West Virginia, US",8247,-161,76,127,-51,0,-108,-108,3488,10003,62703,225616,994
5111,"Poinsett","Arkansas",35.57433534,-90.66268713,31,2,0,29,"Poinsett, Arkansas, US",23528,-375,310,334,-24,-4,-348,-352,6156,18100,117867,500810,1788
22077,"Pointe Coupee","Louisiana",30.71409502,-91.60209535,182,22,0,160,"Pointe Coupee, Louisiana, US",21730,-149,236,253,-17,-5,-125,-130,6003,15884,132556,544023,1665
5113,"Polk","Arkansas",34.48254879,-94.22728802,9,0,0,9,"Polk, Arkansas, US",19964,-55,215,286,-71,-3,21,18,7473,19157,125601,535826,2202
12105,"Polk","Florida",27.95027105,-81.69732947,853,49,0,804,"Polk, Florida, US",724777,18180,8043,7237,806,673,16638,17311,217433,1051070,10362857,42044883,69514
13233,"Polk","Georgia",34.00267074,-85.18677781,96,0,0,96,"Polk, Georgia, US",42613,267,580,489,91,-5,181,176,12823,38620,311719,1271631,3238
19153,"Polk","Iowa",41.68679484,-93.57767461,3603,106,0,3497,"Polk, Iowa, US",490161,4328,6750,3580,3170,385,777,1162,276893,1542964,21060808,80891384,77489
27119,"Polk","Minnesota",47.77372465,-96.40134647,59,2,0,57,"Polk, Minnesota, US",31364,-47,421,344,77,35,-158,-123,13166,42936,332521,1419676,4046
29167,"Polk","Missouri",37.6162296,-93.39828174,3,0,0,3,"Polk, Missouri, US",32149,-65,399,388,11,-13,-63,-76,10313,30258,261312,1113054,2862
31143,"Polk","Nebraska",41.18813488,-97.56630712,9,0,0,9,"Polk, Nebraska, US",5213,-27,61,63,-2,3,-29,-26,1897,2919,22451,91208,615
37149,"Polk","North Carolina",35.27820615,-82.16812354,35,4,0,31,"Polk, North Carolina, US",20724,56,155,308,-153,13,195,208,5821,17713,120328,523422,2394
41053,"Polk","Oregon",44.90322804,-123.4128888,95,10,0,85,"Polk, Oregon, US",86085,1093,848,703,145,56,892,948,20181,69592,524526,2374955,8150
47139,"Polk","Tennessee",35.12245443,-84.52075859,14,0,0,14,"Polk, Tennessee, US",16832,-86,166,235,-69,2,-19,-17,3497,5988,35604,164920,1024
48373,"Polk","Texas",30.79472531,-94.8276624,52,0,0,52,"Polk, Texas, US",51353,1398,495,641,-146,108,1423,1531,14706,39785,322547,1347496,4098
55095,"Polk","Wisconsin",45.46130348,-92.44182875,15,1,0,14,"Polk, Wisconsin, US",43783,215,402,444,-42,4,255,259,16206,64705,526045,2218551,6145
30073,"Pondera","Montana",48.22773388,-112.2252703,2,0,0,2,"Pondera, Montana, US",5911,-49,77,56,21,13,-82,-69,2396,4385,28659,120074,806
28115,"Pontotoc","Mississippi",34.226046,-89.03636807,26,3,0,23,"Pontotoc, Mississippi, US",32174,293,434,282,152,24,119,143,10601,60294,501000,1987940,2459
40123,"Pontotoc","Oklahoma",34.72959848,-96.68337199,11,2,0,9,"Pontotoc, Oklahoma, US",38284,12,487,509,-22,42,-6,36,19060,57895,475758,2037675,5169
5115,"Pope","Arkansas",35.44871474,-93.03212219,107,1,0,106,"Pope, Arkansas, US",64072,478,765,593,172,11,296,307,27966,109047,849007,3526674,8956
17151,"Pope","Illinois",37.41391284,-88.56152109,1,0,0,1,"Pope, Illinois, US",4177,-7,25,39,-14,0,7,7,1063,672,3233,12730,174
27121,"Pope","Minnesota",45.58606667,-95.44451209,6,0,0,6,"Pope, Minnesota, US",11249,154,121,122,-1,5,151,156,4573,13969,127779,583890,1824
51735,"Poquoson","Virginia",37.14259351,-76.35798148,7,0,0,7,"Poquoson, Virginia, US",12271,102,107,113,-6,-1,111,110,2309,6221,37341,156310,961
39133,"Portage","Ohio",41.16793482,-81.19735782,309,58,0,251,"Portage, Ohio, US",162466,-36,1356,1462,-106,303,-229,74,60833,245174,2229855,9339005,17619
55097,"Portage","Wisconsin",44.47558711,-89.50152965,9,0,0,9,"Portage, Wisconsin, US",70772,-78,658,503,155,50,-283,-233,35839,154385,1537329,6188684,9771
18127,"Porter","Indiana",41.45986947,-87.06848888,465,21,0,444,"Porter, Indiana, US",170389,901,1618,1635,-17,103,828,931,62191,294405,3165999,13228366,20721
51740,"Portsmouth","Virginia",36.85914825,-76.35971629,253,11,0,242,"Portsmouth, Virginia, US",94398,-352,1415,1050,365,90,-796,-706,53201,125830,1120763,4654883,9341
18129,"Posey","Indiana",38.02097333,-87.86480429,17,0,0,17,"Posey, Indiana, US",25427,-127,242,261,-19,4,-111,-107,9327,35778,402832,1668187,2599
20149,"Pottawatomie","Kansas",39.37925655,-96.34564657,22,0,0,22,"Pottawatomie, Kansas, US",24383,174,347,195,152,6,17,23,10206,38258,326959,1294339,3218
40125,"Pottawatomie","Oklahoma",35.20614018,-96.94923008,56,4,0,52,"Pottawatomie, Oklahoma, US",72592,79,846,841,5,20,58,78,26074,86187,630195,2596393,7290
19155,"Pottawattamie","Iowa",41.33640314,-95.53907776,205,5,0,200,"Pottawattamie, Iowa, US",93206,-58,1110,941,169,-8,-216,-224,39350,157568,1300544,5393295,11292
42105,"Potter","Pennsylvania",41.74471626,-77.89559864,4,0,0,4,"Potter, Pennsylvania, US",16526,-97,164,216,-52,2,-46,-44,6568,17508,155004,639401,1857
48375,"Potter","Texas",35.40133773,-101.893964,2229,24,0,2205,"Potter, Texas, US",117415,-1296,1641,1135,506,416,-2221,-1805,76903,334587,3282149,13534455,20483
21197,"Powell","Kentucky",37.83218794,-83.82553961,1,0,0,1,"Powell, Kentucky, US",12359,-12,147,154,-7,2,-7,-5,2559,6519,38369,158579,738
16077,"Power","Idaho",42.69254894,-112.8395742,3,0,0,3,"Power, Idaho, US",7681,-19,115,61,54,-1,-73,-74,3737,6910,58475,248913,708
19157,"Poweshiek","Iowa",41.68625425,-92.53155731,88,8,0,80,"Poweshiek, Iowa, US",18504,37,166,198,-32,9,61,70,10865,31557,265558,1169417,2828
51145,"Powhatan","Virginia",37.55016038,-77.91267882,29,0,0,29,"Powhatan, Virginia, US",29652,442,241,236,5,-2,440,438,7145,25729,212511,946507,3719
5117,"Prairie","Arkansas",34.83624419,-91.55162157,2,0,0,2,"Prairie, Arkansas, US",8062,-20,80,116,-36,-2,19,17,2139,3522,23977,100554,674
20151,"Pratt","Kansas",37.64780729,-98.73922153,1,0,0,1,"Pratt, Kansas, US",9164,-176,95,87,8,4,-189,-185,4957,14220,124072,534191,1881
39135,"Preble","Ohio",39.7420247,-84.64787018,30,1,0,29,"Preble, Ohio, US",40882,-129,441,463,-22,15,-122,-107,12395,36047,290205,1159310,3416
28117,"Prentiss","Mississippi",34.61810501,-88.51986294,37,3,0,34,"Prentiss, Mississippi, US",25126,38,289,280,9,0,32,32,7140,23816,177506,710943,2378
26141,"Presque Isle","Michigan",45.34018577,-83.91498656,11,0,0,11,"Presque Isle, Michigan, US",12592,-106,100,181,-81,3,-27,-24,3594,8347,57710,259502,1548
54077,"Preston","West Virginia",39.46770987,-79.66712803,15,0,0,15,"Preston, West Virginia, US",33432,-121,309,364,-55,-11,-52,-63,8593,23231,176848,759575,2837
55099,"Price","Wisconsin",45.68051754,-90.3609888,2,0,0,2,"Price, Wisconsin, US",13351,-6,119,142,-23,3,16,19,6834,17080,134908,588169,2009
51147,"Prince Edward","Virginia",37.22554789,-78.43597949,108,2,0,106,"Prince Edward, Virginia, US",22802,-104,210,236,-26,19,-96,-77,10556,27019,203973,852946,2664
51149,"Prince George","Virginia",37.18497668,-77.22922187,60,0,0,60,"Prince George, Virginia, US",38353,360,327,257,70,15,280,295,21176,48341,324895,1400681,2364
24033,"Prince George's","Maryland",38.83070039,-76.8496441,13324,484,0,12840,"Prince George's, Maryland, US",909327,-292,12008,6852,5156,3991,-9430,-5439,336033,1540393,18374448,74747954,91314
51153,"Prince William","Virginia",38.70916224,-77.48713689,4408,84,0,4324,"Prince William, Virginia, US",470335,4100,6503,2152,4351,1264,-1529,-265,137413,584423,5987972,25635873,48927
2198,"Prince of Wales-Hyder","Alaska",55.76261984,-133.0511621,2,0,0,2,"Prince of Wales-Hyder, Alaska, US",6203,-157,59,53,6,2,-166,-164,2659,3852,28031,165567,755
44007,"Providence","Rhode Island",41.87064746,-71.57753536,10519,0,0,10519,"Providence, Rhode Island, US",638931,1978,7062,5548,1514,3220,-2744,476,296336,1578817,20668088,78677421,95381
8099,"Prowers","Colorado",37.95544985,-102.3926052,12,0,0,12,"Prowers, Colorado, US",12172,93,158,115,43,17,34,51,5405,12756,85978,353480,1641
8101,"Pueblo","Colorado",38.17359144,-104.5127437,260,14,0,246,"Pueblo, Colorado, US",168424,1002,1808,1834,-26,65,968,1033,62455,260738,2262338,9382574,18070
5119,"Pulaski","Arkansas",34.77054088,-92.31355101,773,29,0,744,"Pulaski, Arkansas, US",391911,-7,5067,3795,1272,153,-1415,-1262,246603,1217322,14270341,57344048,72952
13235,"Pulaski","Georgia",32.23334561,-83.4754996,39,2,0,37,"Pulaski, Georgia, US",11137,57,92,114,-22,-2,79,77,3886,6770,48384,203699,766
17153,"Pulaski","Illinois",37.22631423,-89.13085001,40,0,0,40,"Pulaski, Illinois, US",5335,-99,56,75,-19,2,-82,-80,2315,1953,15532,60998,371
18131,"Pulaski","Indiana",41.04166107,-86.69890683,38,0,0,38,"Pulaski, Indiana, US",12353,-139,122,135,-13,14,-141,-127,5122,12186,121425,490887,1519
21199,"Pulaski","Kentucky",37.10466131,-84.57629079,55,2,0,53,"Pulaski, Kentucky, US",64979,395,755,791,-36,-2,434,432,27112,106222,867047,3583376,7831
29169,"Pulaski","Missouri",37.82462075,-92.20783203,33,1,0,32,"Pulaski, Missouri, US",52607,610,676,297,379,48,183,231,32279,39957,257948,1108154,3737
51155,"Pulaski","Virginia",37.06474963,-80.71229738,10,0,0,10,"Pulaski, Virginia, US",34027,-33,308,452,-144,-3,115,112,15104,40251,327436,1327585,3084
40127,"Pushmataha","Oklahoma",34.41635232,-95.37603505,2,0,0,2,"Pushmataha, Oklahoma, US",11096,-96,110,144,-34,5,-66,-61,3123,7641,47741,195510,886
12107,"Putnam","Florida",29.60779729,-81.74230285,139,4,0,135,"Putnam, Florida, US",74521,478,826,1033,-207,-24,705,681,19912,60369,442652,1802579,6910
13237,"Putnam","Georgia",33.32056115,-83.37552891,85,8,0,77,"Putnam, Georgia, US",22119,299,212,276,-64,3,357,360,6757,18185,139806,572240,2206
17155,"Putnam","Illinois",41.2013541,-89.2869272,1,0,0,1,"Putnam, Illinois, US",5739,3,47,55,-8,0,12,12,1892,3428,36994,169569,519
18133,"Putnam","Indiana",39.66437981,-86.84517605,129,7,0,122,"Putnam, Indiana, US",37576,90,356,344,12,40,38,78,13717,46900,355090,1421089,3800
36079,"Putnam","New York",41.42630093,-73.74965532,1200,58,0,1142,"Putnam, New York, US",98320,-494,800,784,16,67,-579,-512,27666,109620,1106612,4844809,16770
39137,"Putnam","Ohio",41.02094889,-84.1336111,85,14,0,71,"Putnam, Ohio, US",33861,59,428,317,111,7,-58,-51,11738,43426,344312,1506547,3898
47141,"Putnam","Tennessee",36.14005459,-85.50646123,359,5,0,354,"Putnam, Tennessee, US",80245,1614,879,781,98,207,1305,1512,35862,149468,1230595,5072417,10309
54079,"Putnam","West Virginia",38.50782345,-81.9082131,31,0,0,31,"Putnam, West Virginia, US",56450,-192,504,596,-92,0,-98,-98,21169,85068,869525,3648745,6637
35037,"Quay","New Mexico",35.10403332,-103.5481727,5,1,0,4,"Quay, New Mexico, US",8253,11,90,95,-5,16,2,18,2878,8309,47986,196414,1031
24035,"Queen Anne's","Maryland",39.06198912,-76.03530977,146,12,0,134,"Queen Anne's, Maryland, US",50381,233,497,427,70,23,143,166,15851,62289,514385,2284941,7773
13239,"Quitman","Georgia",31.86728114,-85.01773177,11,1,0,10,"Quitman, Georgia, US",2299,39,16,24,-8,0,46,46,386,530,2948,12416,98
28119,"Quitman","Mississippi",34.25157572,-90.28908,23,0,0,23,"Quitman, Mississippi, US",6792,-263,80,110,-30,3,-236,-233,1353,1917,10328,44607,410
13241,"Rabun","Georgia",34.88389445,-83.40304637,15,1,0,14,"Rabun, Georgia, US",17137,280,144,212,-68,0,347,347,6325,22629,141932,632731,2456
55101,"Racine","Wisconsin",42.74753117,-88.05941254,1311,22,0,1289,"Racine, Wisconsin, US",196311,-46,2257,1664,593,-4,-633,-637,77754,350049,3677468,15511398,23588
51750,"Radford","Virginia",37.12222899,-80.5602732,4,0,0,4,"Radford, Virginia, US",18249,148,144,97,47,11,91,102,6707,15097,121080,483540,1469
48379,"Rains","Texas",32.87109387,-95.79232691,3,0,0,3,"Rains, Texas, US",12514,367,143,138,5,5,354,359,2481,4754,32116,134848,706
54081,"Raleigh","West Virginia",37.76936795,-81.2456041,14,0,0,14,"Raleigh, West Virginia, US",73361,-811,723,1052,-329,-5,-473,-478,31359,140880,1289123,5258226,10088
29173,"Ralls","Missouri",39.52817427,-91.51838643,2,0,0,2,"Ralls, Missouri, US",10309,75,101,76,25,0,49,49,3193,7192,74040,295228,863
27123,"Ramsey","Minnesota",45.01625271,-93.09872295,2164,94,0,2070,"Ramsey, Minnesota, US",550321,1449,7591,4234,3357,1880,-3770,-1890,323611,1743924,28240548,99522904,80945
38071,"Ramsey","North Dakota",48.26886249,-98.72223879,9,1,0,8,"Ramsey, North Dakota, US",11519,-61,174,130,44,19,-123,-104,6386,19393,162298,677719,2237
48381,"Randall","Texas",34.96585996,-101.8971322,645,5,0,640,"Randall, Texas, US",137713,2022,1587,1102,485,66,1474,1540,38493,164828,1464517,6082491,15300
1111,"Randolph","Alabama",33.29526734,-85.45708831,124,7,0,117,"Randolph, Alabama, US",22722,-5,254,285,-31,-6,33,27,5630,13935,97516,387712,1620
5121,"Randolph","Arkansas",36.3415714,-91.02455531,26,0,0,26,"Randolph, Arkansas, US",17958,-12,235,255,-20,-6,13,7,5314,13378,86638,368506,1482
13243,"Randolph","Georgia",31.76622818,-84.75732369,170,19,0,151,"Randolph, Georgia, US",6778,-34,63,71,-8,-1,-25,-26,2424,4012,32789,135049,505
17157,"Randolph","Illinois",38.05095369,-89.82512254,256,3,0,253,"Randolph, Illinois, US",31782,-395,320,379,-59,8,-344,-336,14138,41370,316707,1306903,3483
18135,"Randolph","Indiana",40.15734772,-85.01139319,37,3,0,34,"Randolph, Indiana, US",24665,-141,283,269,14,10,-165,-155,8146,21911,172346,726068,2302
29175,"Randolph","Missouri",39.44007257,-92.4971374,8,0,0,8,"Randolph, Missouri, US",24748,16,292,239,53,5,-42,-37,9572,32166,263324,1070191,2834
37151,"Randolph","North Carolina",35.71015088,-79.80570339,549,8,0,541,"Randolph, North Carolina, US",143667,418,1538,1573,-35,48,414,462,46842,208293,1660114,6951475,14527
54083,"Randolph","West Virginia",38.769899,-79.87919615,28,0,0,28,"Randolph, West Virginia, US",28695,-119,319,385,-66,-2,-49,-51,12275,41049,281989,1125075,3528
28121,"Rankin","Mississippi",32.26469147,-89.94537876,336,6,0,330,"Rankin, Mississippi, US",155271,1021,1696,1261,435,92,498,590,59809,304390,2849773,11646422,21572
38073,"Ransom","North Dakota",46.45621782,-97.65742504,8,0,0,8,"Ransom, North Dakota, US",5218,-6,49,73,-24,1,17,18,2783,5467,41585,179828,960
22079,"Rapides","Louisiana",31.19778499,-92.52997303,600,16,0,584,"Rapides, Louisiana, US",129648,-678,1636,1433,203,16,-900,-884,56691,247719,2257364,9285308,18184
51157,"Rappahannock","Virginia",38.68295619,-78.15826963,12,0,0,12,"Rappahannock, Virginia, US",7370,25,52,71,-19,3,41,44,2359,4679,37560,162472,996
30081,"Ravalli","Montana",46.08520862,-114.1189164,13,0,0,13,"Ravalli, Montana, US",43806,640,370,484,-114,-17,770,753,13246,46373,325656,1428511,8206
29177,"Ray","Missouri",39.3537468,-93.98905745,15,0,0,15,"Ray, Missouri, US",23018,73,262,279,-17,-4,93,89,4694,11659,89713,369863,1740
27125,"Red Lake","Minnesota",47.87197525,-96.09561104,3,0,0,3,"Red Lake, Minnesota, US",4055,63,42,29,13,1,48,49,1369,2180,14415,64399,405
22081,"Red River","Louisiana",32.09530039,-93.34213308,46,6,0,40,"Red River, Louisiana, US",8442,-84,114,127,-13,9,-79,-70,2617,5944,49721,206153,508
48387,"Red River","Texas",33.61886692,-95.04841765,42,4,0,38,"Red River, Texas, US",12023,-120,120,178,-58,-4,-55,-59,2724,4710,33511,143236,759
31145,"Red Willow","Nebraska",40.1755688,-100.476998,5,0,0,5,"Red Willow, Nebraska, US",10724,19,135,123,12,7,1,8,6095,15357,114835,484348,2041
27127,"Redwood","Minnesota",44.40555844,-95.25207021,3,0,0,3,"Redwood, Minnesota, US",15170,-82,192,159,33,4,-118,-114,7424,23043,191788,839060,2761
48389,"Reeves","Texas",31.32323325,-103.6903896,7,0,0,7,"Reeves, Texas, US",15976,463,186,106,80,51,330,381,6668,18212,238149,1042938,1484
48391,"Refugio","Texas",28.3238976,-97.15766311,3,0,0,3,"Refugio, Texas, US",6948,-52,66,51,15,1,-67,-66,2662,7208,76180,295086,612
20155,"Reno","Kansas",37.95230263,-98.08607292,43,0,0,43,"Reno, Kansas, US",61998,-333,670,699,-29,38,-340,-302,28502,108855,941964,3850057,9143
36083,"Rensselaer","New York",42.71348136,-73.51089874,463,28,0,435,"Rensselaer, New York, US",158714,-569,1548,1610,-62,126,-632,-506,57913,207629,2104271,9076165,17225
27129,"Renville","Minnesota",44.72836381,-94.94553734,5,0,0,5,"Renville, Minnesota, US",14548,-61,188,167,21,8,-90,-82,6565,18579,156653,695103,2454
38075,"Renville","North Dakota",48.71982533,-101.6603912,1,0,0,1,"Renville, North Dakota, US",2327,-31,17,26,-9,0,-22,-22,1131,1455,14507,61792,449
20157,"Republic","Kansas",39.82799632,-97.65036709,4,0,0,4,"Republic, Kansas, US",4636,-16,59,61,-2,5,-18,-13,2261,4048,26631,109672,686
29179,"Reynolds","Missouri",37.36085952,-90.97009925,2,0,0,2,"Reynolds, Missouri, US",6270,-12,64,91,-27,0,17,17,2837,3911,26792,119615,607
47143,"Rhea","Tennessee",35.60536161,-84.93076643,194,0,0,194,"Rhea, Tennessee, US",33167,256,388,405,-17,9,263,272,14754,31834,209366,876501,2537
20159,"Rice","Kansas",38.34616184,-98.19992118,4,0,0,4,"Rice, Kansas, US",9537,54,103,94,9,7,40,47,4340,10397,82592,336895,1240
27131,"Rice","Minnesota",44.3543376,-93.29658715,352,2,0,350,"Rice, Minnesota, US",66972,406,743,490,253,181,-25,156,29219,111512,956109,4118805,8677
31147,"Richardson","Nebraska",40.1247415,-95.71755036,1,0,0,1,"Richardson, Nebraska, US",7865,-73,90,118,-28,1,-46,-45,3044,6754,44374,188707,1286
17159,"Richland","Illinois",38.71240969,-88.08475366,3,0,0,3,"Richland, Illinois, US",15513,-182,162,187,-25,1,-157,-156,6985,20457,157295,646012,2336
22083,"Richland","Louisiana",32.41391005,-91.76634876,114,2,0,112,"Richland, Louisiana, US",20122,-101,249,245,4,-1,-103,-104,7361,20378,156059,627517,2063
30083,"Richland","Montana",47.78668011,-104.5610786,3,0,0,3,"Richland, Montana, US",10803,-52,125,81,44,-16,-78,-94,6177,20865,245202,977776,2686
38077,"Richland","North Dakota",46.26440649,-96.94852979,15,0,0,15,"Richland, North Dakota, US",16177,-52,190,126,64,-7,-109,-116,8615,21805,202848,845080,2638
39139,"Richland","Ohio",40.77180308,-82.5379961,179,3,0,176,"Richland, Ohio, US",121154,167,1319,1397,-78,11,240,251,51520,216703,1771954,7343439,15403
45079,"Richland","South Carolina",34.01791263,-80.90267209,1349,63,0,1286,"Richland, South Carolina, US",415759,1557,4631,3232,1399,990,-833,157,228526,932824,10684630,41197759,53875
55103,"Richland","Wisconsin",43.3762778,-90.43012729,14,4,0,10,"Richland, Wisconsin, US",17252,-145,164,187,-23,15,-138,-123,6869,18326,145415,604548,1803
13245,"Richmond","Georgia",33.35777107,-82.07026432,525,18,0,507,"Richmond, Georgia, US",202518,851,2893,2040,853,82,-76,6,121517,467660,4934665,20010989,24994
37153,"Richmond","North Carolina",35.00417719,-79.74491009,145,2,0,143,"Richmond, North Carolina, US",44829,-59,559,556,3,3,-64,-61,14353,46503,345441,1400410,4267
51159,"Richmond","Virginia",37.937575,-76.72920628,276,4,0,272,"Richmond, Virginia, US",9023,53,71,105,-34,4,83,87,3231,6039,38894,164847,677
51760,"Richmond City","Virginia",37.53255773,-77.47966921,979,19,0,960,"Richmond City, Virginia, US",230436,1215,3037,2046,991,374,-143,231,170933,694829,10233462,39219783,36503
20161,"Riley","Kansas",39.28935726,-96.73420026,61,1,0,60,"Riley, Kansas, US",74232,-480,854,360,494,416,-1398,-982,37947,110663,766985,3209628,9080
19159,"Ringgold","Iowa",40.73518949,-94.24368535,2,0,0,2,"Ringgold, Iowa, US",4894,-46,52,63,-11,1,-36,-35,1756,3534,25230,104050,551
35039,"Rio Arriba","New Mexico",36.51072137,-106.6931674,36,0,0,36,"Rio Arriba, New Mexico, US",38921,-102,417,459,-42,30,-88,-58,11731,27507,186455,807261,2911
8103,"Rio Blanco","Colorado",39.97913541,-108.2179009,1,0,0,1,"Rio Blanco, Colorado, US",6324,-6,62,43,19,11,-37,-26,3647,6261,81801,329762,1028
8105,"Rio Grande","Colorado",37.5836865,-106.3847838,16,0,0,16,"Rio Grande, Colorado, US",11267,-4,115,113,2,12,-17,-5,4135,12502,92924,405423,1698
18137,"Ripley","Indiana",39.10235626,-85.26212744,112,6,0,106,"Ripley, Indiana, US",28324,-126,343,300,43,9,-179,-170,11187,36883,313259,1322919,3452
29181,"Ripley","Missouri",36.65460667,-90.85990261,7,0,0,7,"Ripley, Missouri, US",13288,-132,137,204,-67,-2,-65,-67,3429,10645,48429,198222,1678
54085,"Ritchie","West Virginia",39.18094587,-81.06356878,1,0,0,1,"Ritchie, West Virginia, US",9554,-194,82,156,-74,1,-120,-119,3925,8279,69189,286319,883
6065,"Riverside","California",33.74314981,-115.9933578,6464,290,0,6174,"Riverside, California, US",2470546,24757,29482,18148,11334,303,13170,13473,727578,3401222,32609856,136592287,233134
47145,"Roane","Tennessee",35.84923189,-84.52458689,13,0,0,13,"Roane, Tennessee, US",53382,124,473,725,-252,-13,390,377,15777,40566,281974,1176238,3941
54087,"Roane","West Virginia",38.71622686,-81.35243568,8,0,0,8,"Roane, West Virginia, US",13688,-230,119,186,-67,0,-163,-163,3213,8198,60923,264358,1009
51161,"Roanoke","Virginia",37.26865804,-80.06396753,90,5,0,85,"Roanoke, Virginia, US",94186,100,697,1059,-362,115,354,469,36113,153047,1457443,5928159,11601
51770,"Roanoke City","Virginia",37.27791025,-79.96189766,141,9,0,132,"Roanoke City, Virginia, US",99143,134,1319,1218,101,235,-195,40,71149,349347,3436537,14887833,18208
46109,"Roberts","South Dakota",45.62975048,-96.94672673,23,0,0,23,"Roberts, South Dakota, US",10394,18,167,111,56,2,-37,-35,3994,7179,48730,211398,1063
48393,"Roberts","Texas",35.83809685,-100.813175,2,0,0,2,"Roberts, Texas, US",854,-44,8,9,-1,0,-45,-45,237,208,2312,11243,45
47147,"Robertson","Tennessee",36.52454807,-86.87346725,360,0,0,360,"Robertson, Tennessee, US",71813,634,869,664,205,46,383,429,21042,82001,718717,2909839,6473
48395,"Robertson","Texas",31.02539637,-96.51272246,7,0,0,7,"Robertson, Texas, US",17074,-145,211,170,41,12,-198,-186,5275,11982,94078,367308,1334
37155,"Robeson","North Carolina",34.64244496,-79.1025053,646,12,0,634,"Robeson, North Carolina, US",130625,-1259,1697,1378,319,58,-1636,-1578,42683,158715,1146128,4759919,10308
27133,"Rock","Minnesota",43.67482683,-96.25296832,20,0,0,20,"Rock, Minnesota, US",9315,-86,104,94,10,-5,-91,-96,3910,10213,75363,322192,1262
55105,"Rock","Wisconsin",42.67151616,-89.071479,529,16,0,513,"Rock, Wisconsin, US",163354,480,1877,1471,406,39,42,81,62780,314339,3270656,13565804,19531
17161,"Rock Island","Illinois",41.46613806,-90.57042164,627,22,0,605,"Rock Island, Illinois, US",141879,-742,1661,1543,118,298,-1158,-860,79219,308886,3522925,15544375,17851
51163,"Rockbridge","Virginia",37.81204314,-79.44605905,14,0,0,14,"Rockbridge, Virginia, US",22573,-188,122,255,-133,3,-54,-51,6738,24760,145153,621756,2106
21203,"Rockcastle","Kentucky",37.36642393,-84.31176452,13,0,0,13,"Rockcastle, Kentucky, US",16695,-128,164,243,-79,0,-48,-48,4164,8290,51735,225808,849
13247,"Rockdale","Georgia",33.65145002,-84.02202167,258,9,0,249,"Rockdale, Georgia, US",90896,391,971,750,221,38,136,174,37131,156473,1457727,6316135,11587
33015,"Rockingham","New Hampshire",42.98499744,-71.12883377,1218,62,0,1156,"Rockingham, New Hampshire, US",309769,1482,2663,2519,144,181,1173,1354,147052,804571,9793018,40557266,58890
37157,"Rockingham","North Carolina",36.39593137,-79.77504841,65,2,0,63,"Rockingham, North Carolina, US",91010,393,871,1174,-303,2,696,698,30009,107252,794710,3249692,9304
51165,"Rockingham","Virginia",38.51006137,-78.87260325,452,6,0,446,"Rockingham, Virginia, US",81948,687,855,772,83,38,568,606,34351,126543,1199923,4872056,8362
36087,"Rockland","New York",41.15027894,-74.02560498,12934,618,0,12316,"Rockland, New York, US",325789,267,5370,2457,2913,504,-3177,-2673,115103,632485,7088478,28620648,60566
48397,"Rockwall","Texas",32.89779518,-96.40771592,147,9,0,138,"Rockwall, Texas, US",104915,4369,1067,639,428,64,3871,3935,30066,148551,1286744,5502782,12955
40131,"Rogers","Oklahoma",36.37004357,-95.60406759,78,5,0,73,"Rogers, Oklahoma, US",92459,658,1004,898,106,34,524,558,29199,127545,1439232,6120434,9803
38079,"Rolette","North Dakota",48.77245354,-99.84097493,4,0,0,4,"Rolette, North Dakota, US",14176,-173,226,187,39,0,-213,-213,4626,7772,56311,232957,838
20163,"Rooks","Kansas",39.35022773,-99.32484567,6,0,0,6,"Rooks, Kansas, US",4920,-75,49,70,-21,0,-55,-55,2542,5259,39413,154791,809
30085,"Roosevelt","Montana",48.29607488,-105.0079268,7,0,0,7,"Roosevelt, Montana, US",11004,-65,205,170,35,6,-107,-101,4038,6250,43484,180729,989
35041,"Roosevelt","New Mexico",34.02097406,-103.4799493,31,0,0,31,"Roosevelt, New Mexico, US",18500,-259,253,145,108,34,-403,-369,6964,14339,104865,428183,1552
26143,"Roscommon","Michigan",44.33473082,-84.61067651,21,0,0,21,"Roscommon, Michigan, US",24019,207,161,376,-215,2,419,421,7242,23820,150434,631517,2772
27135,"Roseau","Minnesota",48.77501878,-95.81079919,1,0,0,1,"Roseau, Minnesota, US",15165,7,168,123,45,6,-44,-38,8949,21533,165304,715657,2009
39141,"Ross","Ohio",39.33705391,-83.06000914,62,2,0,60,"Ross, Ohio, US",76666,-218,844,849,-5,9,-220,-211,29346,107701,1013747,4166445,6699
8107,"Routt","Colorado",40.48596505,-106.9905548,59,6,0,53,"Routt, Colorado, US",25638,131,207,133,74,43,14,57,14633,75599,625348,2431882,9756
21205,"Rowan","Kentucky",38.19484205,-83.42088935,7,0,0,7,"Rowan, Kentucky, US",24460,-43,268,215,53,-5,-91,-96,11695,29872,211010,856046,2377
37159,"Rowan","North Carolina",35.64003916,-80.52446628,603,27,0,576,"Rowan, North Carolina, US",142088,960,1575,1570,5,51,906,957,49428,205281,1853559,7686651,14998
48399,"Runnels","Texas",31.8314342,-99.97616148,2,0,0,2,"Runnels, Texas, US",10264,86,106,123,-17,8,98,106,3678,8305,59451,255055,1033
18139,"Rush","Indiana",39.62002287,-85.4655599,45,2,0,43,"Rush, Indiana, US",16581,-54,183,184,-1,7,-59,-52,5263,15786,139423,566770,1706
48401,"Rusk","Texas",32.10773545,-94.76176432,42,2,0,40,"Rusk, Texas, US",54406,105,562,557,5,-13,117,104,16139,44592,438425,1867865,4319
55107,"Rusk","Wisconsin",45.47498854,-91.1333012,4,0,0,4,"Rusk, Wisconsin, US",14178,68,139,163,-24,12,82,94,6236,13176,110519,449010,1462
1113,"Russell","Alabama",32.28725256,-85.18415324,125,0,0,125,"Russell, Alabama, US",57961,177,810,608,202,-49,26,-23,13947,49589,375532,1519028,4234
21207,"Russell","Kentucky",36.99308373,-85.06070117,22,4,0,18,"Russell, Kentucky, US",17923,133,203,224,-21,7,149,156,6255,15962,98439,414584,1610
51167,"Russell","Virginia",36.9302832,-82.10095486,8,0,0,8,"Russell, Virginia, US",26586,-209,229,357,-128,0,-79,-79,7746,24779,203871,853435,2383
37161,"Rutherford","North Carolina",35.40114178,-81.92112099,161,7,0,154,"Rutherford, North Carolina, US",67029,254,662,862,-200,-6,461,455,20628,75510,550052,2256722,6916
47149,"Rutherford","Tennessee",35.84591405,-86.4107263,977,22,0,955,"Rutherford, Tennessee, US",332285,7638,4109,2071,2038,551,5039,5590,123980,594682,6023606,24565865,31391
50021,"Rutland","Vermont",43.57723578,-73.03741676,51,1,0,50,"Rutland, Vermont, US",58191,-405,498,669,-171,8,-242,-234,28962,113075,936013,3824582,12102
22085,"Sabine","Louisiana",31.56388699,-93.55433981,39,0,0,39,"Sabine, Louisiana, US",23884,-17,262,234,28,-2,-41,-43,6804,17951,148109,604669,2435
48403,"Sabine","Texas",31.34318809,-93.85440451,4,0,0,4,"Sabine, Texas, US",10542,-34,100,144,-44,-4,16,12,2179,5386,45419,178443,706
19161,"Sac","Iowa",42.38624071,-95.10547892,13,0,0,13,"Sac, Iowa, US",9721,16,106,117,-11,0,29,29,3954,9487,85314,335391,1645
6067,"Sacramento","California",38.45106826,-121.3425374,1289,56,0,1233,"Sacramento, California, US",1552058,13312,19192,12368,6824,3042,3456,6498,621683,2798021,36574994,150582712,176481
23023,"Sagadahoc","Maine",43.95415864,-69.85074999,28,0,0,28,"Sagadahoc, Maine, US",35856,166,313,402,-89,2,255,257,16408,46539,427103,1796934,5132
26145,"Saginaw","Michigan",43.33433923,-84.0513121,982,105,0,877,"Saginaw, Michigan, US",190539,-252,2188,2138,50,125,-421,-296,90750,422426,3930087,16195173,24719
8109,"Saguache","Colorado",38.08054629,-106.282466,24,0,0,24,"Saguache, Colorado, US",6824,-16,69,59,10,9,-34,-25,2160,3939,26432,111740,509
34033,"Salem","New Jersey",39.58719656,-75.3469663,535,27,0,508,"Salem, New Jersey, US",62385,-361,684,756,-72,9,-300,-291,24169,69492,710798,2897165,6347
51775,"Salem","Virginia",37.2836193,-80.06219455,32,3,0,29,"Salem, Virginia, US",25301,8,300,331,-31,11,30,41,23462,74723,793281,3199679,5513
5125,"Saline","Arkansas",34.64916145,-92.67583224,87,1,0,86,"Saline, Arkansas, US",122437,1363,1280,1100,180,-9,1197,1188,27840,110662,811824,3449721,11244
17165,"Saline","Illinois",37.75332999,-88.54119706,6,0,0,6,"Saline, Illinois, US",23491,-298,278,343,-65,-2,-231,-233,9811,35334,301141,1138409,3005
20169,"Saline","Kansas",38.78369175,-97.65185177,24,2,0,22,"Saline, Kansas, US",54224,-163,682,500,182,2,-346,-344,29901,129566,1061598,4471266,8528
29195,"Saline","Missouri",39.13734288,-93.20259964,266,2,0,264,"Saline, Missouri, US",22761,-129,240,241,-1,45,-174,-129,10268,26565,205582,835203,2516
31151,"Saline","Nebraska",40.52418865,-97.14085859,467,1,0,466,"Saline, Nebraska, US",14224,-112,190,131,59,60,-233,-173,7026,19604,204836,790985,1488
49035,"Salt Lake","Utah",40.66616532,-111.9216011,4441,67,0,4374,"Salt Lake, Utah, US",1160437,11745,16530,6741,9789,3592,-1604,1988,606597,3502599,43818259,176950320,193672
45081,"Saluda","South Carolina",34.00795823,-81.72713237,134,0,0,134,"Saluda, South Carolina, US",20473,76,226,199,27,28,22,50,5856,17960,139655,560359,1163
37163,"Sampson","North Carolina",34.98820368,-78.36914061,367,1,0,366,"Sampson, North Carolina, US",63531,186,825,685,140,128,-78,50,21564,59755,438704,1783079,5356
48405,"San Augustine","Texas",31.39457611,-94.17000399,28,1,0,27,"San Augustine, Texas, US",8237,-17,78,118,-40,1,23,24,1896,3616,27123,123518,534
6069,"San Benito","California",36.60308176,-121.069975,69,2,0,67,"San Benito, California, US",62808,1341,774,324,450,-38,926,888,17470,58206,563959,2441129,5268
6071,"San Bernardino","California",34.84060306,-116.1774685,4315,176,0,4139,"San Bernardino, California, US",2180085,13332,29341,15223,14118,162,-914,-752,744663,3552604,36385587,151456727,213298
6073,"San Diego","California",33.03484597,-116.7365326,6559,249,0,6310,"San Diego, California, US",3338330,4469,40603,23052,17551,6733,-19731,-12998,1534345,7530736,108319555,432912990,509765
6075,"San Francisco","California",37.75215114,-122.4385672,2350,40,0,2310,"San Francisco, California, US",881549,853,8868,6359,2509,4498,-6094,-1596,661099,3844233,106309347,398469175,206490
48407,"San Jacinto","Texas",30.57933681,-95.16260304,13,0,0,13,"San Jacinto, Texas, US",28859,142,298,315,-17,-10,169,159,3692,4406,27848,120555,900
6077,"San Joaquin","California",37.93433732,-121.2730061,752,33,0,719,"San Joaquin, California, US",762148,9657,9975,5838,4137,687,4842,5529,242122,1108268,11600118,48638501,68417
8111,"San Juan","Colorado",37.76248981,-107.6763289,1,0,0,1,"San Juan, Colorado, US",728,-36,4,4,0,0,-37,-37,299,887,4932,27833,284
35045,"San Juan","New Mexico",36.50838318,-108.320437,1490,103,0,1387,"San Juan, New Mexico, US",123958,-1541,1410,1109,301,-12,-1837,-1849,51694,184127,1873250,7526437,15237
49037,"San Juan","Utah",37.62762978,-109.8033714,259,4,0,255,"San Juan, Utah, US",15308,-50,186,128,58,1,-109,-108,5137,10193,69400,333833,1103
53055,"San Juan","Washington",48.60182783,-122.96745,15,0,0,15,"San Juan, Washington, US",17582,458,88,132,-44,27,474,501,7400,25758,199049,994478,5679
6079,"San Luis Obispo","California",35.38822029,-120.4039028,259,1,0,258,"San Luis Obispo, California, US",283111,-243,2488,2465,23,-7,-245,-252,121723,512949,5068613,21740945,49843
6081,"San Mateo","California",37.4228808,-122.3275546,1833,76,0,1757,"San Mateo, California, US",766573,-2108,8425,5187,3238,3610,-8953,-5343,380392,2158669,61493874,238508635,127644
8113,"San Miguel","Colorado",38.00450883,-108.4020725,23,0,0,23,"San Miguel, Colorado, US",8179,-1,61,24,37,41,-79,-38,5075,24474,222959,861217,3330
35047,"San Miguel","New Mexico",35.48014807,-104.8163562,10,0,0,10,"San Miguel, New Mexico, US",27277,-203,247,271,-24,41,-222,-181,8325,28693,168550,680582,2293
48409,"San Patricio","Texas",28.00880118,-97.51763891,28,0,0,28,"San Patricio, Texas, US",66730,59,915,584,331,46,-318,-272,20939,67725,662257,2874433,5848
48411,"San Saba","Texas",31.1577796,-98.81758731,1,0,0,1,"San Saba, Texas, US",6055,-5,65,79,-14,7,2,9,2168,3155,20306,84054,628
46111,"Sanborn","South Dakota",44.02351092,-98.0909816,9,0,0,9,"Sanborn, South Dakota, US",2344,-52,33,17,16,0,-69,-69,883,746,5105,22472,182
35043,"Sandoval","New Mexico",35.68862401,-106.8687803,529,24,0,505,"Sandoval, New Mexico, US",146748,1652,1405,1145,260,-22,1414,1392,35556,119850,1014017,4054134,10013
39143,"Sandusky","Ohio",41.35624126,-83.137872,65,10,0,55,"Sandusky, Ohio, US",58518,-222,603,624,-21,2,-201,-199,26964,104012,870981,3679437,7427
17167,"Sangamon","Illinois",39.75836914,-89.65872023,328,26,0,302,"Sangamon, Illinois, US",194672,-967,2201,2101,100,203,-1272,-1069,109663,452736,4465485,18286930,29538
26151,"Sanilac","Michigan",43.42406072,-82.82055898,39,5,0,34,"Sanilac, Michigan, US",41170,-22,426,491,-65,4,42,46,13362,39206,300200,1297714,4361
6083,"Santa Barbara","California",34.65329488,-120.0188492,1551,12,0,1539,"Santa Barbara, California, US",446499,719,5390,3288,2102,553,-1924,-1371,213822,865117,10919310,45255722,69982
6085,"Santa Clara","California",37.23104908,-121.6970462,2571,139,0,2432,"Santa Clara, California, US",1927852,-4485,21713,11258,10455,13409,-28421,-15012,1015257,6153791,181973152,742918806,291585
4023,"Santa Cruz","Arizona",31.52508998,-110.8479088,143,0,0,143,"Santa Cruz, Arizona, US",46498,103,619,316,303,56,-257,-201,17453,63524,535859,2176218,6400
6087,"Santa Cruz","California",37.05580291,-122.0066524,192,2,0,190,"Santa Cruz, California, US",273213,-628,2540,1885,655,59,-1339,-1280,117139,448728,4992623,21106708,41809
35049,"Santa Fe","New Mexico",35.50708973,-105.9774716,129,3,0,126,"Santa Fe, New Mexico, US",150358,597,1189,1191,-2,63,542,605,71801,260169,2259576,10022535,27932
12113,"Santa Rosa","Florida",30.6934145,-87.02458128,207,9,0,198,"Santa Rosa, Florida, US",184313,5018,1971,1692,279,-68,4787,4719,41461,144797,1244700,4962064,15918
12115,"Sarasota","Florida",27.18546175,-82.33174248,576,73,0,503,"Sarasota, Florida, US",433742,7413,2835,6127,-3292,724,9945,10669,170172,845140,9015035,36867653,83218
36091,"Saratoga","New York",43.10904162,-73.86653895,452,11,0,441,"Saratoga, New York, US",229863,-307,2103,2050,53,132,-490,-358,86417,383602,4065247,17663780,31949
38081,"Sargent","North Dakota",46.10830372,-97.63217159,3,0,0,3,"Sargent, North Dakota, US",3898,47,45,33,12,3,31,34,3072,3211,32524,140672,446
31153,"Sarpy","Nebraska",41.11314181,-96.11156432,434,2,0,432,"Sarpy, Nebraska, US",187196,3134,2490,1069,1421,107,1607,1714,63826,303924,3159605,12899330,21717
55111,"Sauk","Wisconsin",43.42574087,-89.94966132,77,3,0,74,"Sauk, Wisconsin, US",64442,124,728,606,122,19,-14,5,34799,156764,1368688,5821437,10271
31155,"Saunders","Nebraska",41.2278103,-96.63773905,27,1,0,26,"Saunders, Nebraska, US",21578,304,247,202,45,3,258,261,6158,17018,126260,559501,2895
55113,"Sawyer","Wisconsin",45.87931905,-91.14504927,7,0,0,7,"Sawyer, Wisconsin, US",16558,94,150,204,-54,2,146,148,7151,22591,166826,757224,3364
36093,"Schenectady","New York",42.81668777,-74.05278291,648,29,0,619,"Schenectady, New York, US",155299,220,1792,1486,306,223,-305,-82,66766,266570,3208132,12776169,17647
13249,"Schley","Georgia",32.2654021,-84.31258912,16,1,0,15,"Schley, Georgia, US",5257,27,46,38,8,12,7,19,1117,1611,11574,49560,174
36095,"Schoharie","New York",42.58831742,-74.4433903,49,0,0,49,"Schoharie, New York, US",30999,-147,237,313,-76,6,-76,-70,10745,20720,159137,753452,3057
26153,"Schoolcraft","Michigan",46.19235734,-86.19972234,4,0,0,4,"Schoolcraft, Michigan, US",8094,50,64,108,-44,-1,94,93,2682,6802,49624,220418,1024
17169,"Schuyler","Illinois",40.1571798,-90.61114163,10,0,0,10,"Schuyler, Illinois, US",6768,-102,54,93,-39,6,-68,-62,2093,3813,24711,113009,620
36097,"Schuyler","New York",42.39184015,-76.8773299,11,0,0,11,"Schuyler, New York, US",17807,-77,146,187,-41,6,-40,-34,5747,13100,98202,436156,1816
42107,"Schuylkill","Pennsylvania",40.70497338,-76.2150785,576,26,0,550,"Schuylkill, Pennsylvania, US",141359,-456,1282,1778,-496,23,27,50,51678,210523,1811813,7473557,15772
39145,"Scioto","Ohio",38.80270163,-82.98907345,14,0,0,14,"Scioto, Ohio, US",75314,-166,825,958,-133,8,-39,-31,24912,101906,798293,3441004,7124
29199,"Scotland","Missouri",40.45214695,-92.14709064,4,0,0,4,"Scotland, Missouri, US",4902,-36,73,40,33,0,-69,-69,1724,2676,16975,72539,579
37165,"Scotland","North Carolina",34.8386299,-79.4757978,62,0,0,62,"Scotland, North Carolina, US",34823,72,436,427,9,13,53,66,12243,40776,291938,1281678,3065
5127,"Scott","Arkansas",34.85588887,-94.0632176,1,0,0,1,"Scott, Arkansas, US",10281,-58,112,117,-5,-5,-48,-53,3877,4863,31135,138138,627
18143,"Scott","Indiana",38.68672078,-85.74627859,115,3,0,112,"Scott, Indiana, US",23873,89,262,310,-48,20,117,137,7084,25061,179066,743691,1950
19163,"Scott","Iowa",41.63935978,-90.61959493,329,9,0,320,"Scott, Iowa, US",172943,140,2069,1509,560,65,-481,-416,85786,432164,4325605,17345932,26313
20171,"Scott","Kansas",38.48222076,-100.9066539,13,0,0,13,"Scott, Kansas, US",4823,-86,58,59,-1,-2,-83,-85,2262,5690,45456,184129,871
21209,"Scott","Kentucky",38.29622293,-84.5816631,34,0,0,34,"Scott, Kentucky, US",57004,1036,702,437,265,-6,776,770,28381,84932,890197,3768595,4960
27139,"Scott","Minnesota",44.6490231,-93.53340251,334,2,0,332,"Scott, Minnesota, US",149013,1822,1765,677,1088,126,611,737,48665,233561,2472933,10835094,19737
28123,"Scott","Mississippi",32.4067041,-89.53789439,587,10,0,577,"Scott, Mississippi, US",28124,-195,451,312,139,20,-355,-335,11757,56052,442012,1838873,2578
29201,"Scott","Missouri",37.05588075,-89.56474493,91,8,0,83,"Scott, Missouri, US",38280,-261,482,454,28,-6,-280,-286,16917,59964,509892,2111739,5746
47151,"Scott","Tennessee",36.42325673,-84.50360494,11,0,0,11,"Scott, Tennessee, US",22068,40,257,287,-30,0,72,72,6238,14239,93541,408309,1607
51169,"Scott","Virginia",36.71466456,-82.60171704,7,2,0,5,"Scott, Virginia, US",21566,-106,176,302,-126,-1,23,22,5303,14290,94050,376099,1332
31157,"Scotts Bluff","Nebraska",41.85070896,-103.7080986,62,0,0,62,"Scotts Bluff, Nebraska, US",35618,-307,454,388,66,23,-397,-374,18423,64553,518312,2192405,6080
13251,"Screven","Georgia",32.74976524,-81.60779441,26,2,0,24,"Screven, Georgia, US",13966,6,196,176,20,3,-17,-14,4234,8340,59241,240131,991
48415,"Scurry","Texas",32.74613808,-100.9162664,2,0,0,2,"Scurry, Texas, US",16703,-109,203,182,21,6,-136,-130,7925,28439,352106,1463440,2101
5129,"Searcy","Arkansas",35.9109364,-92.69936482,6,0,0,6,"Searcy, Arkansas, US",7881,-49,73,111,-38,2,-11,-9,2026,3074,16393,67555,442
5131,"Sebastian","Arkansas",35.19605503,-94.27162713,19,0,0,19,"Sebastian, Arkansas, US",127827,257,1780,1276,504,-51,-194,-245,69392,325281,3013985,12435911,19897
20173,"Sedgwick","Kansas",37.6842718,-97.4608198,553,21,0,532,"Sedgwick, Kansas, US",516042,2558,6705,4511,2194,622,-240,382,255609,1332778,15614805,60422291,72765
12117,"Seminole","Florida",28.7158582,-81.24060348,454,12,0,442,"Seminole, Florida, US",471826,3704,4714,3672,1042,836,1840,2676,178461,1015156,11190834,44944238,80956
13253,"Seminole","Georgia",30.93464824,-84.86823924,42,2,0,40,"Seminole, Georgia, US",8090,-180,94,116,-22,-1,-157,-158,2681,5219,41177,170866,789
40133,"Seminole","Oklahoma",35.16478725,-96.61686741,21,2,0,19,"Seminole, Oklahoma, US",24258,-262,304,354,-50,1,-214,-213,8414,21585,164775,685555,2222
36099,"Seneca","New York",42.78081007,-76.82497064,54,0,0,54,"Seneca, New York, US",34016,-163,318,313,5,8,-175,-167,13131,43396,345387,1413882,3798
39147,"Seneca","Ohio",41.12351311,-83.12783209,17,2,0,15,"Seneca, Ohio, US",55178,-16,589,561,28,34,-76,-42,19378,81494,671340,2717529,5685
47153,"Sequatchie","Tennessee",35.36979721,-85.41022136,10,0,0,10,"Sequatchie, Tennessee, US",15026,135,166,168,-2,-1,138,137,3117,6353,36022,156532,806
40135,"Sequoyah","Oklahoma",35.49447108,-94.75463785,14,3,0,11,"Sequoyah, Oklahoma, US",41569,-16,512,545,-33,23,-3,20,10619,30347,170298,706548,3022
5133,"Sevier","Arkansas",33.99780401,-94.2424869,79,1,0,78,"Sevier, Arkansas, US",17007,-54,246,149,97,-22,-130,-152,5659,11448,91375,372668,1245
47155,"Sevier","Tennessee",35.78077323,-83.52244332,72,2,0,70,"Sevier, Tennessee, US",98250,355,1025,1063,-38,169,230,399,43566,227003,1307013,6138314,16144
20175,"Seward","Kansas",37.19324632,-100.8507201,821,1,0,820,"Seward, Kansas, US",21428,-474,403,110,293,106,-878,-772,11953,28812,223625,970248,2927
31159,"Seward","Nebraska",40.87241834,-97.139673,27,1,0,26,"Seward, Nebraska, US",17284,11,194,162,32,9,-30,-21,6469,22918,191241,744744,2433
48417,"Shackelford","Texas",32.73587756,-99.35401337,1,0,0,1,"Shackelford, Texas, US",3265,9,29,31,-2,0,11,11,1493,5240,91380,342317,568
28125,"Sharkey","Mississippi",32.88149103,-90.8159538,7,0,0,7,"Sharkey, Mississippi, US",4321,-54,65,50,15,1,-70,-69,1395,2555,18447,75890,434
5135,"Sharp","Arkansas",36.16258158,-91.47819342,42,2,0,40,"Sharp, Arkansas, US",17442,152,193,240,-47,2,199,201,4242,11439,68577,280902,1509
6089,"Shasta","California",40.76391419,-122.0396884,36,4,0,32,"Shasta, California, US",180080,371,1977,2297,-320,193,514,707,68830,279699,2655660,11447801,24618
55115,"Shawano","Wisconsin",44.78902246,-88.76443896,37,0,0,37,"Shawano, Wisconsin, US",40899,128,449,376,73,8,49,57,15000,45481,347257,1480682,4645
20177,"Shawnee","Kansas",39.04100763,-95.7557264,247,6,0,241,"Shawnee, Kansas, US",176875,-415,2002,1800,202,132,-743,-611,95991,409685,4512290,17752523,24610
55117,"Sheboygan","Wisconsin",43.72099677,-87.94579284,82,3,0,79,"Sheboygan, Wisconsin, US",115340,107,1226,1079,147,41,-76,-35,58974,268259,2997904,11966048,15286
1117,"Shelby","Alabama",33.26879845,-86.66232561,426,19,0,407,"Shelby, Alabama, US",217702,2119,2237,1626,611,137,1381,1518,79605,453258,5813740,22106510,30872
17173,"Shelby","Illinois",39.39133527,-88.80611122,16,1,0,15,"Shelby, Illinois, US",21634,-92,228,246,-18,0,-73,-73,6566,16353,107456,484306,2100
18145,"Shelby","Indiana",39.52305623,-85.7915857,311,21,0,290,"Shelby, Indiana, US",44729,207,492,442,50,32,126,158,18634,63711,596664,2460547,4978
19165,"Shelby","Iowa",41.6850066,-95.31015553,31,0,0,31,"Shelby, Iowa, US",11454,-105,110,132,-22,-1,-81,-82,6267,18595,165807,675616,1944
21211,"Shelby","Kentucky",38.21476019,-85.194223,92,4,0,88,"Shelby, Kentucky, US",49024,965,550,389,161,25,776,801,16448,82122,640491,2638682,5397
29205,"Shelby","Missouri",39.79742518,-92.07634971,1,0,0,1,"Shelby, Missouri, US",5930,-67,76,51,25,0,-93,-93,2381,3515,22699,94585,729
39149,"Shelby","Ohio",40.33163494,-84.20258189,37,2,0,35,"Shelby, Ohio, US",48590,-32,613,442,171,34,-239,-205,27663,111084,1194548,5052424,5222
47157,"Shelby","Tennessee",35.1864775,-89.89692423,4225,92,0,4133,"Shelby, Tennessee, US",937166,801,12894,8484,4410,1581,-5190,-3609,494978,2475190,30364824,126123843,116669
48419,"Shelby","Texas",31.79211404,-94.14550696,180,5,0,175,"Shelby, Texas, US",25274,-33,340,296,44,-13,-62,-75,8842,26232,208845,882302,2597
51171,"Shenandoah","Virginia",38.85905135,-78.56813762,365,16,0,349,"Shenandoah, Virginia, US",43616,143,452,484,-32,7,170,177,14752,51988,394310,1670672,4680
27141,"Sherburne","Minnesota",45.44447208,-93.77617511,202,1,0,201,"Sherburne, Minnesota, US",97238,1281,1217,533,684,20,582,602,24844,114827,994450,4505916,11952
20179,"Sheridan","Kansas",39.35018161,-100.4418259,2,0,0,2,"Sheridan, Kansas, US",2521,-1,31,21,10,2,-14,-12,1219,2178,19283,89745,418
31161,"Sheridan","Nebraska",42.50284406,-102.4126613,0,0,0,0,"Sheridan, Nebraska, US",5246,57,57,63,-6,3,59,62,2059,3919,23069,98487,760
56033,"Sheridan","Wyoming",44.79048913,-106.8862389,16,0,0,16,"Sheridan, Wyoming, US",30485,266,308,346,-38,14,289,303,13618,53096,457844,1998274,6773
20181,"Sherman","Kansas",39.35147699,-101.7197624,6,0,0,6,"Sherman, Kansas, US",5917,0,72,74,-2,-1,5,4,2782,7649,64601,257887,1190
31163,"Sherman","Nebraska",41.22045983,-98.97588642,2,0,0,2,"Sherman, Nebraska, US",3001,-43,37,38,-1,0,-42,-42,1082,1672,10957,47916,326
41055,"Sherman","Oregon",45.41501554,-120.6827834,1,0,0,1,"Sherman, Oregon, US",1780,80,15,11,4,0,76,76,837,1368,8222,35422,268
48421,"Sherman","Texas",36.27751473,-101.8933156,23,0,0,23,"Sherman, Texas, US",3022,-79,39,14,25,7,-111,-104,1126,984,9518,43538,210
26155,"Shiawassee","Michigan",42.953928,-84.14585902,238,24,0,214,"Shiawassee, Michigan, US",68122,-11,676,734,-58,8,43,51,18620,61969,479701,2063394,6265
27143,"Sibley","Minnesota",44.5796592,-94.23164924,12,0,0,12,"Sibley, Minnesota, US",14865,-132,167,131,36,6,-174,-168,5120,11307,90980,385321,1730
6091,"Sierra","California",39.57713498,-120.5200701,1,0,0,1,"Sierra, California, US",3005,8,25,37,-12,0,20,20,799,816,5244,31184,229
35051,"Sierra","New Mexico",33.13028233,-107.1925893,1,0,0,1,"Sierra, New Mexico, US",10791,-158,98,236,-138,1,-20,-19,4169,8652,47345,204417,993
30093,"Silver Bow","Montana",45.90018933,-112.6620092,11,0,0,11,"Silver Bow, Montana, US",34915,176,364,419,-55,51,181,232,16052,59555,455658,1895464,6240
21213,"Simpson","Kentucky",36.74058474,-86.58047435,44,3,0,41,"Simpson, Kentucky, US",18572,169,228,180,48,3,118,121,8376,31718,276562,1139598,1984
28127,"Simpson","Mississippi",31.91282117,-89.91716179,83,0,0,83,"Simpson, Mississippi, US",26658,-59,305,313,-8,3,-53,-50,6725,24983,166223,665657,2153
19167,"Sioux","Iowa",43.08221074,-96.1767568,194,0,0,194,"Sioux, Iowa, US",34855,53,487,254,233,24,-205,-181,20953,90946,808665,3525051,7334
38085,"Sioux","North Dakota",46.11323337,-101.0440149,2,0,0,2,"Sioux, North Dakota, US",4230,-147,78,74,4,2,-156,-154,1794,898,5038,21741,98
6093,"Siskiyou","California",41.59198861,-122.5407434,6,1,0,5,"Siskiyou, California, US",43539,-11,382,525,-143,2,133,135,16309,41452,311989,1375206,5962
2220,"Sitka","Alaska",57.24124555,-135.3206587,1,0,0,1,"Sitka, Alaska, US",8493,-61,77,58,19,16,-96,-80,4733,12328,110448,589705,1865
53057,"Skagit","Washington",48.48171488,-121.766131,426,15,0,411,"Skagit, Washington, US",129205,1370,1431,1265,166,170,1030,1200,52991,222962,2306511,9612099,20723
53059,"Skamania","Washington",46.02408726,-121.9164403,3,0,0,3,"Skamania, Washington, US",12083,164,99,94,5,4,154,158,2598,5870,40038,182706,903
38087,"Slope","North Dakota",46.44737738,-103.4601547,3,0,0,3,"Slope, North Dakota, US",750,-11,8,0,8,1,-20,-19,331,40,902,3135,29
20183,"Smith","Kansas",39.78516566,-98.78566062,2,0,0,2,"Smith, Kansas, US",3583,-7,41,39,2,0,-10,-10,1732,3262,20758,91770,563
28129,"Smith","Mississippi",32.01744532,-89.50644846,126,10,0,116,"Smith, Mississippi, US",15916,-113,186,180,6,1,-122,-121,3890,5792,53083,200908,722
47159,"Smith","Tennessee",36.25359775,-85.95411046,29,1,0,28,"Smith, Tennessee, US",20157,178,223,232,-9,-3,190,187,5690,13456,105453,446823,1307
48423,"Smith","Texas",32.37474036,-95.2717568,195,4,0,191,"Smith, Texas, US",232751,3002,2969,2177,792,92,2120,2212,100226,508589,5014175,20952057,34425
51173,"Smyth","Virginia",36.84455636,-81.53344948,15,0,0,15,"Smyth, Virginia, US",30104,-350,286,485,-199,-2,-147,-149,12376,32757,261548,1076119,2448
53061,"Snohomish","Washington",48.04615983,-121.7170703,2863,135,0,2728,"Snohomish, Washington, US",822083,9024,9993,5850,4143,2230,2641,4871,287524,1454556,19830463,78947374,112411
42109,"Snyder","Pennsylvania",40.77129231,-77.06840691,38,1,0,37,"Snyder, Pennsylvania, US",40372,-146,426,385,41,5,-191,-186,17987,71323,487166,2049711,4846
35053,"Socorro","New Mexico",34.00715494,-106.9298354,49,4,0,45,"Socorro, New Mexico, US",16637,-67,175,148,27,47,-142,-95,5422,10575,63663,264129,1016
6095,"Solano","California",38.26827353,-121.9357113,455,20,0,435,"Solano, California, US",447643,1918,5088,3711,1377,280,277,557,140641,628796,7530254,31176386,41886
23025,"Somerset","Maine",45.51229767,-69.95995554,21,0,0,21,"Somerset, Maine, US",50484,-5,457,543,-86,2,81,83,19431,60281,551754,2318105,6545
24039,"Somerset","Maryland",38.1163542,-75.75118623,71,1,0,70,"Somerset, Maryland, US",25616,10,216,276,-60,18,53,71,6818,16177,123949,549836,1980
34035,"Somerset","New Jersey",40.56465737,-74.61683016,4425,397,0,4028,"Somerset, New Jersey, US",328934,-1247,3033,2613,420,598,-2279,-1681,184338,1025020,24760420,83799611,59432
42111,"Somerset","Pennsylvania",39.97172723,-79.02699593,37,0,0,37,"Somerset, Pennsylvania, US",73447,-425,638,938,-300,17,-137,-120,27564,99437,784860,3304101,9536
6097,"Sonoma","California",38.52746429,-122.8862506,467,4,0,463,"Sonoma, California, US",494336,-4307,4509,4379,130,97,-4534,-4437,215529,1006385,12310869,51380253,84462
51175,"Southampton","Virginia",36.72231125,-77.10642712,141,2,0,139,"Southampton, Virginia, US",17631,-82,122,205,-83,0,2,2,4028,7659,65938,283635,938
2240,"Southeast Fairbanks","Alaska",63.87692095,-143.2127643,3,0,0,3,"Southeast Fairbanks, Alaska, US",6893,-44,109,35,74,12,-129,-117,3526,4288,51176,219895,770
13255,"Spalding","Georgia",33.26310031,-84.28013991,253,14,0,239,"Spalding, Georgia, US",66703,596,824,827,-3,3,595,598,20954,77997,619736,2561266,6211
45083,"Spartanburg","South Carolina",34.92960077,-81.99225984,450,16,0,434,"Spartanburg, South Carolina, US",319785,5648,3897,3178,719,242,4672,4914,131415,674279,7243897,29690087,37916
18147,"Spencer","Indiana",38.01519732,-87.0079644,14,1,0,13,"Spencer, Indiana, US",20277,-108,212,235,-23,-2,-84,-86,7540,15938,147223,582911,1929
21215,"Spencer","Kentucky",38.03223971,-85.32749335,16,0,0,16,"Spencer, Kentucky, US",19351,330,205,147,58,10,262,272,1898,4915,27310,121792,1007
46115,"Spink","South Dakota",44.93837606,-98.34626602,4,0,0,4,"Spink, South Dakota, US",6376,-108,81,69,12,-2,-119,-121,3071,4613,39414,169861,823
53063,"Spokane","Washington",47.62113146,-117.4046494,437,31,0,406,"Spokane, Washington, US",522798,9195,5880,4799,1081,489,7594,8083,217936,1119650,12066468,49921640,78777
51177,"Spotsylvania","Virginia",38.18574462,-77.655399,386,4,0,382,"Spotsylvania, Virginia, US",136215,2204,1481,1017,464,32,1711,1743,36650,168072,1427197,5976672,14533
22087,"St. Bernard","Louisiana",29.87761636,-89.51887093,521,21,0,500,"St. Bernard, Louisiana, US",47244,464,632,398,234,45,185,230,13097,35639,336140,1303276,3584
22089,"St. Charles","Louisiana",29.90709658,-90.35555967,622,43,0,579,"St. Charles, Louisiana, US",53100,325,571,446,125,26,179,205,25838,90948,1482588,5578682,5382
29183,"St. Charles","Missouri",38.77875681,-90.66662425,730,54,0,676,"St. Charles, Missouri, US",402022,3242,4289,2988,1301,387,1567,1954,139518,738850,7950075,30276236,50953
1115,"St. Clair","Alabama",33.71902176,-86.31029372,100,1,0,99,"St. Clair, Alabama, US",89512,858,983,975,8,23,828,851,19600,87691,701929,2852010,7282
17163,"St. Clair","Illinois",38.46996033,-89.93063427,939,70,0,869,"St. Clair, Illinois, US",259686,-1674,3095,2723,372,61,-2115,-2054,104407,423367,3804387,16002086,30836
26147,"St. Clair","Michigan",42.92655373,-82.67937954,429,34,0,395,"St. Clair, Michigan, US",159128,97,1426,1741,-315,22,403,425,50696,229084,2147384,8877066,17919
29185,"St. Clair","Missouri",38.03699437,-93.77631447,3,0,0,3,"St. Clair, Missouri, US",9397,8,92,134,-42,-5,56,51,2495,4523,27299,109201,683
55109,"St. Croix","Wisconsin",45.03437474,-92.45000068,65,0,0,65,"St. Croix, Wisconsin, US",90687,999,992,641,351,29,622,651,33652,162785,1454542,6434334,13234
5123,"St. Francis","Arkansas",35.02201976,-90.74828138,628,1,0,627,"St. Francis, Arkansas, US",24994,-515,305,315,-10,2,-508,-506,8980,23306,165900,683571,2338
29187,"St. Francois","Missouri",37.81214171,-90.47598685,33,2,0,31,"St. Francois, Missouri, US",67215,478,693,774,-81,-7,566,559,24877,89660,640134,2652359,8064
22091,"St. Helena","Louisiana",30.82210324,-90.71013176,44,1,0,43,"St. Helena, Louisiana, US",10132,-55,99,105,-6,-2,-46,-48,1558,3848,31860,127061,500
22093,"St. James","Louisiana",30.02531716,-90.80212061,289,24,0,265,"St. James, Louisiana, US",21096,-55,279,226,53,5,-113,-108,9203,25298,434840,1609495,1506
22095,"St. John the Baptist","Louisiana",30.12597499,-90.4753503,838,77,0,761,"St. John the Baptist, Louisiana, US",42837,-282,534,421,113,15,-413,-398,16801,69837,808835,3209822,3877
12109,"St. Johns","Florida",29.90096506,-81.43589967,238,5,0,233,"St. Johns, Florida, US",264672,10858,2216,2105,111,83,10628,10711,72596,340810,3206840,12453759,37289
18141,"St. Joseph","Indiana",41.61756781,-86.29040834,1132,34,0,1098,"St. Joseph, Indiana, US",271826,854,3429,2460,969,802,-914,-112,123519,641912,6334156,26133654,34493
26149,"St. Joseph","Michigan",41.91441767,-85.52797979,100,2,0,98,"St. Joseph, Michigan, US",60964,52,726,582,144,22,-113,-91,23841,90682,852992,3512603,6193
22097,"St. Landry","Louisiana",30.59724262,-92.00135806,247,52,0,195,"St. Landry, Louisiana, US",82124,-658,1111,1017,94,6,-756,-750,23831,106323,876801,3832737,9164
36089,"St. Lawrence","New York",44.4976179,-75.06550039,196,2,0,194,"St. Lawrence, New York, US",107740,-587,988,1082,-94,96,-591,-495,41917,123497,1141926,4705512,10923
27137,"St. Louis","Minnesota",47.6048407,-92.46879855,110,13,0,97,"St. Louis, Minnesota, US",199070,-615,1876,2084,-208,82,-480,-398,101973,504090,5009247,21392960,31638
29189,"St. Louis","Missouri",38.6377004,-90.4458375,4472,384,0,4088,"St. Louis, Missouri, US",994205,-1014,11089,10264,825,1722,-3548,-1826,578492,3588668,51008504,201451272,182765
29510,"St. Louis City","Missouri",38.63555736,-90.24349225,1789,110,0,1679,"St. Louis City, Missouri, US",300576,-2843,3938,3079,859,734,-4414,-3680,253902,1120398,15950947,60006183,54457
12111,"St. Lucie","Florida",27.37763908,-80.47106649,386,28,0,358,"St. Lucie, Florida, US",328297,7872,3082,3501,-419,603,7656,8259,86006,328920,2727924,11162533,34011
22099,"St. Martin","Louisiana",30.13112107,-91.61403569,288,22,0,266,"St. Martin, Louisiana, US",53431,-131,663,537,126,11,-265,-254,14683,57429,535064,2155539,5089
22101,"St. Mary","Louisiana",29.69262097,-91.44702164,294,29,0,265,"St. Mary, Louisiana, US",49348,-493,647,557,90,38,-622,-584,25166,94707,1061655,4307598,6821
24037,"St. Mary's","Maryland",38.30058422,-76.6062928,379,14,0,365,"St. Mary's, Maryland, US",113510,790,1319,874,445,60,288,348,51274,180194,2201088,9078416,11415
22103,"St. Tammany","Louisiana",30.40942847,-89.95642711,1609,154,0,1455,"St. Tammany, Louisiana, US",260419,2384,2822,2423,399,105,1894,1999,88328,440025,4577900,18618783,38302
20185,"Stafford","Kansas",38.03100851,-98.71762001,1,0,0,1,"Stafford, Kansas, US",4156,-6,51,49,2,0,-9,-9,1690,2202,16578,70229,544
51179,"Stafford","Virginia",38.41758738,-77.45917053,569,4,0,565,"Stafford, Virginia, US",152882,3058,1773,813,960,91,2018,2109,42628,161751,1599045,6722821,13449
6099,"Stanislaus","California",37.55862499,-120.9970722,621,28,0,593,"Stanislaus, California, US",550660,2534,7393,4317,3076,144,-679,-535,184403,817655,8638198,36462959,53989
46117,"Stanley","South Dakota",44.41381872,-100.7349153,9,0,0,9,"Stanley, South Dakota, US",3098,81,37,7,30,0,51,51,1264,4143,25581,129575,467
37167,"Stanly","North Carolina",35.31647813,-80.25093221,42,4,0,38,"Stanly, North Carolina, US",62806,626,709,715,-6,10,623,633,20969,77555,575889,2414485,7366
20187,"Stanton","Kansas",37.56304714,-101.7843534,9,0,0,9,"Stanton, Kansas, US",2006,-19,29,20,9,12,-42,-30,1094,1255,10299,42373,229
31167,"Stanton","Nebraska",41.9169835,-97.19394708,16,0,0,16,"Stanton, Nebraska, US",5920,-50,68,38,30,3,-84,-81,1926,2072,28303,119456,435
17175,"Stark","Illinois",41.09309773,-89.79745866,3,0,0,3,"Stark, Illinois, US",5342,-76,57,76,-19,2,-59,-57,1638,2898,25385,113789,451
38089,"Stark","North Dakota",46.80851182,-102.6576326,61,2,0,59,"Stark, North Dakota, US",31489,596,506,234,272,33,293,326,18357,72195,946355,4087543,6591
39151,"Stark","Ohio",40.81482476,-81.36437305,670,89,0,581,"Stark, Ohio, US",370606,-642,3985,4092,-107,27,-545,-518,165252,817249,7647741,31418288,48341
18149,"Starke","Indiana",41.27890281,-86.64686895,30,3,0,27,"Starke, Indiana, US",22995,44,262,284,-22,-2,69,67,5233,11161,75450,331754,1453
48427,"Starr","Texas",26.56150059,-98.73892358,23,0,0,23,"Starr, Texas, US",64633,384,1178,400,778,-10,-387,-397,17210,46262,233276,944069,3038
51790,"Staunton","Virginia",38.15965544,-79.05979937,35,0,0,35,"Staunton, Virginia, US",24932,370,338,348,-10,22,356,378,11870,44178,331610,1348499,4072
29186,"Ste. Genevieve","Missouri",37.89090059,-90.1949941,8,1,0,7,"Ste. Genevieve, Missouri, US",17894,17,204,199,5,-1,15,14,5947,19300,160520,700531,1970
27145,"Stearns","Minnesota",45.55192576,-94.61078221,1918,12,0,1906,"Stearns, Minnesota, US",161075,1419,2039,1044,995,556,-127,429,91932,428575,4513792,18518537,26281
27147,"Steele","Minnesota",44.02240351,-93.22627088,138,0,0,138,"Steele, Minnesota, US",36649,-89,391,308,83,-6,-166,-172,20059,78549,798077,3077243,5415
38091,"Steele","North Dakota",47.45611548,-97.72728747,1,0,0,1,"Steele, North Dakota, US",1890,-2,20,6,14,0,-17,-17,897,1554,15750,65984,192
13257,"Stephens","Georgia",34.55151201,-83.29405315,123,2,0,121,"Stephens, Georgia, US",25925,-82,317,356,-39,0,-42,-42,9659,30784,242927,995998,2749
40137,"Stephens","Oklahoma",34.48556989,-97.85141892,37,1,0,36,"Stephens, Oklahoma, US",43143,-36,491,571,-80,22,25,47,18326,60198,521235,2215100,6090
48429,"Stephens","Texas",32.73553157,-98.83631615,2,0,0,2,"Stephens, Texas, US",9366,-39,108,98,10,-6,-44,-50,3463,8193,76514,335494,1140
17177,"Stephenson","Illinois",42.35129217,-89.662598,176,2,0,174,"Stephenson, Illinois, US",44498,-299,476,547,-71,24,-252,-228,20086,68753,700841,2857136,5742
18151,"Steuben","Indiana",41.64423868,-85.00101094,76,2,0,74,"Steuben, Indiana, US",34594,107,336,348,-12,15,106,121,14578,62489,492181,2082283,5221
36101,"Steuben","New York",42.2689144,-77.3829924,240,41,0,199,"Steuben, New York, US",95379,-481,981,1022,-41,49,-489,-440,41282,124129,1175377,4590416,10272
20189,"Stevens","Kansas",37.1923008,-101.3118967,27,0,0,27,"Stevens, Kansas, US",5485,-51,62,32,30,23,-106,-83,2618,4000,32291,134453,562
53065,"Stevens","Washington",48.40035475,-117.8542701,10,1,0,9,"Stevens, Washington, US",45723,499,434,488,-54,-3,557,554,11898,32371,268025,1172678,4785
13259,"Stewart","Georgia",32.07996777,-84.83208037,42,0,0,42,"Stewart, Georgia, US",6621,186,34,62,-28,170,45,215,1355,1191,8157,35390,165
47161,"Stewart","Tennessee",36.50235092,-87.83920548,8,0,0,8,"Stewart, Tennessee, US",13715,96,136,174,-38,-7,142,135,3331,4981,39531,151660,695
30095,"Stillwater","Montana",45.67071407,-109.3950061,1,0,0,1,"Stillwater, Montana, US",9642,159,77,82,-5,9,157,166,3828,6615,70622,306301,1197
29207,"Stoddard","Missouri",36.85571651,-89.9444155,70,0,0,70,"Stoddard, Missouri, US",29025,-239,328,388,-60,-2,-177,-179,10156,37488,300755,1244478,3661
37169,"Stokes","North Carolina",36.4017975,-80.23893369,50,0,0,50,"Stokes, North Carolina, US",45591,80,387,556,-169,22,231,253,9738,29176,183286,782051,3377
5137,"Stone","Arkansas",35.86251946,-92.15684085,8,0,0,8,"Stone, Arkansas, US",12506,52,111,166,-55,-8,115,107,3827,8042,45724,192534,1007
28131,"Stone","Mississippi",30.79187949,-89.11547539,30,0,0,30,"Stone, Mississippi, US",18336,339,204,168,36,-1,302,301,5031,12619,89718,371430,1285
29209,"Stone","Missouri",36.75000327,-93.45256475,4,0,0,4,"Stone, Missouri, US",31952,251,253,403,-150,-5,406,401,7647,24131,149109,692916,3542
32029,"Storey","Nevada",39.44875482,-119.5250207,1,0,0,1,"Storey, Nevada, US",4123,142,11,21,-10,-4,155,151,965,1650,8869,46915,370
19169,"Story","Iowa",42.03621213,-93.46499005,90,1,0,89,"Story, Iowa, US",97117,336,872,526,346,355,-369,-14,51767,162170,1589121,6379437,12068
33017,"Strafford","New Hampshire",43.291833,-71.02336013,253,12,0,241,"Strafford, New Hampshire, US",130633,836,1163,1072,91,259,484,743,54301,194363,2038105,8348326,15035
38093,"Stutsman","North Dakota",46.97962541,-98.95637318,18,0,0,18,"Stutsman, North Dakota, US",20704,-171,223,214,9,8,-189,-181,11556,35752,337955,1406256,3577
56035,"Sublette","Wyoming",42.76558279,-109.9130922,3,0,0,3,"Sublette, Wyoming, US",9831,33,88,80,8,-8,32,24,6269,12699,215262,828374,2138
25025,"Suffolk","Massachusetts",42.3279514,-71.07850442,17291,827,0,16464,"Suffolk, Massachusetts, US",803907,760,9219,5210,4009,7805,-11034,-3229,642267,3782846,90404628,335024542,128225
36103,"Suffolk","New York",40.88320119,-72.8012172,38802,1822,0,36980,"Suffolk, New York, US",1476601,-4229,15129,13146,1983,1603,-7842,-6239,634128,3468160,43975130,186562002,298374
51800,"Suffolk","Virginia",36.70155394,-76.63603554,290,25,0,265,"Suffolk, Virginia, US",92108,1133,1136,845,291,11,827,838,31523,119340,1101387,4552259,9268
18153,"Sullivan","Indiana",39.08952258,-87.41414469,31,1,0,30,"Sullivan, Indiana, US",20669,-27,207,209,-2,-2,-24,-26,6841,12909,106234,436445,1578
29211,"Sullivan","Missouri",40.2099105,-93.11150106,44,0,0,44,"Sullivan, Missouri, US",6089,-144,86,71,15,10,-169,-159,2893,3704,31261,116523,423
33019,"Sullivan","New Hampshire",43.36094111,-72.22203125,17,1,0,16,"Sullivan, New Hampshire, US",43146,32,380,432,-52,7,77,84,14645,49623,491993,2026494,4891
36105,"Sullivan","New York",41.71579493,-74.76394559,1297,29,0,1268,"Sullivan, New York, US",75432,33,779,779,0,-2,40,38,27134,105041,792431,3539416,10984
42113,"Sullivan","Pennsylvania",41.44634738,-76.51246591,2,0,0,2,"Sullivan, Pennsylvania, US",6066,-10,41,97,-56,2,45,47,2157,2957,18341,79448,701
47163,"Sullivan","Tennessee",36.51240691,-82.30412917,61,2,0,59,"Sullivan, Tennessee, US",158348,749,1517,1967,-450,-18,1220,1202,73895,307970,3144685,12851589,19580
46119,"Sully","South Dakota",44.71571812,-100.1278092,1,0,0,1,"Sully, South Dakota, US",1391,14,16,11,5,0,9,9,816,810,5652,30265,172
54089,"Summers","West Virginia",37.65390597,-80.86009693,1,0,0,1,"Summers, West Virginia, US",12573,-99,98,155,-57,-1,-39,-40,2979,4526,29505,123011,645
8117,"Summit","Colorado",39.63803232,-106.1150762,203,2,0,201,"Summit, Colorado, US",31011,194,266,69,197,101,-105,-4,19656,115853,940625,3642536,13126
39153,"Summit","Ohio",41.12464734,-81.53123079,1204,159,0,1045,"Summit, Ohio, US",541013,-340,5840,5734,106,533,-961,-428,272508,1449847,16791899,67465338,79785
49043,"Summit","Utah",40.86688146,-110.9535882,403,0,0,403,"Summit, Utah, US",42145,255,416,159,257,131,-133,-2,24458,146499,1468409,5533874,14040
20191,"Sumner","Kansas",37.23682549,-97.47721621,6,1,0,5,"Sumner, Kansas, US",22836,-183,249,252,-3,9,-189,-180,7846,19874,155403,636767,2442
47165,"Sumner","Tennessee",36.46824103,-86.45917204,809,45,0,764,"Sumner, Tennessee, US",191283,3793,2173,1701,472,141,3175,3316,56173,250625,2350364,10186829,18716
1119,"Sumter","Alabama",32.59117397,-88.19916205,185,6,0,179,"Sumter, Alabama, US",12427,-207,136,163,-27,27,-207,-180,3705,7790,56114,231707,874
12119,"Sumter","Florida",28.70181754,-82.0794267,253,17,0,236,"Sumter, Florida, US",132420,3701,478,2017,-1539,-57,5269,5212,25659,108666,957575,3934858,8913
13261,"Sumter","Georgia",32.03650571,-84.19821492,439,40,0,399,"Sumter, Georgia, US",29524,-272,377,339,38,27,-340,-313,12024,37737,267836,1111183,3137
45085,"Sumter","South Carolina",33.91826534,-80.37942316,344,17,0,327,"Sumter, South Carolina, US",106721,312,1343,1075,268,89,-40,49,43836,140598,1116697,4738442,9914
28133,"Sunflower","Mississippi",33.60192578,-90.58882684,77,3,0,74,"Sunflower, Mississippi, US",25110,-1101,275,307,-32,3,-1081,-1078,7844,21706,151126,620973,2216
37171,"Surry","North Carolina",36.41689489,-80.69102283,151,1,0,150,"Surry, North Carolina, US",71783,-176,736,874,-138,40,-72,-32,29623,126515,1088619,4463168,9292
51181,"Surry","Virginia",37.11781893,-76.88450012,6,1,0,5,"Surry, Virginia, US",6422,-41,56,68,-12,0,-30,-30,2511,2329,37940,134333,277
42115,"Susquehanna","Pennsylvania",41.82147784,-75.80071959,95,15,0,80,"Susquehanna, Pennsylvania, US",40328,-232,352,472,-120,1,-111,-110,12725,30907,222100,979558,4507
10005,"Sussex","Delaware",38.66143781,-75.39031349,4048,119,0,3929,"Sussex, Delaware, US",234225,4836,2288,2781,-493,-58,5350,5292,80650,393418,3318064,14591014,33090
34037,"Sussex","New Jersey",41.13891592,-74.69118243,1079,145,0,934,"Sussex, New Jersey, US",140488,-313,1207,1266,-59,-5,-245,-250,44030,169511,1489571,6295898,18702
51183,"Sussex","Virginia",36.92432914,-77.25791182,114,1,0,113,"Sussex, Virginia, US",11159,-82,86,129,-43,2,-41,-39,3304,6911,46354,192812,783
6101,"Sutter","California",39.03417539,-121.6945899,40,2,0,38,"Sutter, California, US",96971,623,1267,834,433,100,95,195,30113,118195,1105631,4821500,10160
12121,"Suwannee","Florida",30.19746066,-82.9909967,164,18,0,146,"Suwannee, Florida, US",44417,238,444,561,-117,-5,361,356,13030,33443,245087,995773,3516
37173,"Swain","North Carolina",35.48665845,-83.48748932,10,0,0,10,"Swain, North Carolina, US",14271,22,143,221,-78,-3,103,100,6189,15025,91341,421754,1818
56037,"Sweetwater","Wyoming",41.65943896,-108.8827882,25,0,0,25,"Sweetwater, Wyoming, US",42343,-515,506,298,208,23,-750,-727,24690,75731,977635,4013811,6969
27151,"Swift","Minnesota",45.2829032,-95.68264092,15,0,0,15,"Swift, Minnesota, US",9266,-57,112,98,14,4,-74,-70,4568,12726,107066,470505,1423
48437,"Swisher","Texas",34.53028891,-101.7349174,15,0,0,15,"Swisher, Texas, US",7397,-16,80,66,14,-2,-27,-29,2098,3090,20395,88856,557
18155,"Switzerland","Indiana",38.82767338,-85.03022429,19,0,0,19,"Switzerland, Indiana, US",10751,20,110,109,1,13,7,20,2454,2935,19229,86018,484
13263,"Talbot","Georgia",32.69642758,-84.53351366,34,1,0,33,"Talbot, Georgia, US",6195,-95,63,91,-28,0,-67,-67,700,1824,16040,73495,208
24041,"Talbot","Maryland",38.76618159,-76.10882561,77,1,0,76,"Talbot, Maryland, US",37181,107,338,478,-140,9,242,251,21338,90588,841721,3508435,8181
13265,"Taliaferro","Georgia",33.56543317,-82.88136816,1,0,0,1,"Taliaferro, Georgia, US",1537,-75,13,27,-14,1,-62,-61,304,61,346,1432,22
1121,"Talladega","Alabama",33.37823223,-86.16886178,86,2,0,84,"Talladega, Alabama, US",79978,-159,844,1044,-200,32,14,46,29446,103580,939116,3964649,6882
28135,"Tallahatchie","Mississippi",33.95339918,-90.1729398,23,1,0,22,"Tallahatchie, Mississippi, US",13809,-152,162,162,0,-7,-144,-151,3194,4498,31135,133745,705
1123,"Tallapoosa","Alabama",32.86698258,-85.79833053,392,62,0,330,"Tallapoosa, Alabama, US",40367,-168,385,534,-149,2,-18,-16,13797,45064,318736,1404322,4148
19171,"Tama","Iowa",42.07991767,-92.53266945,390,23,0,367,"Tama, Iowa, US",16854,-15,219,193,26,3,-42,-39,5764,15571,113812,467145,1552
29213,"Taney","Missouri",36.65465345,-93.04075153,14,2,0,12,"Taney, Missouri, US",55928,209,615,555,60,7,145,152,27064,130915,755547,3636415,10413
22105,"Tangipahoa","Louisiana",30.62888673,-90.40664996,767,31,0,736,"Tangipahoa, Louisiana, US",134758,921,1953,1383,570,1,350,351,43272,196200,1617043,7016834,13972
35055,"Taos","New Mexico",36.58006022,-105.6310198,22,0,0,22,"Taos, New Mexico, US",32723,24,271,317,-46,-14,86,72,13931,46901,319170,1270505,5798
48439,"Tarrant","Texas",32.77143818,-97.29101614,4899,132,0,4767,"Tarrant, Texas, US",2102515,21069,27512,13796,13716,4856,2546,7402,904159,4632706,55663098,223636781,252527
28137,"Tate","Mississippi",34.65133709,-89.94485778,58,1,0,57,"Tate, Mississippi, US",28321,-26,347,320,27,-6,-45,-51,6804,17063,116074,479044,1930
13267,"Tattnall","Georgia",32.04785085,-82.05539188,14,0,0,14,"Tattnall, Georgia, US",25286,-199,254,245,9,32,-242,-210,5860,12314,88881,377112,1542
12123,"Taylor","Florida",30.04848048,-83.60445406,11,0,0,11,"Taylor, Florida, US",21569,24,216,258,-42,4,62,66,7394,18755,154892,625739,1947
13269,"Taylor","Georgia",32.55792548,-84.25077141,21,2,0,19,"Taylor, Georgia, US",8020,0,86,83,3,0,-2,-2,2053,2632,19924,86814,491
19173,"Taylor","Iowa",40.73710579,-94.69778563,10,0,0,10,"Taylor, Iowa, US",6121,-39,70,62,8,1,-48,-47,2241,4963,41408,171256,610
21217,"Taylor","Kentucky",37.3677562,-85.3329931,11,0,0,11,"Taylor, Kentucky, US",25769,255,324,302,22,7,227,234,11662,32906,218811,954389,3219
48441,"Taylor","Texas",32.30163422,-99.89007449,228,5,0,223,"Taylor, Texas, US",138034,740,2062,1423,639,214,-107,107,65998,294178,2511630,10419094,20318
54091,"Taylor","West Virginia",39.33602617,-80.0421439,8,0,0,8,"Taylor, West Virginia, US",16695,-133,129,199,-70,-2,-60,-62,3415,7525,59037,236200,966
55119,"Taylor","Wisconsin",45.21179252,-90.5004405,1,0,0,1,"Taylor, Wisconsin, US",20343,-21,210,188,22,10,-55,-45,9351,34602,299990,1257355,2425
17179,"Tazewell","Illinois",40.50716185,-89.51404662,67,3,0,64,"Tazewell, Illinois, US",131803,-647,1375,1444,-69,67,-644,-577,56378,220306,2181401,8640434,16348
51185,"Tazewell","Virginia",37.12191123,-81.56685568,6,0,0,6,"Tazewell, Virginia, US",40595,-463,408,621,-213,-9,-240,-249,16859,58809,481372,1970910,5437
6103,"Tehama","California",40.12570935,-122.2370171,3,1,0,2,"Tehama, California, US",65084,1066,739,661,78,-29,1014,985,19170,52110,471887,2003500,5333
13271,"Telfair","Georgia",31.92829517,-82.93491155,32,1,0,31,"Telfair, Georgia, US",15860,-114,137,156,-19,50,-146,-96,4925,7437,46644,185433,844
8119,"Teller","Colorado",38.88133511,-105.1614893,32,2,0,30,"Teller, Colorado, US",25388,275,176,198,-22,-3,300,297,8663,26803,203823,836755,3825
22107,"Tensas","Louisiana",32.00760749,-91.32915234,10,0,0,10,"Tensas, Louisiana, US",4334,-136,47,56,-9,0,-128,-128,1501,1480,11636,45484,281
22109,"Terrebonne","Louisiana",29.37343766,-90.82626855,623,45,0,578,"Terrebonne, Louisiana, US",110461,-702,1475,1125,350,-1,-1052,-1053,57887,246301,2776400,11469112,16373
13273,"Terrell","Georgia",31.77527543,-84.44069698,211,26,0,185,"Terrell, Georgia, US",8531,-56,98,115,-17,0,-38,-38,2305,5676,43470,183812,702
48445,"Terry","Texas",33.17402785,-102.3354521,13,0,0,13,"Terry, Texas, US",12337,-7,181,119,62,-2,-67,-69,4478,9313,79831,326087,1105
16081,"Teton","Idaho",43.75303583,-111.2056773,11,0,0,11,"Teton, Idaho, US",12142,491,135,43,92,15,380,395,3445,11597,94289,462474,2541
56039,"Teton","Wyoming",43.93522482,-110.5890801,100,0,0,100,"Teton, Wyoming, US",23464,195,228,75,153,79,-37,42,17393,96301,955596,4280471,12273
29215,"Texas","Missouri",37.31728859,-91.96564727,0,0,0,0,"Texas, Missouri, US",25398,-108,268,290,-22,-11,-75,-86,7801,16345,108760,444692,2346
40139,"Texas","Oklahoma",36.74777635,-101.4889765,855,5,0,850,"Texas, Oklahoma, US",19983,-508,350,149,201,61,-775,-714,10192,23760,218563,910002,2499
31169,"Thayer","Nebraska",40.17626377,-97.59504381,0,0,0,0,"Thayer, Nebraska, US",5003,-36,47,73,-26,2,-12,-10,2685,6321,52641,213610,1000
13275,"Thomas","Georgia",30.86392347,-83.91847289,309,31,0,278,"Thomas, Georgia, US",44451,117,531,516,15,18,87,105,18605,76625,792028,3088378,6147
31171,"Thomas","Nebraska",41.91358968,-100.5556632,1,0,0,1,"Thomas, Nebraska, US",722,8,6,0,6,0,3,3,373,278,1558,11706,58
31173,"Thurston","Nebraska",42.15725356,-96.54157099,24,0,0,24,"Thurston, Nebraska, US",7224,-50,152,83,69,1,-120,-119,2879,4314,43710,198072,485
53067,"Thurston","Washington",46.9291895,-122.8290656,124,1,0,123,"Thurston, Washington, US",290536,4480,3135,2377,758,362,3351,3713,107347,411182,3994183,16733035,36884
13277,"Tift","Georgia",31.45743864,-83.5236119,213,14,0,199,"Tift, Georgia, US",40644,102,554,419,135,-4,-30,-34,20841,75602,613802,2491738,5653
41057,"Tillamook","Oregon",45.46248721,-123.712066,6,0,0,6,"Tillamook, Oregon, US",27036,326,230,303,-73,-13,412,399,9502,32484,256253,1103723,4018
40141,"Tillman","Oklahoma",34.37288446,-98.92426619,22,1,0,21,"Tillman, Oklahoma, US",7250,-73,75,78,-3,16,-86,-70,2417,3361,25373,107258,551
36107,"Tioga","New York",42.16852837,-76.30835812,121,21,0,100,"Tioga, New York, US",48203,-238,425,492,-67,-9,-161,-170,15028,34184,264984,1144738,4144
42117,"Tioga","Pennsylvania",41.77255149,-77.25433032,16,2,0,14,"Tioga, Pennsylvania, US",40591,-99,402,481,-79,8,-24,-16,17242,46162,376049,1630353,4536
28139,"Tippah","Mississippi",34.76872156,-88.90988194,69,11,0,58,"Tippah, Mississippi, US",22015,-24,262,243,19,0,-44,-44,6931,17014,123137,508694,1686
18157,"Tippecanoe","Indiana",40.38872739,-86.89413959,356,3,0,353,"Tippecanoe, Indiana, US",195732,1915,2196,1204,992,2070,-1159,911,95547,350923,3395337,13960870,21338
18159,"Tipton","Indiana",40.31123252,-86.05234925,22,1,0,21,"Tipton, Indiana, US",15148,36,144,157,-13,7,43,50,5768,12579,96003,425740,1408
47167,"Tipton","Tennessee",35.501942,-89.73694895,426,2,0,424,"Tipton, Tennessee, US",61599,23,660,605,55,1,-30,-29,12676,40047,306861,1272474,3692
28141,"Tishomingo","Mississippi",34.74023475,-88.23917219,23,0,0,23,"Tishomingo, Mississippi, US",19383,0,195,283,-88,3,86,89,5995,18431,134361,556618,1792
48449,"Titus","Texas",33.21339719,-94.96797273,248,2,0,246,"Titus, Texas, US",32750,7,473,264,209,-23,-181,-204,16416,56009,456557,1848252,3286
21219,"Todd","Kentucky",36.8381152,-87.17878374,16,0,0,16,"Todd, Kentucky, US",12294,-12,170,126,44,5,-62,-57,2709,5684,40280,171519,882
27153,"Todd","Minnesota",46.06996226,-94.89785296,183,0,0,183,"Todd, Minnesota, US",24664,94,321,204,117,-6,-16,-22,8265,26388,228340,994030,2915
46121,"Todd","South Dakota",43.19338568,-100.7195503,17,0,0,17,"Todd, South Dakota, US",10177,-68,238,131,107,10,-186,-176,3029,2639,18118,74975,171
9013,"Tolland","Connecticut",41.85853803,-72.3308481,799,55,0,744,"Tolland, Connecticut, US",150721,32,1134,1048,86,449,-503,-54,49664,144181,1268759,5437189,13973
48451,"Tom Green","Texas",31.40464436,-100.462443,90,1,0,89,"Tom Green, Texas, US",119200,1186,1498,1071,427,-46,802,756,54034,206422,1873487,7787359,16018
36109,"Tompkins","New York",42.44945765,-76.47229843,149,0,0,149,"Tompkins, New York, US",102180,-239,742,636,106,447,-797,-350,59385,170943,1619805,6530163,13668
49045,"Tooele","Utah",40.44862644,-113.1295715,112,0,0,112,"Tooele, Utah, US",72259,2270,1025,353,672,75,1523,1598,16853,48546,401422,1710491,4827
30101,"Toole","Montana",48.65577551,-111.6942414,29,6,0,23,"Toole, Montana, US",4736,-99,63,44,19,-4,-115,-119,2475,4963,39732,171733,770
13279,"Toombs","Georgia",32.12059861,-82.32957247,50,4,0,46,"Toombs, Georgia, US",26830,-72,372,308,64,-17,-118,-135,12657,40544,320785,1326471,3498
35057,"Torrance","New Mexico",34.64048375,-105.8508949,19,1,0,18,"Torrance, New Mexico, US",15461,-51,153,150,3,23,-76,-53,3809,6430,43561,182084,891
13281,"Towns","Georgia",34.91369188,-83.7410746,22,1,0,21,"Towns, Georgia, US",12037,171,94,181,-87,4,253,257,3550,9996,59504,257885,1342
38097,"Traill","North Dakota",47.45367788,-97.16323288,20,0,0,20,"Traill, North Dakota, US",8036,16,87,83,4,4,8,12,3696,10346,101346,415976,1476
37175,"Transylvania","North Carolina",35.20383864,-82.79638423,11,0,0,11,"Transylvania, North Carolina, US",34385,212,261,394,-133,-3,349,346,11772,36725,248470,1089905,4467
27155,"Traverse","Minnesota",45.77298854,-96.47062949,3,0,0,3,"Traverse, Minnesota, US",3259,-32,37,38,-1,1,-34,-33,1482,2862,22262,95761,505
48453,"Travis","Texas",30.33432034,-97.7853562,2761,82,0,2679,"Travis, Texas, US",1273954,27382,15147,6196,8951,4296,13964,18260,697487,3536372,53235603,213873747,213788
20195,"Trego","Kansas",38.91467218,-99.87284448,1,0,0,1,"Trego, Kansas, US",2803,6,19,41,-22,2,26,28,1474,2177,14278,57307,466
55121,"Trempealeau","Wisconsin",44.30360275,-91.35893614,14,0,0,14,"Trempealeau, Wisconsin, US",29649,155,425,253,172,55,-71,-16,14766,47543,408533,1755530,3412
13283,"Treutlen","Georgia",32.40422134,-82.56904553,8,0,0,8,"Treutlen, Georgia, US",6901,88,71,74,-3,6,85,91,1536,1813,10427,43005,282
21221,"Trigg","Kentucky",36.80767017,-87.87333656,9,0,0,9,"Trigg, Kentucky, US",14651,-7,153,163,-10,-1,4,3,4023,8080,51568,208791,1053
21223,"Trimble","Kentucky",38.61056487,-85.33775972,5,0,0,5,"Trimble, Kentucky, US",8471,3,82,94,-12,-1,16,15,1581,1718,14458,55663,289
6105,"Trinity","California",40.6491767,-123.114713,1,0,0,1,"Trinity, California, US",12285,-282,118,161,-43,-1,-239,-240,4971,6473,42497,209472,1131
48455,"Trinity","Texas",31.0879489,-95.1367187,11,0,0,11,"Trinity, Texas, US",14651,-37,139,232,-93,9,48,57,3150,5747,39673,161737,812
46123,"Tripp","South Dakota",43.34459388,-99.8854891,6,0,0,6,"Tripp, South Dakota, US",5441,-50,86,56,30,-1,-80,-81,2739,6196,46531,190601,859
13285,"Troup","Georgia",33.03349196,-85.02812115,245,9,0,236,"Troup, Georgia, US",69922,-156,886,763,123,94,-377,-283,37070,160392,1709828,6820607,7974
47169,"Trousdale","Tennessee",36.39026213,-86.16087954,1390,4,0,1386,"Trousdale, Tennessee, US",11284,251,111,95,16,0,234,234,1998,4492,26726,115456,434
39155,"Trumbull","Ohio",41.31735028,-80.76109643,514,42,0,472,"Trumbull, Ohio, US",197974,-565,2039,2477,-438,-17,-98,-115,78056,332986,3082795,12429544,23220
54093,"Tucker","West Virginia",39.11240885,-79.57053576,4,0,0,4,"Tucker, West Virginia, US",6839,-98,60,128,-68,0,-28,-28,2756,6948,40354,157134,668
6107,"Tulare","California",36.22026558,-118.8020203,1641,75,0,1566,"Tulare, California, US",466195,1606,7032,3209,3823,-270,-1960,-2230,156043,526703,4811572,20040555,37920
40143,"Tulsa","Oklahoma",36.11939621,-95.94013939,903,44,0,859,"Tulsa, Oklahoma, US",651552,3869,8762,6147,2615,1127,150,1277,359460,1945660,23523772,93184774,113272
28143,"Tunica","Mississippi",34.64967704,-90.37481167,48,2,0,46,"Tunica, Mississippi, US",9632,-290,169,102,67,3,-362,-359,9876,34821,270255,1059832,914
6109,"Tuolumne","California",38.02644018,-119.9525093,2,0,0,2,"Tuolumne, California, US",54478,91,466,621,-155,20,232,252,18971,59175,519642,2278085,7158
13287,"Turner","Georgia",31.71612656,-83.62069378,96,12,0,84,"Turner, Georgia, US",7985,77,111,92,19,0,59,59,2211,4941,30832,126229,688
46125,"Turner","South Dakota",43.3109081,-97.14865776,22,0,0,22,"Turner, South Dakota, US",8384,-38,102,91,11,1,-50,-49,2569,5621,42454,192692,1242
1125,"Tuscaloosa","Alabama",33.28726072,-87.52556818,479,11,0,468,"Tuscaloosa, Alabama, US",209355,1036,2431,1872,559,221,261,482,94108,410355,3743192,15659573,24042
39157,"Tuscarawas","Ohio",40.44214695,-81.47226262,306,2,0,304,"Tuscarawas, Ohio, US",91987,-92,1098,1048,50,26,-163,-137,36751,157249,1283086,5436995,12234
26157,"Tuscola","Michigan",43.46606813,-83.41897025,183,23,0,160,"Tuscola, Michigan, US",52245,-388,536,650,-114,7,-281,-274,14659,41414,330162,1441292,4539
13289,"Twiggs","Georgia",32.67435595,-83.43078662,13,0,0,13,"Twiggs, Georgia, US",8120,-54,72,141,-69,14,2,16,1659,2252,18807,73805,232
16083,"Twin Falls","Idaho",42.35440512,-114.6685381,374,19,0,355,"Twin Falls, Idaho, US",86878,849,1195,778,417,65,369,434,36268,155403,1164181,4915482,15335
48457,"Tyler","Texas",30.77031716,-94.37690895,10,0,0,10,"Tyler, Texas, US",21672,63,187,268,-81,0,145,145,5161,10216,72878,286946,1308
54095,"Tyler","West Virginia",39.46811972,-80.88772676,3,0,0,3,"Tyler, West Virginia, US",8591,-149,74,108,-34,-2,-113,-115,2422,4105,38628,156511,438
37177,"Tyrrell","North Carolina",35.87147226,-76.17055253,4,0,0,4,"Tyrrell, North Carolina, US",4016,-99,31,48,-17,0,-83,-83,1411,1563,8421,41474,262
56041,"Uinta","Wyoming",41.2878183,-110.5475782,12,0,0,12,"Uinta, Wyoming, US",20226,-66,255,136,119,0,-186,-186,8922,24790,254094,1109919,2920
36111,"Ulster","New York",41.89027881,-74.26252104,1606,72,0,1534,"Ulster, New York, US",177573,-845,1433,1743,-310,148,-677,-529,68022,251503,2031513,8823431,28504
41059,"Umatilla","Oregon",45.59073056,-118.7353826,110,3,0,107,"Umatilla, Oregon, US",77950,529,949,665,284,38,211,249,30247,108719,859189,3761388,8920
47171,"Unicoi","Tennessee",36.10890856,-82.43709629,3,0,0,3,"Unicoi, Tennessee, US",17883,61,173,281,-108,12,157,169,5832,11598,97465,392964,1112
5139,"Union","Arkansas",33.16887091,-92.59746952,152,5,0,147,"Union, Arkansas, US",38682,-457,480,550,-70,-1,-386,-387,18418,72734,1021487,3522010,5988
12125,"Union","Florida",30.04412971,-82.37497443,29,0,0,29,"Union, Florida, US",15237,-91,149,224,-75,0,-16,-16,4574,4829,41977,169067,504
13291,"Union","Georgia",34.82995757,-83.98967069,39,1,0,38,"Union, Georgia, US",24511,606,167,305,-138,-6,747,741,7637,24704,194558,800882,2900
17181,"Union","Illinois",37.47119609,-89.25548938,138,5,0,133,"Union, Illinois, US",16653,-179,173,224,-51,0,-129,-129,5341,15503,91287,391607,1829
18161,"Union","Indiana",39.62550777,-84.92497066,8,0,0,8,"Union, Indiana, US",7054,25,66,66,0,-10,37,27,1536,2726,18368,78694,455
19175,"Union","Iowa",41.0277278,-94.24234847,5,0,0,5,"Union, Iowa, US",12241,-57,130,138,-8,4,-53,-49,7127,17445,142986,599467,1565
21225,"Union","Kentucky",37.66166713,-87.94300009,10,0,0,10,"Union, Kentucky, US",14381,-90,151,160,-9,-9,-72,-81,6370,12011,105426,420382,1156
22111,"Union","Louisiana",32.83121059,-92.3749373,287,16,0,271,"Union, Louisiana, US",22108,-135,230,249,-19,5,-120,-115,5188,14590,105926,477739,1711
28145,"Union","Mississippi",34.49162015,-89.00776006,70,5,0,65,"Union, Mississippi, US",28815,200,355,284,71,36,94,130,10669,41113,318083,1345567,2495
34039,"Union","New Jersey",40.65835409,-74.30680092,15186,1022,0,14164,"Union, New Jersey, US",556341,-61,6738,4195,2543,2002,-4631,-2629,234221,1150300,17443863,69641220,82430
35059,"Union","New Mexico",36.48126404,-103.4709624,3,0,0,3,"Union, New Mexico, US",4059,-49,38,37,1,-2,-47,-49,1815,2575,16257,66701,360
37179,"Union","North Carolina",34.98960527,-80.52955873,393,17,0,376,"Union, North Carolina, US",239859,4029,2431,1521,910,19,3115,3134,66557,288138,2604775,11003007,27841
39159,"Union","Ohio",40.30016061,-83.37239023,42,0,0,42,"Union, Ohio, US",58988,1206,689,379,310,36,859,895,31840,100418,1187536,5202997,5671
41061,"Union","Oregon",45.30915495,-118.0068979,6,0,0,6,"Union, Oregon, US",26835,134,277,280,-3,11,126,137,10881,32154,240413,1080652,3996
42119,"Union","Pennsylvania",40.96188846,-77.05996014,52,1,0,51,"Union, Pennsylvania, US",44923,-94,402,422,-20,2,-76,-74,19571,62018,536974,2257102,4973
45087,"Union","South Carolina",34.68835752,-81.61730349,31,0,0,31,"Union, South Carolina, US",27316,-8,294,378,-84,-1,80,79,8916,25478,187875,777210,2113
46127,"Union","South Dakota",42.83112163,-96.6557828,75,0,0,75,"Union, South Dakota, US",15932,362,185,112,73,14,277,291,8481,41273,496140,2126782,2587
47173,"Union","Tennessee",36.28590426,-83.83651902,4,0,0,4,"Union, Tennessee, US",19972,283,201,214,-13,4,291,295,2838,6215,40495,177550,866
48459,"Upshur","Texas",32.73706798,-94.93999853,18,0,0,18,"Upshur, Texas, US",41753,574,452,437,15,-4,566,562,8727,20613,161546,693922,2589
54097,"Upshur","West Virginia",38.89285061,-80.23689136,6,0,0,6,"Upshur, West Virginia, US",24176,-196,221,285,-64,-2,-131,-133,9507,23849,194862,822465,2725
13293,"Upson","Georgia",32.87920671,-84.30024826,272,33,0,239,"Upson, Georgia, US",26320,135,306,400,-94,-4,238,234,8490,22529,172688,722949,2270
49049,"Utah","Utah",40.1166722,-111.6657662,1678,14,0,1664,"Utah, Utah, US",636235,14715,11884,2419,9465,959,4255,5214,216540,1159427,12017424,51007737,80604
48463,"Uvalde","Texas",29.35739637,-99.76229172,6,0,0,6,"Uvalde, Texas, US",26741,-46,378,253,125,-36,-135,-171,10517,32040,249673,1036015,3202
48465,"Val Verde","Texas",29.89149232,-101.1525205,14,0,0,14,"Val Verde, Texas, US",49025,37,759,379,380,-15,-329,-344,18511,53638,320790,1325206,4261
35061,"Valencia","New Mexico",34.71669834,-106.8103733,70,1,0,69,"Valencia, New Mexico, US",76688,383,832,699,133,-21,274,253,17593,48672,320566,1321644,4948
16085,"Valley","Idaho",44.76728382,-115.5676773,2,0,0,2,"Valley, Idaho, US",11392,371,102,72,30,-14,354,340,4521,17005,110201,509653,3262
31175,"Valley","Nebraska",41.56730777,-98.98197724,3,0,0,3,"Valley, Nebraska, US",4158,-39,46,46,0,8,-47,-39,2340,4853,37693,156007,820
5141,"Van Buren","Arkansas",35.58095779,-92.51295036,28,2,0,26,"Van Buren, Arkansas, US",16545,-90,141,250,-109,11,9,20,4545,11658,96005,386065,1496
19177,"Van Buren","Iowa",40.75326764,-91.95017958,8,0,0,8,"Van Buren, Iowa, US",7044,31,88,96,-8,0,40,40,2627,5501,40783,183528,673
26159,"Van Buren","Michigan",42.25190229,-86.01939087,121,6,0,115,"Van Buren, Michigan, US",75677,196,865,802,63,39,99,138,24190,73685,644089,2638945,7213
47175,"Van Buren","Tennessee",35.69864497,-85.45221699,4,0,0,4,"Van Buren, Tennessee, US",5872,109,69,55,14,0,95,95,1394,978,7381,27348,89
39161,"Van Wert","Ohio",40.8554138,-84.591117,5,0,0,5,"Van Wert, Ohio, US",28275,22,339,295,44,-1,-20,-21,11168,38148,309330,1268951,2764
48467,"Van Zandt","Texas",32.56483801,-95.83766469,25,1,0,24,"Van Zandt, Texas, US",56590,624,635,656,-21,47,602,649,13301,39884,310674,1300055,4773
37181,"Vance","North Carolina",36.36880673,-78.40670845,239,18,0,221,"Vance, North Carolina, US",44535,-100,571,525,46,32,-177,-145,16152,58276,454754,1907725,4567
18163,"Vanderburgh","Indiana",38.02658833,-87.58763124,240,2,0,238,"Vanderburgh, Indiana, US",181451,331,2058,1889,169,217,-47,170,105843,564915,5941814,23494389,29792
42121,"Venango","Pennsylvania",41.40323442,-79.75845449,8,0,0,8,"Venango, Pennsylvania, US",50668,-533,452,680,-228,1,-306,-305,21543,68611,548711,2303193,6413
6111,"Ventura","California",34.44465746,-119.0910613,912,30,0,882,"Ventura, California, US",846006,-2136,9161,6241,2920,140,-5193,-5053,346493,1501557,19793005,76864705,127466
17183,"Vermilion","Illinois",40.18417171,-87.73384359,39,1,0,38,"Vermilion, Illinois, US",75758,-944,918,945,-27,19,-937,-918,31005,119593,1330625,4715990,7887
22113,"Vermilion","Louisiana",29.83517605,-92.30292538,50,3,0,47,"Vermilion, Louisiana, US",59511,-375,730,602,128,4,-507,-503,16252,47748,376272,1645798,5453
18165,"Vermillion","Indiana",39.8523352,-87.46160542,8,0,0,8,"Vermillion, Indiana, US",15498,-12,170,199,-29,17,1,18,4985,11513,113917,463704,1266
22115,"Vernon","Louisiana",31.10884837,-93.18153838,23,2,0,21,"Vernon, Louisiana, US",47429,-672,828,366,462,31,-1161,-1130,24230,37729,318194,1270741,3750
29217,"Vernon","Missouri",37.8457799,-94.34127305,7,0,0,7,"Vernon, Missouri, US",20563,71,242,227,15,3,55,58,9230,21017,154004,642230,2422
55123,"Vernon","Wisconsin",43.59422667,-90.8324691,14,0,0,14,"Vernon, Wisconsin, US",30822,50,412,326,86,1,-35,-34,10361,33292,265754,1138199,3281
48469,"Victoria","Texas",28.79780988,-96.96813006,157,7,0,150,"Victoria, Texas, US",92084,206,1175,835,340,25,-156,-131,43269,174027,1727817,7213120,13329
18167,"Vigo","Indiana",39.42944561,-87.39169027,135,7,0,128,"Vigo, Indiana, US",107038,-329,1192,1169,23,194,-547,-353,54970,221545,1958763,7961039,14179
55125,"Vilas","Wisconsin",46.05467334,-89.51719204,6,0,0,6,"Vilas, Wisconsin, US",22195,267,182,308,-126,10,383,393,8582,29186,180940,878458,5291
39163,"Vinton","Ohio",39.25208988,-82.4831444,19,0,0,19,"Vinton, Ohio, US",13085,-60,144,157,-13,0,-47,-47,2465,5654,40181,169543,608
51810,"Virginia Beach","Virginia",36.73285734,-76.04566934,598,19,0,579,"Virginia Beach, Virginia, US",449974,125,5514,3319,2195,296,-2367,-2071,201028,895788,8522243,35436614,66261
12127,"Volusia","Florida",29.05858895,-81.18263252,655,36,0,619,"Volusia, Florida, US",553284,7183,4933,7178,-2245,420,8975,9395,175165,831566,7196887,29132007,76659
17185,"Wabash","Illinois",38.44272901,-87.84922065,1,0,0,1,"Wabash, Illinois, US",11520,-3,131,114,17,34,-55,-21,3781,11153,89498,395037,1220
18169,"Wabash","Indiana",40.84704239,-85.79328272,72,2,0,70,"Wabash, Indiana, US",30996,-202,306,406,-100,10,-113,-103,13904,44009,348507,1410426,3888
27157,"Wabasha","Minnesota",44.28424356,-92.23121312,16,0,0,16,"Wabasha, Minnesota, US",21627,-18,235,186,49,4,-72,-68,7716,22358,174361,743328,2847
20197,"Wabaunsee","Kansas",38.95471985,-96.20350509,29,0,0,29,"Wabaunsee, Kansas, US",6931,19,74,51,23,2,-7,-5,1664,2931,19757,83708,554
27159,"Wadena","Minnesota",46.58589171,-94.96968506,6,0,0,6,"Wadena, Minnesota, US",13682,-41,186,177,9,1,-49,-48,6454,16533,125912,553721,2027
40145,"Wagoner","Oklahoma",35.96024096,-95.51911308,145,17,0,128,"Wagoner, Oklahoma, US",81289,1166,853,696,157,36,976,1012,12017,35702,282485,1215975,5162
53069,"Wahkiakum","Washington",46.2918004,-123.4250831,4,0,0,4,"Wahkiakum, Washington, US",4488,73,33,46,-13,4,83,87,1065,1280,10183,44685,237
37183,"Wake","North Carolina",35.78879266,-78.65249174,1434,32,0,1402,"Wake, North Carolina, US",1111761,20488,12634,6210,6424,3165,10857,14022,516628,2773548,37615639,150934304,175857
12129,"Wakulla","Florida",30.16548905,-84.39895211,32,1,0,31,"Wakulla, Florida, US",33739,1326,329,276,53,-2,1263,1261,5942,13936,88580,365875,2279
23027,"Waldo","Maine",44.4858305,-69.12061935,51,14,0,37,"Waldo, Maine, US",39715,58,330,446,-116,32,144,176,13162,38110,339022,1415115,5335
1127,"Walker","Alabama",33.80270512,-87.30027177,191,1,0,190,"Walker, Alabama, US",63521,-148,750,969,-219,-1,75,74,20758,68791,561095,2285517,6860
13295,"Walker","Georgia",34.73376362,-85.30165174,95,0,0,95,"Walker, Georgia, US",69761,318,745,835,-90,18,391,409,15724,38680,286947,1186486,3514
48471,"Walker","Texas",30.73872995,-95.57440968,436,27,0,409,"Walker, Texas, US",72971,-165,592,593,-1,151,-319,-168,23732,61737,412007,1745917,5505
53071,"Walla Walla","Washington",46.23040051,-118.4775539,106,2,0,104,"Walla Walla, Washington, US",60760,145,610,575,35,-15,128,113,29322,95314,891421,3772651,7654
48473,"Waller","Texas",30.01058447,-95.99011759,45,0,0,45,"Waller, Texas, US",55246,1734,683,336,347,25,1359,1384,17220,56744,599226,2495130,4227
41063,"Wallowa","Oregon",45.57894064,-117.183538,2,0,0,2,"Wallowa, Oregon, US",7208,150,61,71,-10,0,160,160,2853,7406,52503,253318,1793
38099,"Walsh","North Dakota",48.36876964,-97.72574783,11,0,0,11,"Walsh, North Dakota, US",10641,-4,124,128,-4,13,-11,2,5554,12828,110790,491158,2037
28147,"Walthall","Mississippi",31.14971548,-90.10446654,51,0,0,51,"Walthall, Mississippi, US",14286,-150,165,193,-28,-2,-118,-120,2776,8091,61197,254127,997
12131,"Walton","Florida",30.64204028,-86.16935664,103,7,0,96,"Walton, Florida, US",74071,3339,780,718,62,5,3252,3257,25377,117625,906585,3915374,13473
13297,"Walton","Georgia",33.78017694,-83.73552314,186,10,0,176,"Walton, Georgia, US",94593,1391,1174,937,237,-9,1162,1153,22519,83535,698318,2879581,9439
46129,"Walworth","South Dakota",45.43019636,-100.0307514,5,0,0,5,"Walworth, South Dakota, US",5435,-42,78,65,13,6,-60,-54,2414,7240,47020,202137,988
55127,"Walworth","Wisconsin",42.66858202,-88.54163073,339,12,0,327,"Walworth, Wisconsin, US",103868,318,924,947,-23,-23,366,343,45063,183114,1504987,6458367,15655
19179,"Wapello","Iowa",41.03064984,-92.40954728,477,4,0,473,"Wapello, Iowa, US",34969,-22,436,392,44,87,-154,-67,17048,56809,448248,1979917,3933
38101,"Ward","North Dakota",48.22390169,-101.5436763,54,1,0,53,"Ward, North Dakota, US",67641,-72,1099,491,608,117,-798,-681,40593,138982,1474506,6110325,11866
13299,"Ware","Georgia",31.05449097,-82.42224148,206,13,0,193,"Ware, Georgia, US",35734,147,476,455,21,-6,133,127,16428,55529,448780,1784250,4715
13301,"Warren","Georgia",33.41146451,-82.67795848,17,0,0,17,"Warren, Georgia, US",5254,7,61,68,-7,1,13,14,1360,1861,16152,69321,199
17187,"Warren","Illinois",40.84925021,-90.6147432,114,0,0,114,"Warren, Illinois, US",16844,-148,204,178,26,37,-212,-175,7189,18976,145942,577266,1835
18171,"Warren","Indiana",40.34728141,-87.35602659,12,1,0,11,"Warren, Indiana, US",8265,-15,86,84,2,4,-19,-15,2256,4524,38526,159710,521
19181,"Warren","Iowa",41.33559454,-93.56007641,100,0,0,100,"Warren, Iowa, US",51466,452,586,439,147,1,308,309,11923,41096,307592,1380951,4820
21227,"Warren","Kentucky",36.99903045,-86.42672751,920,5,0,915,"Warren, Kentucky, US",132896,2146,1723,1000,723,111,1308,1419,62618,287153,2701255,10868776,17301
28149,"Warren","Mississippi",32.35810271,-90.83352619,148,6,0,142,"Warren, Mississippi, US",45381,-712,576,518,58,16,-786,-770,21812,76673,636060,2655765,5498
29219,"Warren","Missouri",38.76529479,-91.16124662,28,0,0,28,"Warren, Missouri, US",35649,883,416,313,103,7,771,778,8008,26416,205032,903214,2877
34041,"Warren","New Jersey",40.85951833,-74.99556527,1119,126,0,993,"Warren, New Jersey, US",105267,-261,927,969,-42,104,-323,-219,37063,138902,1328111,5619056,14064
36113,"Warren","New York",43.56173026,-73.8433699,249,26,0,223,"Warren, New York, US",63944,-271,529,674,-145,23,-146,-123,37647,153583,1326330,5703007,13040
37185,"Warren","North Carolina",36.39728256,-78.10652228,54,0,0,54,"Warren, North Carolina, US",19731,-88,161,267,-106,-6,27,21,4656,7997,62461,217888,1251
39165,"Warren","Ohio",39.42581994,-84.16557457,319,19,0,300,"Warren, Ohio, US",234602,2657,2316,1858,458,187,2019,2206,88237,440220,5322713,21614178,25484
42123,"Warren","Pennsylvania",41.81304978,-79.26969577,3,0,0,3,"Warren, Pennsylvania, US",39191,-360,417,531,-114,5,-250,-245,17104,56997,484645,2000704,4913
47177,"Warren","Tennessee",35.6728299,-85.77969117,19,0,0,19,"Warren, Tennessee, US",41277,451,473,471,2,37,413,450,15759,44637,347990,1425464,3779
51187,"Warren","Virginia",38.90847745,-78.20280433,110,2,0,108,"Warren, Virginia, US",40164,158,457,395,62,2,94,96,13296,51158,411275,1712023,4437
18173,"Warrick","Indiana",38.08922676,-87.2716085,163,26,0,137,"Warrick, Indiana, US",62998,524,627,617,10,58,460,518,17168,67878,731619,2894793,6379
49051,"Wasatch","Utah",40.33110236,-111.1691419,237,1,0,236,"Wasatch, Utah, US",34091,1024,452,145,307,24,689,713,7811,30682,243644,1075486,5242
41065,"Wasco","Oregon",45.16292781,-121.1670954,18,1,0,17,"Wasco, Oregon, US",26682,250,299,299,0,3,248,251,10671,34411,285538,1193069,3665
27161,"Waseca","Minnesota",44.02211116,-93.58720034,24,0,0,24,"Waseca, Minnesota, US",18612,-52,204,149,55,-4,-103,-107,7791,19479,160882,709586,2272
56043,"Washakie","Wyoming",43.90451606,-107.680187,21,0,0,21,"Washakie, Wyoming, US",7805,-72,83,90,-7,-5,-60,-65,3930,10208,82247,351693,1674
55129,"Washburn","Wisconsin",45.89838588,-91.79050449,2,0,0,2,"Washburn, Wisconsin, US",15720,-117,133,225,-92,3,-26,-23,6534,17972,124448,536132,2715
1129,"Washington","Alabama",31.4092794,-88.20689944,64,5,0,59,"Washington, Alabama, US",16326,-76,165,191,-26,14,-65,-51,4568,15004,272745,1067513,997
5143,"Washington","Arkansas",35.976844,-94.21800746,233,5,0,228,"Washington, Arkansas, US",239187,2576,3203,1599,1604,164,802,966,102623,491819,4757463,20105013,32032
8121,"Washington","Colorado",39.97015535,-103.202587,30,0,0,30,"Washington, Colorado, US",4908,20,47,48,-1,-1,21,20,1602,1764,15876,60805,429
12133,"Washington","Florida",30.61359259,-85.66002461,26,1,0,25,"Washington, Florida, US",25473,680,257,305,-48,9,715,724,6979,15372,110142,451058,1951
13303,"Washington","Georgia",32.96711864,-82.79357039,73,1,0,72,"Washington, Georgia, US",20374,-36,219,227,-8,1,-28,-27,7430,20993,230027,850543,1654
16087,"Washington","Idaho",44.45275475,-116.7847688,34,0,0,34,"Washington, Idaho, US",10194,79,108,86,22,-8,64,56,2871,7368,44316,199542,947
17189,"Washington","Illinois",38.35309213,-89.40982703,18,0,0,18,"Washington, Illinois, US",13887,-112,154,143,11,0,-123,-123,7332,20518,186113,808914,1836
18175,"Washington","Indiana",38.60219804,-86.1049363,52,1,0,51,"Washington, Indiana, US",28036,104,321,302,19,0,87,87,6399,19207,139421,577097,2256
19183,"Washington","Iowa",41.33577126,-91.71725711,179,8,0,171,"Washington, Iowa, US",21965,-93,275,225,50,-1,-142,-143,8628,29013,222920,965960,3657
20201,"Washington","Kansas",39.78420784,-97.0875323,0,0,0,0,"Washington, Kansas, US",5406,-44,72,85,-13,3,-34,-31,2278,5650,33964,155678,947
21229,"Washington","Kentucky",37.75599461,-85.17407732,6,0,0,6,"Washington, Kentucky, US",12095,72,146,132,14,5,53,58,3884,10771,89903,395651,1041
22117,"Washington","Louisiana",30.85288548,-90.03866652,383,36,0,347,"Washington, Louisiana, US",46194,-394,600,635,-35,-16,-341,-357,12509,41202,303692,1176706,3351
23029,"Washington","Maine",45.01607142,-67.62813524,2,0,0,2,"Washington, Maine, US",31379,58,259,414,-155,31,185,216,12355,34366,237154,1047258,4627
24043,"Washington","Maryland",39.60835778,-77.82002295,398,10,0,388,"Washington, Maryland, US",151049,393,1649,1619,30,116,256,372,68753,301424,2739448,11296243,19942
27163,"Washington","Minnesota",45.03864533,-92.88429635,485,25,0,460,"Washington, Minnesota, US",262440,3541,2722,1712,1010,124,2420,2544,88711,429787,4462930,18116850,35051
28151,"Washington","Mississippi",33.28392041,-90.94196237,151,5,0,146,"Washington, Mississippi, US",43909,-1127,565,608,-43,19,-1107,-1088,17068,68046,497826,2032153,6143
29221,"Washington","Missouri",37.96130078,-90.87948158,10,1,0,9,"Washington, Missouri, US",24730,-203,274,271,3,-1,-206,-207,5778,12490,76604,335678,1738
31177,"Washington","Nebraska",41.52815707,-96.22019892,26,1,0,25,"Washington, Nebraska, US",20729,112,207,176,31,10,73,83,9200,26446,280582,1139729,3113
36115,"Washington","New York",43.31153794,-73.43043448,225,13,0,212,"Washington, New York, US",61204,-70,545,681,-136,7,63,70,18040,54201,493751,2106920,5921
37187,"Washington","North Carolina",35.83810081,-76.57299037,26,3,0,23,"Washington, North Carolina, US",11580,-189,129,155,-26,-8,-154,-162,4184,10544,94972,364997,1052
39167,"Washington","Ohio",39.45690571,-81.49121382,116,18,0,98,"Washington, Ohio, US",59911,-200,594,725,-131,10,-76,-66,25384,109077,1141292,4756546,7668
40147,"Washington","Oklahoma",36.71380786,-95.90514104,310,33,0,277,"Washington, Oklahoma, US",51527,-264,586,677,-91,83,-255,-172,23706,77909,834469,3054817,6359
41067,"Washington","Oregon",45.55972701,-123.0955257,673,17,0,656,"Washington, Oregon, US",601592,4688,6611,3582,3029,1193,478,1671,272129,1608626,26918663,108123828,93374
42125,"Washington","Pennsylvania",40.19208869,-80.24582867,135,5,0,130,"Washington, Pennsylvania, US",206865,-153,1926,2509,-583,47,402,449,90688,467932,6385481,24306202,30617
44009,"Washington","Rhode Island",41.45961631,-71.61435303,485,0,0,485,"Washington, Rhode Island, US",125577,-520,840,1247,-407,99,-208,-109,55803,215301,2156464,9336224,22067
47179,"Washington","Tennessee",36.29472368,-82.4945472,72,0,0,72,"Washington, Tennessee, US",129375,714,1223,1365,-142,182,678,860,63671,267789,2298681,9709963,16786
48477,"Washington","Texas",30.21498498,-96.40946246,187,22,0,165,"Washington, Texas, US",35882,386,364,383,-19,-2,409,407,16237,55966,458363,1894794,4812
50023,"Washington","Vermont",44.27343241,-72.61604978,39,1,0,38,"Washington, Vermont, US",58409,330,534,534,0,-9,338,329,33859,135340,1472467,6031331,12782
51191,"Washington","Virginia",36.72341572,-81.95666289,51,4,0,47,"Washington, Virginia, US",53740,-327,446,692,-246,-7,-71,-78,23631,75811,619814,2596315,6206
55131,"Washington","Wisconsin",43.36863664,-88.22974712,181,4,0,177,"Washington, Wisconsin, US",136034,589,1285,1161,124,22,453,475,54842,271469,2773375,11486386,18982
40149,"Washita","Oklahoma",35.29071824,-98.99180434,1,0,0,1,"Washita, Oklahoma, US",10916,-120,121,145,-24,3,-98,-95,3202,5067,41209,177804,1005
32031,"Washoe","Nevada",40.66562265,-119.6631594,1356,49,0,1307,"Washoe, Nevada, US",471519,7165,5259,4032,1227,-387,6281,5894,203368,1131134,11760745,50595078,75111
26161,"Washtenaw","Michigan",42.253105,-83.83853204,1282,96,0,1186,"Washtenaw, Michigan, US",367601,-1882,3473,2448,1025,1160,-4098,-2938,209801,882006,11624905,47755822,48655
37189,"Watauga","North Carolina",36.23103603,-81.70033724,13,0,0,13,"Watauga, North Carolina, US",56177,143,381,401,-20,43,121,164,26384,93370,666411,2885711,9199
27165,"Watonwan","Minnesota",43.97823903,-94.61413846,46,0,0,46,"Watonwan, Minnesota, US",10897,-110,162,113,49,43,-203,-160,4479,12946,95673,407100,1451
55133,"Waukesha","Wisconsin",43.01833055,-88.30431188,553,25,0,528,"Waukesha, Wisconsin, US",404198,1676,3851,3587,264,151,1300,1451,232566,1377509,18650840,74734214,75411
55135,"Waupaca","Wisconsin",44.47068056,-88.96534501,20,1,0,19,"Waupaca, Wisconsin, US",50990,-140,511,724,-213,17,59,76,22339,75881,576387,2389040,6638
55137,"Waushara","Wisconsin",44.11324419,-89.24317107,7,0,0,7,"Waushara, Wisconsin, US",24443,176,205,243,-38,14,202,216,7174,20162,137603,566779,2414
13305,"Wayne","Georgia",31.5521809,-81.91894878,16,0,0,16,"Wayne, Georgia, US",29927,117,360,358,2,8,108,116,9885,26035,215447,867175,2931
17191,"Wayne","Illinois",38.42955355,-88.42586459,9,1,0,8,"Wayne, Illinois, US",16215,-111,187,211,-24,3,-90,-87,6114,12660,83822,358217,1901
18177,"Wayne","Indiana",39.8633444,-85.01044989,66,5,0,61,"Wayne, Indiana, US",65884,-162,757,866,-109,70,-122,-52,29836,115738,1015601,4196323,8085
19185,"Wayne","Iowa",40.73969028,-93.32752197,1,0,0,1,"Wayne, Iowa, US",6441,36,80,88,-8,0,43,43,2437,3983,30504,130054,671
21231,"Wayne","Kentucky",36.80310688,-84.8251971,8,0,0,8,"Wayne, Kentucky, US",20333,-97,216,208,8,1,-107,-106,5549,12834,81873,350681,1258
26163,"Wayne","Michigan",42.28098405,-83.281255,19697,2361,0,17336,"Wayne, Michigan, US",1749343,-5110,22766,18385,4381,2533,-12052,-9519,740312,3740361,49282098,197456381,194113
28153,"Wayne","Mississippi",31.64135687,-88.69573913,76,0,0,76,"Wayne, Mississippi, US",20183,-113,257,217,40,-1,-153,-154,5916,17009,142112,573514,1860
31179,"Wayne","Nebraska",42.20934475,-97.11926964,12,0,0,12,"Wayne, Nebraska, US",9385,67,95,68,27,1,40,41,5084,12083,80442,338948,1160
36117,"Wayne","New York",43.15494365,-77.02976528,107,3,0,104,"Wayne, New York, US",89918,-282,941,873,68,21,-370,-349,30477,92358,796320,3583493,9761
37191,"Wayne","North Carolina",35.36438125,-78.00027268,980,18,0,962,"Wayne, North Carolina, US",123131,-106,1608,1384,224,214,-542,-328,50805,165547,1260261,5230979,12457
39169,"Wayne","Ohio",40.82925852,-81.88844833,248,50,0,198,"Wayne, Ohio, US",115710,-80,1446,1150,296,47,-424,-377,50743,201710,1839777,7926456,14425
42127,"Wayne","Pennsylvania",41.64938475,-75.29956506,117,7,0,110,"Wayne, Pennsylvania, US",51361,-34,376,615,-239,1,206,207,17206,62123,478667,2176909,7271
47181,"Wayne","Tennessee",35.23868267,-87.78644456,63,0,0,63,"Wayne, Tennessee, US",16673,38,125,197,-72,1,110,111,4542,9284,65629,288690,1034
54099,"Wayne","West Virginia",38.14901357,-82.42287994,97,9,0,88,"Wayne, West Virginia, US",39402,-559,330,537,-207,-12,-342,-354,10489,28164,226887,960068,2514
51820,"Waynesboro","Virginia",38.06451466,-78.90293905,38,0,0,38,"Waynesboro, Virginia, US",22630,99,357,249,108,53,-60,-7,9356,41106,333941,1386515,3221
47183,"Weakley","Tennessee",36.29896232,-88.71990865,26,0,0,26,"Weakley, Tennessee, US",33328,-85,311,359,-48,34,-68,-34,11379,31644,221710,891147,2965
48479,"Webb","Texas",27.7610369,-99.33237355,502,18,0,484,"Webb, Texas, US",276652,1532,4735,1378,3357,377,-2208,-1831,96788,451471,3156477,13010976,32069
13307,"Webster","Georgia",32.04066113,-84.54742852,11,1,0,10,"Webster, Georgia, US",2607,1,23,22,1,0,0,0,599,633,5776,24823,85
19187,"Webster","Iowa",42.42853483,-94.17987389,27,1,0,26,"Webster, Iowa, US",35904,-435,421,418,3,28,-467,-439,18010,80311,728811,3075164,5580
21233,"Webster","Kentucky",37.52168356,-87.67989953,32,0,0,32,"Webster, Kentucky, US",12942,-109,178,142,36,2,-145,-143,4191,6937,58790,259033,1050
22119,"Webster","Louisiana",32.70847669,-93.33121835,126,5,0,121,"Webster, Louisiana, US",38340,-452,452,531,-79,5,-376,-371,13081,46911,422998,1606926,4211
28155,"Webster","Mississippi",33.61300486,-89.28392912,27,1,0,26,"Webster, Mississippi, US",9689,-99,112,151,-39,-3,-57,-60,2227,5610,40505,161958,695
29225,"Webster","Missouri",37.2813734,-92.876329,17,0,0,17,"Webster, Missouri, US",39592,413,572,378,194,0,218,218,8090,25993,177417,749604,3449
31181,"Webster","Nebraska",40.17642643,-98.50019851,5,0,0,5,"Webster, Nebraska, US",3487,-47,39,47,-8,0,-40,-40,1337,2070,14135,61419,355
8123,"Weld","Colorado",40.55499405,-104.3929621,2391,125,0,2266,"Weld, Colorado, US",324492,9677,4360,1856,2504,363,6778,7141,107551,469473,5739418,23328754,37108
18179,"Wells","Indiana",40.72934187,-85.22132966,22,0,0,22,"Wells, Indiana, US",28296,213,321,246,75,31,109,140,11244,43940,347014,1423956,3266
38103,"Wells","North Dakota",47.58614526,-99.65904998,3,0,0,3,"Wells, North Dakota, US",3834,-74,45,50,-5,1,-70,-69,2213,5123,42511,187999,883
22121,"West Baton Rouge","Louisiana",30.46058217,-91.30989571,154,30,0,124,"West Baton Rouge, Louisiana, US",26465,65,346,218,128,-9,-52,-61,11516,52531,592352,2341186,2854
22123,"West Carroll","Louisiana",32.78550125,-91.461201,33,0,0,33,"West Carroll, Louisiana, US",10830,-147,92,149,-57,6,-96,-90,2680,5509,35114,139340,761
22125,"West Feliciana","Louisiana",30.87882871,-91.4148538,194,8,0,186,"West Feliciana, Louisiana, US",15568,76,124,120,4,7,66,73,5156,8979,90955,337875,802
36119,"Westchester","New York",41.16278376,-73.75741653,32881,1327,0,31554,"Westchester, New York, US",967506,-707,10183,7582,2601,2060,-5390,-3330,435102,2275658,38786435,149425899,190752
42129,"Westmoreland","Pennsylvania",40.3137798,-79.46615476,437,38,0,399,"Westmoreland, Pennsylvania, US",348899,-1560,2869,4435,-1566,42,-8,34,144558,706298,6541535,27581436,50992
51193,"Westmoreland","Virginia",38.11021557,-76.80213247,46,0,0,46,"Westmoreland, Virginia, US",18015,198,181,222,-41,-6,245,239,4076,10352,63484,274147,1549
54103,"Wetzel","West Virginia",39.6065771,-80.6401654,8,0,0,8,"Wetzel, West Virginia, US",15065,-194,141,243,-102,0,-91,-91,6426,15590,133512,520471,1594
26165,"Wexford","Michigan",44.33853602,-85.57712739,11,2,0,9,"Wexford, Michigan, US",33631,185,362,341,21,6,160,166,15035,55870,464333,1958624,4540
48481,"Wharton","Texas",29.27765923,-96.22319248,45,0,0,45,"Wharton, Texas, US",41556,57,564,420,144,-15,-70,-85,16362,53906,472718,1888462,5455
53073,"Whatcom","Washington",48.82227976,-121.7490018,363,36,0,327,"Whatcom, Washington, US",229247,4050,2204,1662,542,403,3087,3490,93694,414955,4264558,17793100,39558
30107,"Wheatland","Montana",46.46652491,-109.8464636,1,0,0,1,"Wheatland, Montana, US",2126,-58,26,21,5,-2,-61,-63,832,867,5780,22989,184
13309,"Wheeler","Georgia",32.12009104,-82.72574721,9,0,0,9,"Wheeler, Georgia, US",7855,-43,64,63,1,0,-44,-44,1459,1854,14677,62267,264
48483,"Wheeler","Texas",35.40114335,-100.2699514,15,0,0,15,"Wheeler, Texas, US",5056,-102,53,64,-11,0,-93,-93,3686,6279,66021,306244,830
5145,"White","Arkansas",35.25688493,-91.74908296,38,1,0,37,"White, Arkansas, US",78753,372,881,837,44,-27,360,333,28555,95876,756229,3202020,8913
13311,"White","Georgia",34.64624278,-83.74905525,93,3,0,90,"White, Georgia, US",30798,810,288,316,-28,2,830,832,8873,28251,191683,834530,3250
17193,"White","Illinois",38.08706198,-88.17657461,2,0,0,2,"White, Illinois, US",13537,-81,132,199,-67,2,-16,-14,5470,14143,109628,467471,1934
18181,"White","Indiana",40.74911165,-86.86492015,212,8,0,204,"White, Indiana, US",24102,-31,291,282,9,28,-66,-38,9606,27666,225007,936652,3029
47185,"White","Tennessee",35.92929884,-85.45591799,24,0,0,24,"White, Tennessee, US",27345,259,292,369,-77,5,330,335,7478,23296,182477,798605,2012
32033,"White Pine","Nevada",39.44157041,-114.899966,4,0,0,4,"White Pine, Nevada, US",9580,40,104,96,8,4,29,33,3863,7663,72279,293225,737
17195,"Whiteside","Illinois",41.75509713,-89.91556058,133,10,0,123,"Whiteside, Illinois, US",55175,-378,610,649,-39,-7,-330,-337,22390,78236,647130,2608798,6716
13313,"Whitfield","Georgia",34.80987459,-84.96093476,270,7,0,263,"Whitfield, Georgia, US",104628,379,1305,837,468,41,-130,-89,55650,255722,2757617,10794080,12468
18183,"Whitley","Indiana",41.13863784,-85.50791236,34,2,0,32,"Whitley, Indiana, US",33964,-83,409,312,97,12,-192,-180,12498,45359,407245,1668771,3585
21235,"Whitley","Kentucky",36.75700531,-84.14541217,13,0,0,13,"Whitley, Kentucky, US",36264,163,528,473,55,-6,115,109,12359,36888,286365,1192545,3119
53075,"Whitman","Washington",46.90022523,-117.5241763,16,0,0,16,"Whitman, Washington, US",50104,421,390,239,151,393,-121,272,23635,42336,352802,1556497,4514
48485,"Wichita","Texas",33.98842886,-98.7041034,82,2,0,80,"Wichita, Texas, US",132230,423,1585,1363,222,160,45,205,64389,241720,2067148,8438686,17825
24045,"Wicomico","Maryland",38.37301947,-75.62705831,859,22,0,837,"Wicomico, Maryland, US",103609,565,1264,1066,198,185,186,371,47800,190940,1672939,7288991,14166
48487,"Wilbarger","Texas",34.07945812,-99.24178437,6,0,0,6,"Wilbarger, Texas, US",12769,-8,154,143,11,2,-20,-18,6334,10980,79906,319074,1388
1131,"Wilcox","Alabama",31.98773215,-87.30891118,113,7,0,106,"Wilcox, Alabama, US",10373,-226,133,162,-29,0,-197,-197,2826,6758,65576,270710,849
13315,"Wilcox","Georgia",31.97496928,-83.43438555,98,13,0,85,"Wilcox, Georgia, US",8635,-192,78,88,-10,1,-184,-183,1951,1440,9145,39635,337
13317,"Wilkes","Georgia",33.78290391,-82.74286107,32,1,0,31,"Wilkes, Georgia, US",9777,-87,95,147,-52,6,-39,-33,3302,8056,59025,238811,880
37193,"Wilkes","North Carolina",36.2084135,-81.16232895,472,3,0,469,"Wilkes, North Carolina, US",68412,-151,670,817,-147,52,-50,2,23150,76201,624265,2426702,6502
27167,"Wilkin","Minnesota",46.35721532,-96.4684375,11,3,0,8,"Wilkin, Minnesota, US",6207,-37,73,83,-10,-5,-23,-28,2704,5106,42186,187526,645
13319,"Wilkinson","Georgia",32.80291082,-83.17140684,64,4,0,60,"Wilkinson, Georgia, US",8954,-89,104,127,-23,0,-65,-65,3041,8838,108615,454350,603
28157,"Wilkinson","Mississippi",31.16078225,-91.31018819,81,9,0,72,"Wilkinson, Mississippi, US",8630,-151,88,122,-34,-1,-116,-117,2482,3753,24048,99385,540
17197,"Will","Illinois",41.44619267,-87.97862712,5012,257,0,4755,"Will, Illinois, US",690743,-406,7311,4812,2499,171,-3092,-2921,248101,1307005,13393452,57386525,91953
48489,"Willacy","Texas",26.47411727,-97.61535848,15,1,0,14,"Willacy, Texas, US",21358,-92,252,183,69,5,-168,-163,4510,9167,58928,244571,889
38105,"Williams","North Dakota",48.34522353,-103.4793387,25,0,0,25,"Williams, North Dakota, US",37589,2120,725,234,491,23,1601,1624,25090,103684,1712360,7546857,8495
39171,"Williams","Ohio",41.56052014,-84.58429552,51,1,0,50,"Williams, Ohio, US",36692,-47,408,393,15,-6,-53,-59,17130,67633,571891,2384903,4299
45089,"Williamsburg","South Carolina",33.62190129,-79.72767442,207,10,0,197,"Williamsburg, South Carolina, US",30368,-238,302,394,-92,28,-172,-144,9227,28953,222716,906310,2479
51830,"Williamsburg","Virginia",37.28131268,-76.70905141,43,3,0,40,"Williamsburg, Virginia, US",14954,-48,77,74,3,40,-90,-50,13901,42467,259172,1145420,2811
17199,"Williamson","Illinois",37.73033511,-88.92994027,54,1,0,53,"Williamson, Illinois, US",66597,-385,716,769,-53,28,-359,-331,28748,126360,1057113,4474933,9113
47187,"Williamson","Tennessee",35.89099229,-86.89281867,503,10,0,493,"Williamson, Tennessee, US",238412,6434,2357,1325,1032,574,4835,5409,116137,729782,11137878,45252180,42141
48491,"Williamson","Texas",30.64655664,-97.6004854,541,21,0,520,"Williamson, Texas, US",590551,24088,6685,3009,3676,799,19513,20312,167817,908631,11434629,44946333,64919
20205,"Wilson","Kansas",37.55937174,-95.74323255,1,0,0,1,"Wilson, Kansas, US",8525,-141,107,110,-3,1,-141,-140,3898,9518,82020,368356,930
37195,"Wilson","North Carolina",35.70625477,-77.917978,309,9,0,300,"Wilson, North Carolina, US",81801,409,944,944,0,77,336,413,37867,149497,1429006,5572689,9861
47189,"Wilson","Tennessee",36.15496772,-86.29775884,343,8,0,335,"Wilson, Tennessee, US",144657,3703,1635,1167,468,156,3070,3226,43731,215124,1818012,7903539,15739
48493,"Wilson","Texas",29.1732598,-98.08693082,38,5,0,33,"Wilson, Texas, US",51070,874,534,415,119,17,740,757,10372,30738,239532,1042347,3743
51840,"Winchester","Virginia",39.17054517,-78.17325058,128,1,0,127,"Winchester, Virginia, US",28078,116,338,256,82,80,-44,36,25065,121725,1121338,4713394,7743
9015,"Windham","Connecticut",41.82972709,-71.98182316,354,14,0,340,"Windham, Connecticut, US",116782,-277,1060,1068,-8,117,-384,-267,42548,161620,1470330,6179162,12070
50025,"Windham","Vermont",42.986982,-72.71268875,80,3,0,77,"Windham, Vermont, US",42222,-413,348,426,-78,-2,-334,-336,24515,105418,937466,3752189,9464
50027,"Windsor","Vermont",43.58010937,-72.58595157,49,2,0,47,"Windsor, Vermont, US",55062,-142,439,539,-100,21,-59,-38,25290,109866,1161778,4740833,11263
48495,"Winkler","Texas",31.85008651,-103.0485163,3,0,0,3,"Winkler, Texas, US",8010,232,127,49,78,21,131,152,2774,8676,153337,584588,909
22127,"Winn","Louisiana",31.94449367,-92.63789413,112,2,0,110,"Winn, Louisiana, US",13904,-234,151,215,-64,-2,-169,-171,4414,14896,136108,553096,1315
17201,"Winnebago","Illinois",42.33641854,-89.16085327,1838,49,0,1789,"Winnebago, Illinois, US",282572,-1058,3445,2928,517,329,-1907,-1578,134228,671787,6859736,27963610,37872
19189,"Winnebago","Iowa",43.37751174,-93.73407298,10,0,0,10,"Winnebago, Iowa, US",10354,-185,95,119,-24,1,-162,-161,5574,19907,171236,711153,1518
55139,"Winnebago","Wisconsin",44.06886922,-88.64477096,166,1,0,165,"Winnebago, Wisconsin, US",171907,1029,1783,1497,286,65,683,748,95073,453525,5640183,22682100,21130
19191,"Winneshiek","Iowa",43.29094334,-91.84422722,21,0,0,21,"Winneshiek, Iowa, US",19991,-26,174,187,-13,4,-16,-12,12426,31732,241935,1060045,3378
27169,"Winona","Minnesota",43.98772283,-91.78081305,77,15,0,62,"Winona, Minnesota, US",50484,-251,456,440,16,25,-292,-267,27665,93773,789270,3298077,6226
1133,"Winston","Alabama",34.15030532,-87.37325922,61,0,0,61,"Winston, Alabama, US",23629,-64,243,325,-82,2,17,19,8016,28682,220546,915356,2283
28159,"Winston","Mississippi",33.08747908,-89.03391385,98,1,0,97,"Winston, Mississippi, US",17955,-209,190,250,-60,0,-150,-150,5813,18469,145260,633152,1897
54105,"Wirt","West Virginia",39.02775007,-81.37473928,4,0,0,4,"Wirt, West Virginia, US",5821,10,47,54,-7,0,16,16,834,481,2650,10459,132
48497,"Wise","Texas",33.21570665,-97.65460265,42,2,0,40,"Wise, Texas, US",69984,1700,789,635,154,14,1530,1544,21003,90618,989637,4050766,7420
51195,"Wise","Virginia",36.9746148,-82.62410519,24,2,0,22,"Wise, Virginia, US",37383,-492,336,479,-143,-1,-348,-349,17128,36488,258712,1085575,3767
21237,"Wolfe","Kentucky",37.73941626,-83.49303612,1,0,0,1,"Wolfe, Kentucky, US",7157,-42,86,101,-15,-4,-24,-28,1360,1909,11354,49678,261
39173,"Wood","Ohio",41.36224827,-83.62285108,269,45,0,224,"Wood, Ohio, US",130817,376,1319,1115,204,83,96,179,66097,291948,3099566,12220651,16061
48499,"Wood","Texas",32.78722382,-95.38236368,22,1,0,21,"Wood, Texas, US",45539,382,403,647,-244,-4,629,625,12483,37724,305776,1278816,4375
54107,"Wood","West Virginia",39.20967886,-81.5162836,48,2,0,46,"Wood, West Virginia, US",83518,-662,869,1078,-209,-24,-429,-453,39333,153927,1201841,5002255,11347
55141,"Wood","Wisconsin",44.45537896,-90.04158336,9,1,0,8,"Wood, Wisconsin, US",72999,45,798,724,74,17,-42,-25,39697,172734,1810351,7631982,10068
19193,"Woodbury","Iowa",42.38979414,-96.0459439,2520,23,0,2497,"Woodbury, Iowa, US",103107,592,1390,900,490,100,7,107,49899,229461,1977263,8281593,15226
17203,"Woodford","Illinois",40.78579374,-89.20973757,17,2,0,15,"Woodford, Illinois, US",38459,-68,418,391,27,6,-100,-94,11228,40611,335180,1529843,4064
21239,"Woodford","Kentucky",38.04178222,-84.7417556,25,0,0,25,"Woodford, Kentucky, US",26734,243,280,232,48,1,195,196,10089,31249,287205,1214255,2855
5147,"Woodruff","Arkansas",35.18902527,-91.2439489,1,0,0,1,"Woodruff, Arkansas, US",6320,-146,70,102,-32,0,-112,-112,2099,4216,31557,133318,573
40151,"Woods","Oklahoma",36.76705782,-98.86573064,3,0,0,3,"Woods, Oklahoma, US",8793,-100,96,100,-4,6,-103,-97,5168,10958,142030,441933,1298
20207,"Woodson","Kansas",37.8865336,-95.74006277,6,0,0,6,"Woodson, Kansas, US",3138,-46,35,40,-5,0,-40,-40,1006,1638,8317,39415,310
40153,"Woodward","Oklahoma",36.42316318,-99.26283045,3,0,0,3,"Woodward, Oklahoma, US",20211,-101,247,222,25,22,-148,-126,10149,34999,376042,1561375,4040
24047,"Worcester","Maryland",38.21274277,-75.33200012,180,8,0,172,"Worcester, Maryland, US",52276,316,402,676,-274,17,576,593,25015,100405,668585,3553132,12490
25027,"Worcester","Massachusetts",42.35026951,-71.90493363,10251,667,0,9584,"Worcester, Massachusetts, US",830622,1568,8515,7345,1170,2155,-1743,412,343918,1791131,22506205,89487775,110092
13321,"Worth","Georgia",31.55162306,-83.85090513,204,19,0,185,"Worth, Georgia, US",20247,-55,213,230,-17,0,-38,-38,4069,12423,99255,397790,1226
19195,"Worth","Iowa",43.37750768,-93.26087602,3,0,0,3,"Worth, Iowa, US",7381,-32,77,69,8,0,-40,-40,2475,4907,35436,156993,802
29227,"Worth","Missouri",40.47945588,-94.42328751,3,0,0,3,"Worth, Missouri, US",2013,-13,23,18,5,0,-18,-18,679,334,1832,8074,117
19197,"Wright","Iowa",42.73305373,-93.73515113,98,0,0,98,"Wright, Iowa, US",12562,-128,154,161,-7,11,-132,-121,6145,14790,121609,518369,1860
27171,"Wright","Minnesota",45.17297924,-93.96234781,231,1,0,230,"Wright, Minnesota, US",138377,2064,1734,832,902,41,1132,1173,42595,196119,1759061,7833887,19684
29229,"Wright","Missouri",37.27029221,-92.46914488,11,0,0,11,"Wright, Missouri, US",18289,102,243,243,0,-7,111,104,4969,15130,96007,382006,1967
39175,"Wyandot","Ohio",40.84339621,-83.30734173,36,2,0,34,"Wyandot, Ohio, US",21772,-146,221,253,-32,-5,-108,-113,8565,32256,308536,1299207,2617
20209,"Wyandotte","Kansas",39.11727348,-94.76378225,1255,71,0,1184,"Wyandotte, Kansas, US",165429,108,2477,1423,1054,500,-1445,-945,84938,338131,3751491,15177782,17558
36121,"Wyoming","New York",42.70145109,-78.22199579,80,5,0,75,"Wyoming, New York, US",39859,-164,328,345,-17,1,-147,-146,15379,37132,303541,1281360,4218
42131,"Wyoming","Pennsylvania",41.51955538,-76.01074915,33,7,0,26,"Wyoming, Pennsylvania, US",26794,-293,259,321,-62,3,-234,-231,12622,36409,369729,1585896,3488
54109,"Wyoming","West Virginia",37.612327,-81.54511071,3,0,0,3,"Wyoming, West Virginia, US",20394,-390,180,346,-166,0,-227,-227,5218,10616,71248,306258,1326
51197,"Wythe","Virginia",36.91582035,-81.07834059,17,1,0,16,"Wythe, Virginia, US",28684,-14,299,397,-98,-7,94,87,13070,43716,338421,1410789,3576
37197,"Yadkin","North Carolina",36.16222629,-80.66239436,131,1,0,130,"Yadkin, North Carolina, US",37667,186,379,426,-47,18,218,236,10823,33212,252040,1042471,3134
53077,"Yakima","Washington",46.45738486,-120.7380126,2594,83,0,2511,"Yakima, Washington, US",250873,311,3746,2093,1653,-137,-1203,-1340,98310,392899,3707602,15905641,28048
28161,"Yalobusha","Mississippi",34.02824175,-89.7076205,82,4,0,78,"Yalobusha, Mississippi, US",12108,-253,145,165,-20,-3,-231,-234,3245,7524,51673,211309,737
41071,"Yamhill","Oregon",45.23330449,-123.3086963,64,7,0,57,"Yamhill, Oregon, US",107100,733,1096,904,192,-45,586,541,36217,153989,1333366,5666716,14652
37199,"Yancey","North Carolina",35.90079156,-82.31237181,10,0,0,10,"Yancey, North Carolina, US",18069,196,181,211,-30,-2,227,225,4763,12642,94350,411249,1606
46135,"Yankton","South Dakota",43.00924485,-97.39467635,46,0,0,46,"Yankton, South Dakota, US",22814,55,261,207,54,1,2,3,12651,43871,412360,1753944,3943
36123,"Yates","New York",42.63505484,-77.10369919,37,4,0,33,"Yates, New York, US",24913,-38,316,267,49,10,-98,-88,8768,19164,127908,575399,2631
4025,"Yavapai","Arizona",34.59933926,-112.5538588,284,6,0,278,"Yavapai, Arizona, US",235099,3327,1782,3042,-1260,-72,4636,4564,75612,343850,2815596,11798715,35319
28163,"Yazoo","Mississippi",32.77890365,-90.39656148,204,2,0,202,"Yazoo, Mississippi, US",29690,597,312,278,34,43,515,558,6941,17369,119441,494722,1948
5149,"Yell","Arkansas",35.00292371,-93.41171338,94,1,0,93,"Yell, Arkansas, US",21341,-121,258,244,14,-2,-133,-135,6253,19604,132226,563003,1519
27173,"Yellow Medicine","Minnesota",44.71710183,-95.86842453,5,0,0,5,"Yellow Medicine, Minnesota, US",9709,-90,108,95,13,2,-104,-102,4645,10948,94434,385150,1652
30111,"Yellowstone","Montana",45.93955949,-108.2691486,88,2,0,86,"Yellowstone, Montana, US",161300,1271,1857,1485,372,43,858,901,79761,392660,4174511,17115192,33473
48501,"Yoakum","Texas",33.17320212,-102.8276433,3,0,0,3,"Yoakum, Texas, US",8713,123,151,52,99,48,-24,24,3950,8584,116508,463173,884
6113,"Yolo","California",38.68278902,-121.9018288,190,22,0,168,"Yolo, California, US",220500,382,2215,1386,829,857,-1312,-455,104169,349058,3853081,16369383,24291
23031,"York","Maine",43.47808377,-70.71052375,337,8,0,329,"York, Maine, US",207641,1772,1805,2083,-278,5,2047,2052,72315,291751,2513068,11356712,33116
31185,"York","Nebraska",40.87272618,-97.59710186,35,0,0,35,"York, Nebraska, US",13679,-69,170,135,35,1,-104,-103,8200,26761,202660,901790,2587
42133,"York","Pennsylvania",39.9210089,-76.73040131,904,22,0,882,"York, Pennsylvania, US",449058,1211,4868,4121,747,200,291,491,178610,932404,9678312,39902062,51539
45091,"York","South Carolina",34.97281497,-81.18085944,339,6,0,333,"York, South Carolina, US",280979,7197,2965,2227,738,188,6252,6440,91828,446990,4573558,18465714,30098
51199,"York","Virginia",37.24374789,-76.54412815,67,3,0,64,"York, Virginia, US",68280,304,596,523,73,67,171,238,24639,102041,821594,3454809,8247
48503,"Young","Texas",33.17659707,-98.68790885,4,1,0,3,"Young, Texas, US",18010,24,198,234,-36,9,52,61,8155,24224,232335,945676,3031
6115,"Yuba","California",39.26255932,-121.3535644,28,1,0,27,"Yuba, California, US",78668,1111,1149,583,566,0,542,542,23818,44156,417402,1827040,4356
2290,"Yukon-Koyukuk","Alaska",65.50815459,-151.3907387,1,0,0,1,"Yukon-Koyukuk, Alaska, US",5230,-129,76,69,7,2,-139,-137,2119,1418,11289,55126,432
4027,"Yuma","Arizona",32.76895712,-113.9066674,604,10,0,594,"Yuma, Arizona, US",213787,2175,2991,1713,1278,546,357,903,71353,236079,1903200,7587463,17699
8125,"Yuma","Colorado",40.00346839,-102.4258673,15,0,0,15,"Yuma, Colorado, US",10019,72,135,93,42,47,-17,30,5030,10889,95599,406399,1899
48505,"Zapata","Texas",27.00156391,-99.16987152,8,0,0,8,"Zapata, Texas, US",14179,30,214,110,104,-9,-66,-75,4534,6342,55792,194372,638
48507,"Zavala","Texas",28.86617238,-99.76050829,11,0,0,11,"Zavala, Texas, US",11840,-129,153,104,49,-2,-175,-177,3650,4540,24411,100752,425
46137,"Ziebach","South Dakota",44.97881876,-101.6654622,1,0,0,1,"Ziebach, South Dakota, US",2756,12,23,25,-2,0,14,14,660,868,6619,25493,106
